date,state,county,new doses,cumulative doses,fips
2020-12-14,MO,Adair,1,1,29001
2020-12-15,MO,Adair,4,5,29001
2020-12-16,MO,Adair,8,13,29001
2020-12-17,MO,Adair,16,29,29001
2020-12-18,MO,Adair,13,42,29001
2020-12-19,MO,Adair,2,44,29001
2020-12-20,MO,Adair,1,45,29001
2020-12-21,MO,Adair,440,485,29001
2020-12-22,MO,Adair,11,496,29001
2020-12-23,MO,Adair,368,864,29001
2020-12-24,MO,Adair,1,865,29001
2020-12-26,MO,Adair,1,866,29001
2020-12-27,MO,Adair,3,869,29001
2020-12-28,MO,Adair,13,882,29001
2020-12-29,MO,Adair,7,889,29001
2020-12-30,MO,Adair,12,901,29001
2020-12-31,MO,Adair,7,908,29001
2021-01-02,MO,Adair,1,909,29001
2021-01-03,MO,Adair,3,912,29001
2021-01-04,MO,Adair,14,926,29001
2021-01-05,MO,Adair,8,934,29001
2021-01-06,MO,Adair,15,949,29001
2021-01-07,MO,Adair,10,959,29001
2021-01-08,MO,Adair,15,974,29001
2021-01-09,MO,Adair,17,991,29001
2021-01-10,MO,Adair,3,994,29001
2021-01-11,MO,Adair,488,1482,29001
2021-01-12,MO,Adair,11,1493,29001
2021-01-13,MO,Adair,367,1860,29001
2021-01-14,MO,Adair,132,1992,29001
2021-01-15,MO,Adair,46,2038,29001
2021-01-16,MO,Adair,3,2041,29001
2021-01-17,MO,Adair,2,2043,29001
2021-01-18,MO,Adair,21,2064,29001
2021-01-19,MO,Adair,20,2084,29001
2021-01-20,MO,Adair,22,2106,29001
2021-01-21,MO,Adair,30,2136,29001
2021-01-22,MO,Adair,42,2178,29001
2021-01-23,MO,Adair,3,2181,29001
2021-01-24,MO,Adair,5,2186,29001
2021-01-25,MO,Adair,16,2202,29001
2021-01-26,MO,Adair,16,2218,29001
2021-01-27,MO,Adair,616,2834,29001
2021-01-28,MO,Adair,73,2907,29001
2021-01-29,MO,Adair,62,2969,29001
2021-01-30,MO,Adair,4,2973,29001
2021-02-01,MO,Adair,5,2978,29001
2021-02-02,MO,Adair,25,3003,29001
2021-02-03,MO,Adair,31,3034,29001
2021-02-04,MO,Adair,43,3077,29001
2021-02-05,MO,Adair,160,3237,29001
2021-02-06,MO,Adair,69,3306,29001
2021-02-08,MO,Adair,158,3464,29001
2021-02-09,MO,Adair,21,3485,29001
2021-02-10,MO,Adair,32,3517,29001
2021-02-11,MO,Adair,122,3639,29001
2021-02-12,MO,Adair,69,3708,29001
2021-02-13,MO,Adair,24,3732,29001
2021-02-14,MO,Adair,4,3736,29001
2021-02-15,MO,Adair,24,3760,29001
2021-02-16,MO,Adair,75,3835,29001
2021-02-17,MO,Adair,42,3877,29001
2021-02-18,MO,Adair,61,3938,29001
2021-02-19,MO,Adair,50,3988,29001
2021-02-20,MO,Adair,2,3990,29001
2021-02-21,MO,Adair,5,3995,29001
2021-02-22,MO,Adair,116,4111,29001
2021-02-23,MO,Adair,105,4216,29001
2021-02-24,MO,Adair,667,4883,29001
2021-02-25,MO,Adair,1349,6232,29001
2021-02-26,MO,Adair,152,6384,29001
2021-02-27,MO,Adair,73,6457,29001
2021-02-28,MO,Adair,50,6507,29001
2021-03-01,MO,Adair,113,6620,29001
2021-03-02,MO,Adair,76,6696,29001
2021-03-03,MO,Adair,111,6807,29001
2021-03-04,MO,Adair,147,6954,29001
2021-03-05,MO,Adair,268,7222,29001
2021-03-06,MO,Adair,79,7301,29001
2021-03-07,MO,Adair,24,7325,29001
2021-03-08,MO,Adair,103,7428,29001
2021-03-09,MO,Adair,55,7483,29001
2021-03-10,MO,Adair,46,7529,29001
2021-03-11,MO,Adair,100,7629,29001
2021-03-12,MO,Adair,191,7820,29001
2021-03-13,MO,Adair,34,7854,29001
2021-03-14,MO,Adair,18,7872,29001
2021-03-15,MO,Adair,117,7989,29001
2021-03-16,MO,Adair,253,8242,29001
2021-03-17,MO,Adair,171,8413,29001
2021-03-18,MO,Adair,154,8567,29001
2021-03-19,MO,Adair,265,8832,29001
2021-03-20,MO,Adair,91,8923,29001
2021-03-21,MO,Adair,55,8978,29001
2021-03-22,MO,Adair,178,9156,29001
2021-03-23,MO,Adair,85,9241,29001
2021-03-24,MO,Adair,88,9329,29001
2021-03-25,MO,Adair,1321,10650,29001
2021-03-26,MO,Adair,276,10926,29001
2021-03-27,MO,Adair,96,11022,29001
2021-03-28,MO,Adair,41,11063,29001
2021-03-29,MO,Adair,169,11232,29001
2021-03-30,MO,Adair,150,11382,29001
2021-03-31,MO,Adair,104,11486,29001
2021-04-01,MO,Adair,131,11617,29001
2021-04-02,MO,Adair,291,11908,29001
2021-04-03,MO,Adair,82,11990,29001
2021-04-04,MO,Adair,15,12005,29001
2021-04-05,MO,Adair,120,12125,29001
2021-04-06,MO,Adair,171,12296,29001
2021-04-07,MO,Adair,140,12436,29001
2021-04-08,MO,Adair,129,12565,29001
2021-04-09,MO,Adair,162,12727,29001
2021-04-10,MO,Adair,133,12860,29001
2021-04-11,MO,Adair,41,12901,29001
2021-04-12,MO,Adair,104,13005,29001
2021-04-13,MO,Adair,164,13169,29001
2021-04-14,MO,Adair,81,13250,29001
2021-04-15,MO,Adair,115,13365,29001
2021-04-16,MO,Adair,139,13504,29001
2021-04-17,MO,Adair,64,13568,29001
2021-04-18,MO,Adair,30,13598,29001
2021-04-19,MO,Adair,81,13679,29001
2021-04-20,MO,Adair,117,13796,29001
2021-04-21,MO,Adair,97,13893,29001
2021-04-22,MO,Adair,69,13962,29001
2021-04-23,MO,Adair,136,14098,29001
2021-04-24,MO,Adair,51,14149,29001
2020-12-18,MO,Andrew,2,2,29003
2020-12-21,MO,Andrew,1,3,29003
2020-12-22,MO,Andrew,17,20,29003
2020-12-23,MO,Andrew,36,56,29003
2020-12-24,MO,Andrew,1,57,29003
2020-12-27,MO,Andrew,35,92,29003
2020-12-28,MO,Andrew,66,158,29003
2020-12-29,MO,Andrew,41,199,29003
2020-12-30,MO,Andrew,13,212,29003
2020-12-31,MO,Andrew,17,229,29003
2021-01-01,MO,Andrew,1,230,29003
2021-01-02,MO,Andrew,3,233,29003
2021-01-03,MO,Andrew,18,251,29003
2021-01-04,MO,Andrew,50,301,29003
2021-01-05,MO,Andrew,46,347,29003
2021-01-06,MO,Andrew,24,371,29003
2021-01-07,MO,Andrew,4,375,29003
2021-01-08,MO,Andrew,9,384,29003
2021-01-09,MO,Andrew,2,386,29003
2021-01-10,MO,Andrew,1,387,29003
2021-01-11,MO,Andrew,4,391,29003
2021-01-12,MO,Andrew,13,404,29003
2021-01-13,MO,Andrew,113,517,29003
2021-01-14,MO,Andrew,37,554,29003
2021-01-15,MO,Andrew,32,586,29003
2021-01-16,MO,Andrew,5,591,29003
2021-01-17,MO,Andrew,9,600,29003
2021-01-18,MO,Andrew,7,607,29003
2021-01-19,MO,Andrew,10,617,29003
2021-01-20,MO,Andrew,73,690,29003
2021-01-21,MO,Andrew,52,742,29003
2021-01-22,MO,Andrew,44,786,29003
2021-01-23,MO,Andrew,3,789,29003
2021-01-25,MO,Andrew,22,811,29003
2021-01-26,MO,Andrew,67,878,29003
2021-01-27,MO,Andrew,65,943,29003
2021-01-28,MO,Andrew,84,1027,29003
2021-01-29,MO,Andrew,626,1653,29003
2021-01-30,MO,Andrew,4,1657,29003
2021-01-31,MO,Andrew,123,1780,29003
2021-02-01,MO,Andrew,29,1809,29003
2021-02-02,MO,Andrew,179,1988,29003
2021-02-03,MO,Andrew,97,2085,29003
2021-02-04,MO,Andrew,72,2157,29003
2021-02-05,MO,Andrew,83,2240,29003
2021-02-06,MO,Andrew,6,2246,29003
2021-02-07,MO,Andrew,4,2250,29003
2021-02-08,MO,Andrew,21,2271,29003
2021-02-09,MO,Andrew,25,2296,29003
2021-02-10,MO,Andrew,84,2380,29003
2021-02-11,MO,Andrew,135,2515,29003
2021-02-12,MO,Andrew,86,2601,29003
2021-02-13,MO,Andrew,19,2620,29003
2021-02-14,MO,Andrew,4,2624,29003
2021-02-15,MO,Andrew,18,2642,29003
2021-02-16,MO,Andrew,25,2667,29003
2021-02-17,MO,Andrew,36,2703,29003
2021-02-18,MO,Andrew,25,2728,29003
2021-02-19,MO,Andrew,25,2753,29003
2021-02-20,MO,Andrew,5,2758,29003
2021-02-21,MO,Andrew,2,2760,29003
2021-02-22,MO,Andrew,681,3441,29003
2021-02-23,MO,Andrew,34,3475,29003
2021-02-24,MO,Andrew,27,3502,29003
2021-02-25,MO,Andrew,66,3568,29003
2021-02-26,MO,Andrew,162,3730,29003
2021-02-27,MO,Andrew,7,3737,29003
2021-02-28,MO,Andrew,1,3738,29003
2021-03-01,MO,Andrew,82,3820,29003
2021-03-02,MO,Andrew,113,3933,29003
2021-03-03,MO,Andrew,91,4024,29003
2021-03-04,MO,Andrew,96,4120,29003
2021-03-05,MO,Andrew,104,4224,29003
2021-03-06,MO,Andrew,26,4250,29003
2021-03-07,MO,Andrew,3,4253,29003
2021-03-08,MO,Andrew,27,4280,29003
2021-03-09,MO,Andrew,137,4417,29003
2021-03-10,MO,Andrew,73,4490,29003
2021-03-11,MO,Andrew,53,4543,29003
2021-03-12,MO,Andrew,148,4691,29003
2021-03-13,MO,Andrew,12,4703,29003
2021-03-14,MO,Andrew,1,4704,29003
2021-03-15,MO,Andrew,54,4758,29003
2021-03-16,MO,Andrew,131,4889,29003
2021-03-17,MO,Andrew,71,4960,29003
2021-03-18,MO,Andrew,104,5064,29003
2021-03-19,MO,Andrew,88,5152,29003
2021-03-20,MO,Andrew,8,5160,29003
2021-03-21,MO,Andrew,1,5161,29003
2021-03-22,MO,Andrew,26,5187,29003
2021-03-23,MO,Andrew,56,5243,29003
2021-03-24,MO,Andrew,73,5316,29003
2021-03-25,MO,Andrew,78,5394,29003
2021-03-26,MO,Andrew,90,5484,29003
2021-03-27,MO,Andrew,17,5501,29003
2021-03-28,MO,Andrew,3,5504,29003
2021-03-29,MO,Andrew,47,5551,29003
2021-03-30,MO,Andrew,111,5662,29003
2021-03-31,MO,Andrew,74,5736,29003
2021-04-01,MO,Andrew,84,5820,29003
2021-04-02,MO,Andrew,158,5978,29003
2021-04-03,MO,Andrew,32,6010,29003
2021-04-05,MO,Andrew,36,6046,29003
2021-04-06,MO,Andrew,110,6156,29003
2021-04-07,MO,Andrew,96,6252,29003
2021-04-08,MO,Andrew,91,6343,29003
2021-04-09,MO,Andrew,125,6468,29003
2021-04-10,MO,Andrew,19,6487,29003
2021-04-11,MO,Andrew,3,6490,29003
2021-04-12,MO,Andrew,58,6548,29003
2021-04-13,MO,Andrew,104,6652,29003
2021-04-14,MO,Andrew,142,6794,29003
2021-04-15,MO,Andrew,89,6883,29003
2021-04-16,MO,Andrew,157,7040,29003
2021-04-17,MO,Andrew,7,7047,29003
2021-04-18,MO,Andrew,1,7048,29003
2021-04-19,MO,Andrew,19,7067,29003
2021-04-20,MO,Andrew,83,7150,29003
2021-04-21,MO,Andrew,27,7177,29003
2021-04-22,MO,Andrew,41,7218,29003
2021-04-23,MO,Andrew,66,7284,29003
2021-04-24,MO,Andrew,10,7294,29003
2020-12-16,MO,Atchison,1,1,29005
2020-12-17,MO,Atchison,1,2,29005
2020-12-22,MO,Atchison,2,4,29005
2020-12-23,MO,Atchison,31,35,29005
2020-12-27,MO,Atchison,1,36,29005
2020-12-28,MO,Atchison,54,90,29005
2020-12-29,MO,Atchison,1,91,29005
2020-12-30,MO,Atchison,2,93,29005
2020-12-31,MO,Atchison,41,134,29005
2021-01-02,MO,Atchison,8,142,29005
2021-01-03,MO,Atchison,1,143,29005
2021-01-05,MO,Atchison,1,144,29005
2021-01-06,MO,Atchison,1,145,29005
2021-01-07,MO,Atchison,6,151,29005
2021-01-08,MO,Atchison,1,152,29005
2021-01-11,MO,Atchison,37,189,29005
2021-01-12,MO,Atchison,3,192,29005
2021-01-13,MO,Atchison,4,196,29005
2021-01-15,MO,Atchison,2,198,29005
2021-01-19,MO,Atchison,8,206,29005
2021-01-20,MO,Atchison,37,243,29005
2021-01-21,MO,Atchison,2,245,29005
2021-01-26,MO,Atchison,4,249,29005
2021-01-27,MO,Atchison,2,251,29005
2021-01-28,MO,Atchison,151,402,29005
2021-01-29,MO,Atchison,149,551,29005
2021-01-31,MO,Atchison,7,558,29005
2021-02-01,MO,Atchison,1,559,29005
2021-02-02,MO,Atchison,8,567,29005
2021-02-03,MO,Atchison,202,769,29005
2021-02-04,MO,Atchison,161,930,29005
2021-02-05,MO,Atchison,1,931,29005
2021-02-06,MO,Atchison,9,940,29005
2021-02-08,MO,Atchison,93,1033,29005
2021-02-09,MO,Atchison,7,1040,29005
2021-02-10,MO,Atchison,2,1042,29005
2021-02-11,MO,Atchison,180,1222,29005
2021-02-13,MO,Atchison,1,1223,29005
2021-02-15,MO,Atchison,1,1224,29005
2021-02-17,MO,Atchison,9,1233,29005
2021-02-19,MO,Atchison,3,1236,29005
2021-02-22,MO,Atchison,103,1339,29005
2021-02-24,MO,Atchison,3,1342,29005
2021-02-25,MO,Atchison,259,1601,29005
2021-02-26,MO,Atchison,43,1644,29005
2021-02-28,MO,Atchison,1,1645,29005
2021-03-01,MO,Atchison,5,1650,29005
2021-03-02,MO,Atchison,6,1656,29005
2021-03-03,MO,Atchison,71,1727,29005
2021-03-04,MO,Atchison,198,1925,29005
2021-03-05,MO,Atchison,2,1927,29005
2021-03-06,MO,Atchison,11,1938,29005
2021-03-08,MO,Atchison,87,2025,29005
2021-03-09,MO,Atchison,2,2027,29005
2021-03-10,MO,Atchison,2,2029,29005
2021-03-11,MO,Atchison,213,2242,29005
2021-03-12,MO,Atchison,27,2269,29005
2021-03-15,MO,Atchison,28,2297,29005
2021-03-16,MO,Atchison,21,2318,29005
2021-03-17,MO,Atchison,23,2341,29005
2021-03-18,MO,Atchison,172,2513,29005
2021-03-19,MO,Atchison,30,2543,29005
2021-03-20,MO,Atchison,8,2551,29005
2021-03-21,MO,Atchison,1,2552,29005
2021-03-22,MO,Atchison,38,2590,29005
2021-03-23,MO,Atchison,28,2618,29005
2021-03-24,MO,Atchison,18,2636,29005
2021-03-25,MO,Atchison,46,2682,29005
2021-03-26,MO,Atchison,16,2698,29005
2021-03-27,MO,Atchison,5,2703,29005
2021-03-29,MO,Atchison,68,2771,29005
2021-03-30,MO,Atchison,15,2786,29005
2021-03-31,MO,Atchison,10,2796,29005
2021-04-01,MO,Atchison,56,2852,29005
2021-04-02,MO,Atchison,4,2856,29005
2021-04-03,MO,Atchison,12,2868,29005
2021-04-05,MO,Atchison,44,2912,29005
2021-04-06,MO,Atchison,13,2925,29005
2021-04-07,MO,Atchison,23,2948,29005
2021-04-08,MO,Atchison,53,3001,29005
2021-04-09,MO,Atchison,12,3013,29005
2021-04-10,MO,Atchison,1,3014,29005
2021-04-12,MO,Atchison,89,3103,29005
2021-04-13,MO,Atchison,21,3124,29005
2021-04-14,MO,Atchison,21,3145,29005
2021-04-15,MO,Atchison,20,3165,29005
2021-04-16,MO,Atchison,35,3200,29005
2021-04-17,MO,Atchison,10,3210,29005
2021-04-19,MO,Atchison,29,3239,29005
2021-04-20,MO,Atchison,21,3260,29005
2021-04-21,MO,Atchison,20,3280,29005
2021-04-22,MO,Atchison,13,3293,29005
2021-04-23,MO,Atchison,9,3302,29005
2020-12-16,MO,Audrain,33,33,29007
2020-12-17,MO,Audrain,29,62,29007
2020-12-18,MO,Audrain,30,92,29007
2020-12-19,MO,Audrain,8,100,29007
2020-12-20,MO,Audrain,1,101,29007
2020-12-21,MO,Audrain,21,122,29007
2020-12-22,MO,Audrain,34,156,29007
2020-12-23,MO,Audrain,9,165,29007
2020-12-28,MO,Audrain,21,186,29007
2020-12-29,MO,Audrain,31,217,29007
2020-12-30,MO,Audrain,49,266,29007
2020-12-31,MO,Audrain,10,276,29007
2021-01-01,MO,Audrain,1,277,29007
2021-01-02,MO,Audrain,16,293,29007
2021-01-03,MO,Audrain,5,298,29007
2021-01-04,MO,Audrain,33,331,29007
2021-01-05,MO,Audrain,38,369,29007
2021-01-06,MO,Audrain,31,400,29007
2021-01-07,MO,Audrain,31,431,29007
2021-01-08,MO,Audrain,34,465,29007
2021-01-09,MO,Audrain,17,482,29007
2021-01-10,MO,Audrain,7,489,29007
2021-01-11,MO,Audrain,120,609,29007
2021-01-12,MO,Audrain,25,634,29007
2021-01-13,MO,Audrain,25,659,29007
2021-01-14,MO,Audrain,76,735,29007
2021-01-15,MO,Audrain,21,756,29007
2021-01-16,MO,Audrain,28,784,29007
2021-01-17,MO,Audrain,2,786,29007
2021-01-18,MO,Audrain,79,865,29007
2021-01-19,MO,Audrain,125,990,29007
2021-01-20,MO,Audrain,89,1079,29007
2021-01-21,MO,Audrain,154,1233,29007
2021-01-22,MO,Audrain,161,1394,29007
2021-01-23,MO,Audrain,8,1402,29007
2021-01-24,MO,Audrain,2,1404,29007
2021-01-25,MO,Audrain,13,1417,29007
2021-01-26,MO,Audrain,146,1563,29007
2021-01-27,MO,Audrain,139,1702,29007
2021-01-28,MO,Audrain,64,1766,29007
2021-01-29,MO,Audrain,619,2385,29007
2021-01-30,MO,Audrain,13,2398,29007
2021-01-31,MO,Audrain,9,2407,29007
2021-02-01,MO,Audrain,82,2489,29007
2021-02-02,MO,Audrain,223,2712,29007
2021-02-03,MO,Audrain,83,2795,29007
2021-02-04,MO,Audrain,224,3019,29007
2021-02-05,MO,Audrain,156,3175,29007
2021-02-06,MO,Audrain,20,3195,29007
2021-02-08,MO,Audrain,61,3256,29007
2021-02-09,MO,Audrain,300,3556,29007
2021-02-10,MO,Audrain,49,3605,29007
2021-02-11,MO,Audrain,210,3815,29007
2021-02-12,MO,Audrain,207,4022,29007
2021-02-13,MO,Audrain,40,4062,29007
2021-02-14,MO,Audrain,6,4068,29007
2021-02-15,MO,Audrain,68,4136,29007
2021-02-16,MO,Audrain,219,4355,29007
2021-02-17,MO,Audrain,100,4455,29007
2021-02-18,MO,Audrain,208,4663,29007
2021-02-19,MO,Audrain,229,4892,29007
2021-02-20,MO,Audrain,11,4903,29007
2021-02-21,MO,Audrain,10,4913,29007
2021-02-22,MO,Audrain,42,4955,29007
2021-02-23,MO,Audrain,166,5121,29007
2021-02-24,MO,Audrain,61,5182,29007
2021-02-25,MO,Audrain,765,5947,29007
2021-02-26,MO,Audrain,160,6107,29007
2021-02-27,MO,Audrain,18,6125,29007
2021-02-28,MO,Audrain,1,6126,29007
2021-03-01,MO,Audrain,28,6154,29007
2021-03-02,MO,Audrain,168,6322,29007
2021-03-03,MO,Audrain,108,6430,29007
2021-03-04,MO,Audrain,163,6593,29007
2021-03-05,MO,Audrain,75,6668,29007
2021-03-06,MO,Audrain,19,6687,29007
2021-03-07,MO,Audrain,13,6700,29007
2021-03-08,MO,Audrain,81,6781,29007
2021-03-09,MO,Audrain,111,6892,29007
2021-03-10,MO,Audrain,78,6970,29007
2021-03-11,MO,Audrain,212,7182,29007
2021-03-12,MO,Audrain,148,7330,29007
2021-03-13,MO,Audrain,11,7341,29007
2021-03-14,MO,Audrain,3,7344,29007
2021-03-15,MO,Audrain,196,7540,29007
2021-03-16,MO,Audrain,144,7684,29007
2021-03-17,MO,Audrain,95,7779,29007
2021-03-18,MO,Audrain,126,7905,29007
2021-03-19,MO,Audrain,129,8034,29007
2021-03-20,MO,Audrain,30,8064,29007
2021-03-21,MO,Audrain,18,8082,29007
2021-03-22,MO,Audrain,91,8173,29007
2021-03-23,MO,Audrain,119,8292,29007
2021-03-24,MO,Audrain,72,8364,29007
2021-03-25,MO,Audrain,126,8490,29007
2021-03-26,MO,Audrain,125,8615,29007
2021-03-27,MO,Audrain,14,8629,29007
2021-03-28,MO,Audrain,10,8639,29007
2021-03-29,MO,Audrain,28,8667,29007
2021-03-30,MO,Audrain,138,8805,29007
2021-03-31,MO,Audrain,120,8925,29007
2021-04-01,MO,Audrain,101,9026,29007
2021-04-02,MO,Audrain,146,9172,29007
2021-04-03,MO,Audrain,42,9214,29007
2021-04-04,MO,Audrain,3,9217,29007
2021-04-05,MO,Audrain,93,9310,29007
2021-04-06,MO,Audrain,197,9507,29007
2021-04-07,MO,Audrain,168,9675,29007
2021-04-08,MO,Audrain,85,9760,29007
2021-04-09,MO,Audrain,123,9883,29007
2021-04-10,MO,Audrain,26,9909,29007
2021-04-11,MO,Audrain,16,9925,29007
2021-04-12,MO,Audrain,188,10113,29007
2021-04-13,MO,Audrain,127,10240,29007
2021-04-14,MO,Audrain,82,10322,29007
2021-04-15,MO,Audrain,106,10428,29007
2021-04-16,MO,Audrain,96,10524,29007
2021-04-17,MO,Audrain,26,10550,29007
2021-04-18,MO,Audrain,10,10560,29007
2021-04-19,MO,Audrain,40,10600,29007
2021-04-20,MO,Audrain,117,10717,29007
2021-04-21,MO,Audrain,41,10758,29007
2021-04-22,MO,Audrain,81,10839,29007
2021-04-23,MO,Audrain,91,10930,29007
2021-04-24,MO,Audrain,39,10969,29007
2020-12-15,MO,Barry,4,4,29009
2020-12-16,MO,Barry,1,5,29009
2020-12-17,MO,Barry,21,26,29009
2020-12-18,MO,Barry,4,30,29009
2020-12-19,MO,Barry,3,33,29009
2020-12-20,MO,Barry,1,34,29009
2020-12-21,MO,Barry,25,59,29009
2020-12-22,MO,Barry,50,109,29009
2020-12-23,MO,Barry,38,147,29009
2020-12-24,MO,Barry,8,155,29009
2020-12-26,MO,Barry,3,158,29009
2020-12-27,MO,Barry,1,159,29009
2020-12-28,MO,Barry,35,194,29009
2020-12-29,MO,Barry,60,254,29009
2020-12-30,MO,Barry,37,291,29009
2020-12-31,MO,Barry,13,304,29009
2021-01-03,MO,Barry,1,305,29009
2021-01-04,MO,Barry,12,317,29009
2021-01-05,MO,Barry,10,327,29009
2021-01-06,MO,Barry,11,338,29009
2021-01-07,MO,Barry,60,398,29009
2021-01-08,MO,Barry,104,502,29009
2021-01-09,MO,Barry,2,504,29009
2021-01-10,MO,Barry,3,507,29009
2021-01-11,MO,Barry,65,572,29009
2021-01-12,MO,Barry,39,611,29009
2021-01-13,MO,Barry,22,633,29009
2021-01-14,MO,Barry,22,655,29009
2021-01-15,MO,Barry,12,667,29009
2021-01-16,MO,Barry,7,674,29009
2021-01-17,MO,Barry,28,702,29009
2021-01-18,MO,Barry,5,707,29009
2021-01-19,MO,Barry,76,783,29009
2021-01-20,MO,Barry,92,875,29009
2021-01-21,MO,Barry,74,949,29009
2021-01-22,MO,Barry,12,961,29009
2021-01-23,MO,Barry,12,973,29009
2021-01-24,MO,Barry,1,974,29009
2021-01-25,MO,Barry,48,1022,29009
2021-01-26,MO,Barry,112,1134,29009
2021-01-27,MO,Barry,43,1177,29009
2021-01-28,MO,Barry,38,1215,29009
2021-01-29,MO,Barry,183,1398,29009
2021-01-30,MO,Barry,10,1408,29009
2021-01-31,MO,Barry,1,1409,29009
2021-02-01,MO,Barry,32,1441,29009
2021-02-02,MO,Barry,88,1529,29009
2021-02-03,MO,Barry,53,1582,29009
2021-02-04,MO,Barry,104,1686,29009
2021-02-05,MO,Barry,251,1937,29009
2021-02-06,MO,Barry,32,1969,29009
2021-02-07,MO,Barry,1,1970,29009
2021-02-08,MO,Barry,59,2029,29009
2021-02-09,MO,Barry,92,2121,29009
2021-02-10,MO,Barry,60,2181,29009
2021-02-11,MO,Barry,39,2220,29009
2021-02-12,MO,Barry,133,2353,29009
2021-02-13,MO,Barry,55,2408,29009
2021-02-14,MO,Barry,57,2465,29009
2021-02-15,MO,Barry,194,2659,29009
2021-02-16,MO,Barry,172,2831,29009
2021-02-17,MO,Barry,63,2894,29009
2021-02-18,MO,Barry,314,3208,29009
2021-02-19,MO,Barry,96,3304,29009
2021-02-20,MO,Barry,12,3316,29009
2021-02-21,MO,Barry,1,3317,29009
2021-02-22,MO,Barry,14,3331,29009
2021-02-23,MO,Barry,176,3507,29009
2021-02-24,MO,Barry,296,3803,29009
2021-02-25,MO,Barry,65,3868,29009
2021-02-26,MO,Barry,128,3996,29009
2021-02-27,MO,Barry,40,4036,29009
2021-02-28,MO,Barry,1,4037,29009
2021-03-01,MO,Barry,271,4308,29009
2021-03-02,MO,Barry,274,4582,29009
2021-03-03,MO,Barry,134,4716,29009
2021-03-04,MO,Barry,652,5368,29009
2021-03-05,MO,Barry,714,6082,29009
2021-03-06,MO,Barry,41,6123,29009
2021-03-07,MO,Barry,13,6136,29009
2021-03-08,MO,Barry,242,6378,29009
2021-03-09,MO,Barry,128,6506,29009
2021-03-10,MO,Barry,260,6766,29009
2021-03-11,MO,Barry,215,6981,29009
2021-03-12,MO,Barry,277,7258,29009
2021-03-13,MO,Barry,65,7323,29009
2021-03-14,MO,Barry,27,7350,29009
2021-03-15,MO,Barry,688,8038,29009
2021-03-16,MO,Barry,248,8286,29009
2021-03-17,MO,Barry,147,8433,29009
2021-03-18,MO,Barry,371,8804,29009
2021-03-19,MO,Barry,343,9147,29009
2021-03-20,MO,Barry,188,9335,29009
2021-03-21,MO,Barry,10,9345,29009
2021-03-22,MO,Barry,96,9441,29009
2021-03-23,MO,Barry,322,9763,29009
2021-03-24,MO,Barry,381,10144,29009
2021-03-25,MO,Barry,689,10833,29009
2021-03-26,MO,Barry,654,11487,29009
2021-03-27,MO,Barry,51,11538,29009
2021-03-28,MO,Barry,12,11550,29009
2021-03-29,MO,Barry,306,11856,29009
2021-03-30,MO,Barry,304,12160,29009
2021-03-31,MO,Barry,230,12390,29009
2021-04-01,MO,Barry,326,12716,29009
2021-04-02,MO,Barry,191,12907,29009
2021-04-03,MO,Barry,39,12946,29009
2021-04-04,MO,Barry,19,12965,29009
2021-04-05,MO,Barry,738,13703,29009
2021-04-06,MO,Barry,224,13927,29009
2021-04-07,MO,Barry,185,14112,29009
2021-04-08,MO,Barry,167,14279,29009
2021-04-09,MO,Barry,496,14775,29009
2021-04-10,MO,Barry,116,14891,29009
2021-04-11,MO,Barry,34,14925,29009
2021-04-12,MO,Barry,185,15110,29009
2021-04-13,MO,Barry,285,15395,29009
2021-04-14,MO,Barry,139,15534,29009
2021-04-15,MO,Barry,225,15759,29009
2021-04-16,MO,Barry,191,15950,29009
2021-04-17,MO,Barry,46,15996,29009
2021-04-18,MO,Barry,12,16008,29009
2021-04-19,MO,Barry,117,16125,29009
2021-04-20,MO,Barry,94,16219,29009
2021-04-21,MO,Barry,134,16353,29009
2021-04-22,MO,Barry,278,16631,29009
2021-04-23,MO,Barry,134,16765,29009
2021-04-24,MO,Barry,30,16795,29009
2021-04-25,MO,Barry,4,16799,29009
2020-12-18,MO,Barton,7,7,29011
2020-12-20,MO,Barton,2,9,29011
2020-12-21,MO,Barton,3,12,29011
2020-12-22,MO,Barton,1,13,29011
2020-12-23,MO,Barton,28,41,29011
2020-12-24,MO,Barton,1,42,29011
2020-12-28,MO,Barton,3,45,29011
2020-12-29,MO,Barton,22,67,29011
2020-12-30,MO,Barton,4,71,29011
2020-12-31,MO,Barton,8,79,29011
2021-01-04,MO,Barton,1,80,29011
2021-01-05,MO,Barton,50,130,29011
2021-01-06,MO,Barton,9,139,29011
2021-01-07,MO,Barton,6,145,29011
2021-01-08,MO,Barton,29,174,29011
2021-01-09,MO,Barton,1,175,29011
2021-01-10,MO,Barton,1,176,29011
2021-01-11,MO,Barton,5,181,29011
2021-01-12,MO,Barton,9,190,29011
2021-01-13,MO,Barton,4,194,29011
2021-01-14,MO,Barton,5,199,29011
2021-01-15,MO,Barton,2,201,29011
2021-01-16,MO,Barton,1,202,29011
2021-01-17,MO,Barton,1,203,29011
2021-01-19,MO,Barton,4,207,29011
2021-01-20,MO,Barton,9,216,29011
2021-01-21,MO,Barton,46,262,29011
2021-01-22,MO,Barton,5,267,29011
2021-01-23,MO,Barton,3,270,29011
2021-01-25,MO,Barton,12,282,29011
2021-01-26,MO,Barton,42,324,29011
2021-01-27,MO,Barton,12,336,29011
2021-01-28,MO,Barton,12,348,29011
2021-01-29,MO,Barton,9,357,29011
2021-01-30,MO,Barton,11,368,29011
2021-02-01,MO,Barton,23,391,29011
2021-02-02,MO,Barton,80,471,29011
2021-02-03,MO,Barton,24,495,29011
2021-02-04,MO,Barton,120,615,29011
2021-02-05,MO,Barton,97,712,29011
2021-02-06,MO,Barton,3,715,29011
2021-02-08,MO,Barton,54,769,29011
2021-02-09,MO,Barton,24,793,29011
2021-02-10,MO,Barton,41,834,29011
2021-02-11,MO,Barton,17,851,29011
2021-02-12,MO,Barton,38,889,29011
2021-02-13,MO,Barton,21,910,29011
2021-02-14,MO,Barton,8,918,29011
2021-02-15,MO,Barton,21,939,29011
2021-02-16,MO,Barton,27,966,29011
2021-02-17,MO,Barton,11,977,29011
2021-02-18,MO,Barton,59,1036,29011
2021-02-19,MO,Barton,121,1157,29011
2021-02-20,MO,Barton,7,1164,29011
2021-02-22,MO,Barton,7,1171,29011
2021-02-23,MO,Barton,32,1203,29011
2021-02-24,MO,Barton,13,1216,29011
2021-02-25,MO,Barton,26,1242,29011
2021-02-26,MO,Barton,127,1369,29011
2021-02-27,MO,Barton,4,1373,29011
2021-03-01,MO,Barton,37,1410,29011
2021-03-02,MO,Barton,68,1478,29011
2021-03-03,MO,Barton,48,1526,29011
2021-03-04,MO,Barton,211,1737,29011
2021-03-05,MO,Barton,96,1833,29011
2021-03-06,MO,Barton,12,1845,29011
2021-03-07,MO,Barton,7,1852,29011
2021-03-08,MO,Barton,71,1923,29011
2021-03-09,MO,Barton,102,2025,29011
2021-03-10,MO,Barton,82,2107,29011
2021-03-11,MO,Barton,48,2155,29011
2021-03-12,MO,Barton,44,2199,29011
2021-03-13,MO,Barton,21,2220,29011
2021-03-14,MO,Barton,9,2229,29011
2021-03-15,MO,Barton,56,2285,29011
2021-03-16,MO,Barton,58,2343,29011
2021-03-17,MO,Barton,66,2409,29011
2021-03-18,MO,Barton,74,2483,29011
2021-03-19,MO,Barton,129,2612,29011
2021-03-20,MO,Barton,13,2625,29011
2021-03-21,MO,Barton,7,2632,29011
2021-03-22,MO,Barton,105,2737,29011
2021-03-23,MO,Barton,54,2791,29011
2021-03-24,MO,Barton,25,2816,29011
2021-03-25,MO,Barton,28,2844,29011
2021-03-26,MO,Barton,140,2984,29011
2021-03-27,MO,Barton,16,3000,29011
2021-03-28,MO,Barton,12,3012,29011
2021-03-29,MO,Barton,53,3065,29011
2021-03-30,MO,Barton,44,3109,29011
2021-03-31,MO,Barton,56,3165,29011
2021-04-01,MO,Barton,56,3221,29011
2021-04-02,MO,Barton,47,3268,29011
2021-04-03,MO,Barton,20,3288,29011
2021-04-04,MO,Barton,7,3295,29011
2021-04-05,MO,Barton,28,3323,29011
2021-04-06,MO,Barton,51,3374,29011
2021-04-07,MO,Barton,28,3402,29011
2021-04-08,MO,Barton,56,3458,29011
2021-04-09,MO,Barton,175,3633,29011
2021-04-10,MO,Barton,12,3645,29011
2021-04-11,MO,Barton,11,3656,29011
2021-04-12,MO,Barton,91,3747,29011
2021-04-13,MO,Barton,16,3763,29011
2021-04-14,MO,Barton,36,3799,29011
2021-04-15,MO,Barton,34,3833,29011
2021-04-16,MO,Barton,50,3883,29011
2021-04-17,MO,Barton,11,3894,29011
2021-04-18,MO,Barton,7,3901,29011
2021-04-19,MO,Barton,83,3984,29011
2021-04-20,MO,Barton,42,4026,29011
2021-04-21,MO,Barton,33,4059,29011
2021-04-22,MO,Barton,24,4083,29011
2021-04-23,MO,Barton,71,4154,29011
2021-04-24,MO,Barton,17,4171,29011
2021-04-25,MO,Barton,8,4179,29011
2020-12-18,MO,Bates,2,2,29013
2020-12-19,MO,Bates,2,4,29013
2020-12-21,MO,Bates,3,7,29013
2020-12-22,MO,Bates,3,10,29013
2020-12-23,MO,Bates,5,15,29013
2020-12-24,MO,Bates,4,19,29013
2020-12-26,MO,Bates,5,24,29013
2020-12-28,MO,Bates,10,34,29013
2020-12-29,MO,Bates,9,43,29013
2020-12-30,MO,Bates,8,51,29013
2020-12-31,MO,Bates,87,138,29013
2021-01-03,MO,Bates,2,140,29013
2021-01-04,MO,Bates,8,148,29013
2021-01-05,MO,Bates,7,155,29013
2021-01-06,MO,Bates,62,217,29013
2021-01-07,MO,Bates,16,233,29013
2021-01-08,MO,Bates,65,298,29013
2021-01-09,MO,Bates,1,299,29013
2021-01-11,MO,Bates,23,322,29013
2021-01-12,MO,Bates,36,358,29013
2021-01-13,MO,Bates,26,384,29013
2021-01-14,MO,Bates,14,398,29013
2021-01-15,MO,Bates,61,459,29013
2021-01-16,MO,Bates,2,461,29013
2021-01-17,MO,Bates,1,462,29013
2021-01-18,MO,Bates,1,463,29013
2021-01-19,MO,Bates,3,466,29013
2021-01-20,MO,Bates,15,481,29013
2021-01-21,MO,Bates,7,488,29013
2021-01-22,MO,Bates,17,505,29013
2021-01-23,MO,Bates,16,521,29013
2021-01-25,MO,Bates,6,527,29013
2021-01-26,MO,Bates,119,646,29013
2021-01-27,MO,Bates,41,687,29013
2021-01-28,MO,Bates,116,803,29013
2021-01-29,MO,Bates,113,916,29013
2021-01-30,MO,Bates,22,938,29013
2021-01-31,MO,Bates,2,940,29013
2021-02-01,MO,Bates,66,1006,29013
2021-02-02,MO,Bates,105,1111,29013
2021-02-03,MO,Bates,48,1159,29013
2021-02-04,MO,Bates,37,1196,29013
2021-02-05,MO,Bates,96,1292,29013
2021-02-06,MO,Bates,2,1294,29013
2021-02-08,MO,Bates,69,1363,29013
2021-02-09,MO,Bates,52,1415,29013
2021-02-10,MO,Bates,76,1491,29013
2021-02-11,MO,Bates,234,1725,29013
2021-02-12,MO,Bates,200,1925,29013
2021-02-13,MO,Bates,29,1954,29013
2021-02-14,MO,Bates,12,1966,29013
2021-02-15,MO,Bates,32,1998,29013
2021-02-16,MO,Bates,41,2039,29013
2021-02-17,MO,Bates,22,2061,29013
2021-02-18,MO,Bates,44,2105,29013
2021-02-19,MO,Bates,37,2142,29013
2021-02-20,MO,Bates,8,2150,29013
2021-02-21,MO,Bates,2,2152,29013
2021-02-22,MO,Bates,11,2163,29013
2021-02-23,MO,Bates,97,2260,29013
2021-02-24,MO,Bates,27,2287,29013
2021-02-25,MO,Bates,298,2585,29013
2021-02-26,MO,Bates,94,2679,29013
2021-02-27,MO,Bates,12,2691,29013
2021-02-28,MO,Bates,12,2703,29013
2021-03-01,MO,Bates,62,2765,29013
2021-03-02,MO,Bates,87,2852,29013
2021-03-03,MO,Bates,103,2955,29013
2021-03-04,MO,Bates,75,3030,29013
2021-03-05,MO,Bates,64,3094,29013
2021-03-06,MO,Bates,9,3103,29013
2021-03-07,MO,Bates,8,3111,29013
2021-03-08,MO,Bates,97,3208,29013
2021-03-09,MO,Bates,76,3284,29013
2021-03-10,MO,Bates,199,3483,29013
2021-03-11,MO,Bates,241,3724,29013
2021-03-12,MO,Bates,184,3908,29013
2021-03-13,MO,Bates,26,3934,29013
2021-03-14,MO,Bates,11,3945,29013
2021-03-15,MO,Bates,26,3971,29013
2021-03-16,MO,Bates,152,4123,29013
2021-03-17,MO,Bates,55,4178,29013
2021-03-18,MO,Bates,280,4458,29013
2021-03-19,MO,Bates,89,4547,29013
2021-03-20,MO,Bates,15,4562,29013
2021-03-21,MO,Bates,7,4569,29013
2021-03-22,MO,Bates,97,4666,29013
2021-03-23,MO,Bates,26,4692,29013
2021-03-24,MO,Bates,58,4750,29013
2021-03-25,MO,Bates,152,4902,29013
2021-03-26,MO,Bates,87,4989,29013
2021-03-27,MO,Bates,19,5008,29013
2021-03-28,MO,Bates,12,5020,29013
2021-03-29,MO,Bates,45,5065,29013
2021-03-30,MO,Bates,55,5120,29013
2021-03-31,MO,Bates,82,5202,29013
2021-04-01,MO,Bates,182,5384,29013
2021-04-02,MO,Bates,108,5492,29013
2021-04-03,MO,Bates,13,5505,29013
2021-04-04,MO,Bates,5,5510,29013
2021-04-05,MO,Bates,46,5556,29013
2021-04-06,MO,Bates,121,5677,29013
2021-04-07,MO,Bates,46,5723,29013
2021-04-08,MO,Bates,41,5764,29013
2021-04-09,MO,Bates,64,5828,29013
2021-04-10,MO,Bates,44,5872,29013
2021-04-11,MO,Bates,6,5878,29013
2021-04-12,MO,Bates,49,5927,29013
2021-04-13,MO,Bates,152,6079,29013
2021-04-14,MO,Bates,51,6130,29013
2021-04-15,MO,Bates,156,6286,29013
2021-04-16,MO,Bates,68,6354,29013
2021-04-17,MO,Bates,14,6368,29013
2021-04-18,MO,Bates,7,6375,29013
2021-04-19,MO,Bates,64,6439,29013
2021-04-20,MO,Bates,49,6488,29013
2021-04-21,MO,Bates,51,6539,29013
2021-04-22,MO,Bates,31,6570,29013
2021-04-23,MO,Bates,53,6623,29013
2021-04-24,MO,Bates,12,6635,29013
2021-04-25,MO,Bates,1,6636,29013
2020-12-17,MO,Benton,1,1,29015
2020-12-18,MO,Benton,7,8,29015
2020-12-19,MO,Benton,7,15,29015
2020-12-21,MO,Benton,39,54,29015
2020-12-22,MO,Benton,20,74,29015
2020-12-23,MO,Benton,54,128,29015
2020-12-24,MO,Benton,8,136,29015
2020-12-28,MO,Benton,9,145,29015
2020-12-29,MO,Benton,49,194,29015
2020-12-30,MO,Benton,18,212,29015
2020-12-31,MO,Benton,9,221,29015
2021-01-02,MO,Benton,1,222,29015
2021-01-03,MO,Benton,2,224,29015
2021-01-04,MO,Benton,4,228,29015
2021-01-05,MO,Benton,2,230,29015
2021-01-06,MO,Benton,28,258,29015
2021-01-07,MO,Benton,8,266,29015
2021-01-08,MO,Benton,65,331,29015
2021-01-09,MO,Benton,3,334,29015
2021-01-11,MO,Benton,49,383,29015
2021-01-12,MO,Benton,26,409,29015
2021-01-13,MO,Benton,86,495,29015
2021-01-14,MO,Benton,34,529,29015
2021-01-15,MO,Benton,27,556,29015
2021-01-16,MO,Benton,4,560,29015
2021-01-18,MO,Benton,13,573,29015
2021-01-19,MO,Benton,34,607,29015
2021-01-20,MO,Benton,17,624,29015
2021-01-21,MO,Benton,18,642,29015
2021-01-22,MO,Benton,24,666,29015
2021-01-23,MO,Benton,97,763,29015
2021-01-25,MO,Benton,9,772,29015
2021-01-26,MO,Benton,109,881,29015
2021-01-27,MO,Benton,63,944,29015
2021-01-28,MO,Benton,165,1109,29015
2021-01-29,MO,Benton,222,1331,29015
2021-01-30,MO,Benton,52,1383,29015
2021-01-31,MO,Benton,9,1392,29015
2021-02-01,MO,Benton,72,1464,29015
2021-02-02,MO,Benton,146,1610,29015
2021-02-03,MO,Benton,323,1933,29015
2021-02-04,MO,Benton,59,1992,29015
2021-02-05,MO,Benton,542,2534,29015
2021-02-06,MO,Benton,14,2548,29015
2021-02-07,MO,Benton,1,2549,29015
2021-02-08,MO,Benton,26,2575,29015
2021-02-09,MO,Benton,42,2617,29015
2021-02-10,MO,Benton,82,2699,29015
2021-02-11,MO,Benton,34,2733,29015
2021-02-12,MO,Benton,519,3252,29015
2021-02-13,MO,Benton,202,3454,29015
2021-02-14,MO,Benton,49,3503,29015
2021-02-15,MO,Benton,18,3521,29015
2021-02-16,MO,Benton,35,3556,29015
2021-02-17,MO,Benton,38,3594,29015
2021-02-18,MO,Benton,74,3668,29015
2021-02-19,MO,Benton,134,3802,29015
2021-02-20,MO,Benton,8,3810,29015
2021-02-21,MO,Benton,7,3817,29015
2021-02-22,MO,Benton,23,3840,29015
2021-02-23,MO,Benton,731,4571,29015
2021-02-24,MO,Benton,229,4800,29015
2021-02-25,MO,Benton,140,4940,29015
2021-02-26,MO,Benton,201,5141,29015
2021-02-27,MO,Benton,97,5238,29015
2021-02-28,MO,Benton,29,5267,29015
2021-03-01,MO,Benton,55,5322,29015
2021-03-02,MO,Benton,167,5489,29015
2021-03-03,MO,Benton,288,5777,29015
2021-03-04,MO,Benton,57,5834,29015
2021-03-05,MO,Benton,508,6342,29015
2021-03-06,MO,Benton,20,6362,29015
2021-03-07,MO,Benton,15,6377,29015
2021-03-08,MO,Benton,31,6408,29015
2021-03-09,MO,Benton,45,6453,29015
2021-03-10,MO,Benton,71,6524,29015
2021-03-11,MO,Benton,46,6570,29015
2021-03-12,MO,Benton,557,7127,29015
2021-03-13,MO,Benton,114,7241,29015
2021-03-14,MO,Benton,50,7291,29015
2021-03-15,MO,Benton,441,7732,29015
2021-03-16,MO,Benton,55,7787,29015
2021-03-17,MO,Benton,642,8429,29015
2021-03-18,MO,Benton,204,8633,29015
2021-03-19,MO,Benton,210,8843,29015
2021-03-20,MO,Benton,15,8858,29015
2021-03-21,MO,Benton,5,8863,29015
2021-03-22,MO,Benton,43,8906,29015
2021-03-23,MO,Benton,47,8953,29015
2021-03-24,MO,Benton,58,9011,29015
2021-03-25,MO,Benton,90,9101,29015
2021-03-26,MO,Benton,72,9173,29015
2021-03-27,MO,Benton,97,9270,29015
2021-03-28,MO,Benton,32,9302,29015
2021-03-29,MO,Benton,49,9351,29015
2021-03-30,MO,Benton,240,9591,29015
2021-03-31,MO,Benton,63,9654,29015
2021-04-01,MO,Benton,86,9740,29015
2021-04-02,MO,Benton,33,9773,29015
2021-04-03,MO,Benton,11,9784,29015
2021-04-04,MO,Benton,2,9786,29015
2021-04-05,MO,Benton,375,10161,29015
2021-04-06,MO,Benton,90,10251,29015
2021-04-07,MO,Benton,67,10318,29015
2021-04-08,MO,Benton,30,10348,29015
2021-04-09,MO,Benton,157,10505,29015
2021-04-10,MO,Benton,29,10534,29015
2021-04-11,MO,Benton,7,10541,29015
2021-04-12,MO,Benton,131,10672,29015
2021-04-13,MO,Benton,29,10701,29015
2021-04-14,MO,Benton,75,10776,29015
2021-04-15,MO,Benton,79,10855,29015
2021-04-16,MO,Benton,137,10992,29015
2021-04-17,MO,Benton,13,11005,29015
2021-04-18,MO,Benton,3,11008,29015
2021-04-19,MO,Benton,39,11047,29015
2021-04-20,MO,Benton,33,11080,29015
2021-04-21,MO,Benton,54,11134,29015
2021-04-22,MO,Benton,75,11209,29015
2021-04-23,MO,Benton,46,11255,29015
2021-04-24,MO,Benton,19,11274,29015
2021-04-25,MO,Benton,1,11275,29015
2020-12-16,MO,Bollinger,1,1,29017
2020-12-17,MO,Bollinger,12,13,29017
2020-12-18,MO,Bollinger,2,15,29017
2020-12-21,MO,Bollinger,26,41,29017
2020-12-22,MO,Bollinger,25,66,29017
2020-12-23,MO,Bollinger,13,79,29017
2020-12-24,MO,Bollinger,3,82,29017
2020-12-26,MO,Bollinger,1,83,29017
2020-12-28,MO,Bollinger,3,86,29017
2020-12-29,MO,Bollinger,5,91,29017
2020-12-30,MO,Bollinger,31,122,29017
2020-12-31,MO,Bollinger,5,127,29017
2021-01-02,MO,Bollinger,2,129,29017
2021-01-05,MO,Bollinger,24,153,29017
2021-01-06,MO,Bollinger,11,164,29017
2021-01-07,MO,Bollinger,7,171,29017
2021-01-08,MO,Bollinger,43,214,29017
2021-01-09,MO,Bollinger,58,272,29017
2021-01-11,MO,Bollinger,32,304,29017
2021-01-12,MO,Bollinger,22,326,29017
2021-01-13,MO,Bollinger,31,357,29017
2021-01-14,MO,Bollinger,9,366,29017
2021-01-15,MO,Bollinger,21,387,29017
2021-01-16,MO,Bollinger,6,393,29017
2021-01-17,MO,Bollinger,2,395,29017
2021-01-18,MO,Bollinger,32,427,29017
2021-01-19,MO,Bollinger,61,488,29017
2021-01-20,MO,Bollinger,103,591,29017
2021-01-21,MO,Bollinger,42,633,29017
2021-01-22,MO,Bollinger,102,735,29017
2021-01-24,MO,Bollinger,1,736,29017
2021-01-25,MO,Bollinger,56,792,29017
2021-01-26,MO,Bollinger,34,826,29017
2021-01-27,MO,Bollinger,43,869,29017
2021-01-28,MO,Bollinger,183,1052,29017
2021-01-29,MO,Bollinger,60,1112,29017
2021-01-30,MO,Bollinger,1,1113,29017
2021-02-01,MO,Bollinger,7,1120,29017
2021-02-02,MO,Bollinger,43,1163,29017
2021-02-03,MO,Bollinger,178,1341,29017
2021-02-04,MO,Bollinger,21,1362,29017
2021-02-05,MO,Bollinger,113,1475,29017
2021-02-06,MO,Bollinger,60,1535,29017
2021-02-08,MO,Bollinger,55,1590,29017
2021-02-09,MO,Bollinger,90,1680,29017
2021-02-10,MO,Bollinger,75,1755,29017
2021-02-11,MO,Bollinger,35,1790,29017
2021-02-12,MO,Bollinger,107,1897,29017
2021-02-13,MO,Bollinger,3,1900,29017
2021-02-14,MO,Bollinger,3,1903,29017
2021-02-15,MO,Bollinger,26,1929,29017
2021-02-16,MO,Bollinger,10,1939,29017
2021-02-17,MO,Bollinger,9,1948,29017
2021-02-18,MO,Bollinger,5,1953,29017
2021-02-19,MO,Bollinger,124,2077,29017
2021-02-20,MO,Bollinger,14,2091,29017
2021-02-21,MO,Bollinger,1,2092,29017
2021-02-22,MO,Bollinger,118,2210,29017
2021-02-23,MO,Bollinger,83,2293,29017
2021-02-24,MO,Bollinger,59,2352,29017
2021-02-25,MO,Bollinger,7,2359,29017
2021-02-26,MO,Bollinger,52,2411,29017
2021-02-27,MO,Bollinger,16,2427,29017
2021-03-01,MO,Bollinger,6,2433,29017
2021-03-02,MO,Bollinger,196,2629,29017
2021-03-03,MO,Bollinger,184,2813,29017
2021-03-04,MO,Bollinger,21,2834,29017
2021-03-05,MO,Bollinger,132,2966,29017
2021-03-06,MO,Bollinger,2,2968,29017
2021-03-07,MO,Bollinger,1,2969,29017
2021-03-08,MO,Bollinger,61,3030,29017
2021-03-09,MO,Bollinger,35,3065,29017
2021-03-10,MO,Bollinger,32,3097,29017
2021-03-11,MO,Bollinger,24,3121,29017
2021-03-12,MO,Bollinger,46,3167,29017
2021-03-13,MO,Bollinger,1,3168,29017
2021-03-15,MO,Bollinger,43,3211,29017
2021-03-16,MO,Bollinger,17,3228,29017
2021-03-17,MO,Bollinger,118,3346,29017
2021-03-18,MO,Bollinger,9,3355,29017
2021-03-19,MO,Bollinger,139,3494,29017
2021-03-20,MO,Bollinger,3,3497,29017
2021-03-21,MO,Bollinger,2,3499,29017
2021-03-22,MO,Bollinger,42,3541,29017
2021-03-23,MO,Bollinger,10,3551,29017
2021-03-24,MO,Bollinger,66,3617,29017
2021-03-25,MO,Bollinger,132,3749,29017
2021-03-26,MO,Bollinger,18,3767,29017
2021-03-27,MO,Bollinger,5,3772,29017
2021-03-28,MO,Bollinger,1,3773,29017
2021-03-29,MO,Bollinger,36,3809,29017
2021-03-30,MO,Bollinger,47,3856,29017
2021-03-31,MO,Bollinger,110,3966,29017
2021-04-01,MO,Bollinger,31,3997,29017
2021-04-02,MO,Bollinger,53,4050,29017
2021-04-03,MO,Bollinger,4,4054,29017
2021-04-05,MO,Bollinger,36,4090,29017
2021-04-06,MO,Bollinger,40,4130,29017
2021-04-07,MO,Bollinger,49,4179,29017
2021-04-08,MO,Bollinger,21,4200,29017
2021-04-09,MO,Bollinger,110,4310,29017
2021-04-10,MO,Bollinger,6,4316,29017
2021-04-11,MO,Bollinger,4,4320,29017
2021-04-12,MO,Bollinger,40,4360,29017
2021-04-13,MO,Bollinger,20,4380,29017
2021-04-14,MO,Bollinger,43,4423,29017
2021-04-15,MO,Bollinger,8,4431,29017
2021-04-16,MO,Bollinger,61,4492,29017
2021-04-17,MO,Bollinger,7,4499,29017
2021-04-19,MO,Bollinger,34,4533,29017
2021-04-20,MO,Bollinger,16,4549,29017
2021-04-21,MO,Bollinger,61,4610,29017
2021-04-22,MO,Bollinger,16,4626,29017
2021-04-23,MO,Bollinger,8,4634,29017
2021-04-24,MO,Bollinger,5,4639,29017
2020-12-14,MO,Boone,1,1,29019
2020-12-15,MO,Boone,27,28,29019
2020-12-16,MO,Boone,352,380,29019
2020-12-17,MO,Boone,537,917,29019
2020-12-18,MO,Boone,696,1613,29019
2020-12-19,MO,Boone,538,2151,29019
2020-12-20,MO,Boone,352,2503,29019
2020-12-21,MO,Boone,509,3012,29019
2020-12-22,MO,Boone,615,3627,29019
2020-12-23,MO,Boone,248,3875,29019
2020-12-24,MO,Boone,16,3891,29019
2020-12-26,MO,Boone,14,3905,29019
2020-12-27,MO,Boone,9,3914,29019
2020-12-28,MO,Boone,629,4543,29019
2020-12-29,MO,Boone,573,5116,29019
2020-12-30,MO,Boone,700,5816,29019
2020-12-31,MO,Boone,347,6163,29019
2021-01-01,MO,Boone,7,6170,29019
2021-01-02,MO,Boone,171,6341,29019
2021-01-03,MO,Boone,165,6506,29019
2021-01-04,MO,Boone,179,6685,29019
2021-01-05,MO,Boone,276,6961,29019
2021-01-06,MO,Boone,578,7539,29019
2021-01-07,MO,Boone,792,8331,29019
2021-01-08,MO,Boone,854,9185,29019
2021-01-09,MO,Boone,525,9710,29019
2021-01-10,MO,Boone,470,10180,29019
2021-01-11,MO,Boone,747,10927,29019
2021-01-12,MO,Boone,689,11616,29019
2021-01-13,MO,Boone,403,12019,29019
2021-01-14,MO,Boone,421,12440,29019
2021-01-15,MO,Boone,409,12849,29019
2021-01-16,MO,Boone,380,13229,29019
2021-01-17,MO,Boone,124,13353,29019
2021-01-18,MO,Boone,756,14109,29019
2021-01-19,MO,Boone,698,14807,29019
2021-01-20,MO,Boone,991,15798,29019
2021-01-21,MO,Boone,1207,17005,29019
2021-01-22,MO,Boone,556,17561,29019
2021-01-23,MO,Boone,410,17971,29019
2021-01-24,MO,Boone,158,18129,29019
2021-01-25,MO,Boone,640,18769,29019
2021-01-26,MO,Boone,901,19670,29019
2021-01-27,MO,Boone,866,20536,29019
2021-01-28,MO,Boone,1000,21536,29019
2021-01-29,MO,Boone,1709,23245,29019
2021-01-30,MO,Boone,731,23976,29019
2021-01-31,MO,Boone,214,24190,29019
2021-02-01,MO,Boone,325,24515,29019
2021-02-02,MO,Boone,630,25145,29019
2021-02-03,MO,Boone,620,25765,29019
2021-02-04,MO,Boone,2390,28155,29019
2021-02-05,MO,Boone,944,29099,29019
2021-02-06,MO,Boone,1968,31067,29019
2021-02-07,MO,Boone,2,31069,29019
2021-02-08,MO,Boone,318,31387,29019
2021-02-09,MO,Boone,552,31939,29019
2021-02-10,MO,Boone,593,32532,29019
2021-02-11,MO,Boone,668,33200,29019
2021-02-12,MO,Boone,861,34061,29019
2021-02-13,MO,Boone,335,34396,29019
2021-02-14,MO,Boone,83,34479,29019
2021-02-15,MO,Boone,966,35445,29019
2021-02-16,MO,Boone,1023,36468,29019
2021-02-17,MO,Boone,925,37393,29019
2021-02-18,MO,Boone,1337,38730,29019
2021-02-19,MO,Boone,1266,39996,29019
2021-02-20,MO,Boone,142,40138,29019
2021-02-21,MO,Boone,7,40145,29019
2021-02-22,MO,Boone,831,40976,29019
2021-02-23,MO,Boone,801,41777,29019
2021-02-24,MO,Boone,885,42662,29019
2021-02-25,MO,Boone,3141,45803,29019
2021-02-26,MO,Boone,993,46796,29019
2021-02-27,MO,Boone,2626,49422,29019
2021-02-28,MO,Boone,220,49642,29019
2021-03-01,MO,Boone,681,50323,29019
2021-03-02,MO,Boone,784,51107,29019
2021-03-03,MO,Boone,878,51985,29019
2021-03-04,MO,Boone,3356,55341,29019
2021-03-05,MO,Boone,2296,57637,29019
2021-03-06,MO,Boone,2376,60013,29019
2021-03-07,MO,Boone,550,60563,29019
2021-03-08,MO,Boone,714,61277,29019
2021-03-09,MO,Boone,943,62220,29019
2021-03-10,MO,Boone,728,62948,29019
2021-03-11,MO,Boone,737,63685,29019
2021-03-12,MO,Boone,1403,65088,29019
2021-03-13,MO,Boone,254,65342,29019
2021-03-14,MO,Boone,175,65517,29019
2021-03-15,MO,Boone,1249,66766,29019
2021-03-16,MO,Boone,1672,68438,29019
2021-03-17,MO,Boone,1445,69883,29019
2021-03-18,MO,Boone,1163,71046,29019
2021-03-19,MO,Boone,3306,74352,29019
2021-03-20,MO,Boone,461,74813,29019
2021-03-21,MO,Boone,1687,76500,29019
2021-03-22,MO,Boone,1474,77974,29019
2021-03-23,MO,Boone,1194,79168,29019
2021-03-24,MO,Boone,1046,80214,29019
2021-03-25,MO,Boone,3235,83449,29019
2021-03-26,MO,Boone,1409,84858,29019
2021-03-27,MO,Boone,2208,87066,29019
2021-03-28,MO,Boone,660,87726,29019
2021-03-29,MO,Boone,962,88688,29019
2021-03-30,MO,Boone,1216,89904,29019
2021-03-31,MO,Boone,1809,91713,29019
2021-04-01,MO,Boone,1837,93550,29019
2021-04-02,MO,Boone,2834,96384,29019
2021-04-03,MO,Boone,884,97268,29019
2021-04-04,MO,Boone,179,97447,29019
2021-04-05,MO,Boone,3420,100867,29019
2021-04-06,MO,Boone,3898,104765,29019
2021-04-07,MO,Boone,1240,106005,29019
2021-04-08,MO,Boone,1068,107073,29019
2021-04-09,MO,Boone,3878,110951,29019
2021-04-10,MO,Boone,583,111534,29019
2021-04-11,MO,Boone,1767,113301,29019
2021-04-12,MO,Boone,1059,114360,29019
2021-04-13,MO,Boone,1329,115689,29019
2021-04-14,MO,Boone,1038,116727,29019
2021-04-15,MO,Boone,2893,119620,29019
2021-04-16,MO,Boone,2281,121901,29019
2021-04-17,MO,Boone,1735,123636,29019
2021-04-18,MO,Boone,273,123909,29019
2021-04-19,MO,Boone,839,124748,29019
2021-04-20,MO,Boone,1201,125949,29019
2021-04-21,MO,Boone,962,126911,29019
2021-04-22,MO,Boone,1006,127917,29019
2021-04-23,MO,Boone,869,128786,29019
2021-04-24,MO,Boone,342,129128,29019
2021-04-25,MO,Boone,100,129228,29019
2020-12-16,MO,Buchanan,1,1,29021
2020-12-17,MO,Buchanan,1,2,29021
2020-12-18,MO,Buchanan,6,8,29021
2020-12-19,MO,Buchanan,3,11,29021
2020-12-20,MO,Buchanan,2,13,29021
2020-12-21,MO,Buchanan,8,21,29021
2020-12-22,MO,Buchanan,49,70,29021
2020-12-23,MO,Buchanan,139,209,29021
2020-12-24,MO,Buchanan,4,213,29021
2020-12-26,MO,Buchanan,2,215,29021
2020-12-27,MO,Buchanan,150,365,29021
2020-12-28,MO,Buchanan,165,530,29021
2020-12-29,MO,Buchanan,149,679,29021
2020-12-30,MO,Buchanan,48,727,29021
2020-12-31,MO,Buchanan,31,758,29021
2021-01-01,MO,Buchanan,1,759,29021
2021-01-02,MO,Buchanan,14,773,29021
2021-01-03,MO,Buchanan,142,915,29021
2021-01-04,MO,Buchanan,244,1159,29021
2021-01-05,MO,Buchanan,200,1359,29021
2021-01-06,MO,Buchanan,152,1511,29021
2021-01-07,MO,Buchanan,44,1555,29021
2021-01-08,MO,Buchanan,57,1612,29021
2021-01-09,MO,Buchanan,6,1618,29021
2021-01-10,MO,Buchanan,3,1621,29021
2021-01-11,MO,Buchanan,21,1642,29021
2021-01-12,MO,Buchanan,35,1677,29021
2021-01-13,MO,Buchanan,280,1957,29021
2021-01-14,MO,Buchanan,267,2224,29021
2021-01-15,MO,Buchanan,173,2397,29021
2021-01-16,MO,Buchanan,16,2413,29021
2021-01-17,MO,Buchanan,34,2447,29021
2021-01-18,MO,Buchanan,27,2474,29021
2021-01-19,MO,Buchanan,33,2507,29021
2021-01-20,MO,Buchanan,310,2817,29021
2021-01-21,MO,Buchanan,172,2989,29021
2021-01-22,MO,Buchanan,181,3170,29021
2021-01-23,MO,Buchanan,12,3182,29021
2021-01-24,MO,Buchanan,13,3195,29021
2021-01-25,MO,Buchanan,85,3280,29021
2021-01-26,MO,Buchanan,474,3754,29021
2021-01-27,MO,Buchanan,329,4083,29021
2021-01-28,MO,Buchanan,433,4516,29021
2021-01-29,MO,Buchanan,418,4934,29021
2021-01-30,MO,Buchanan,15,4949,29021
2021-01-31,MO,Buchanan,68,5017,29021
2021-02-01,MO,Buchanan,165,5182,29021
2021-02-02,MO,Buchanan,307,5489,29021
2021-02-03,MO,Buchanan,424,5913,29021
2021-02-04,MO,Buchanan,512,6425,29021
2021-02-05,MO,Buchanan,550,6975,29021
2021-02-06,MO,Buchanan,10,6985,29021
2021-02-07,MO,Buchanan,2,6987,29021
2021-02-08,MO,Buchanan,288,7275,29021
2021-02-09,MO,Buchanan,320,7595,29021
2021-02-10,MO,Buchanan,177,7772,29021
2021-02-11,MO,Buchanan,483,8255,29021
2021-02-12,MO,Buchanan,375,8630,29021
2021-02-13,MO,Buchanan,29,8659,29021
2021-02-14,MO,Buchanan,20,8679,29021
2021-02-15,MO,Buchanan,79,8758,29021
2021-02-16,MO,Buchanan,225,8983,29021
2021-02-17,MO,Buchanan,317,9300,29021
2021-02-18,MO,Buchanan,222,9522,29021
2021-02-19,MO,Buchanan,213,9735,29021
2021-02-20,MO,Buchanan,20,9755,29021
2021-02-21,MO,Buchanan,3,9758,29021
2021-02-22,MO,Buchanan,347,10105,29021
2021-02-23,MO,Buchanan,162,10267,29021
2021-02-24,MO,Buchanan,87,10354,29021
2021-02-25,MO,Buchanan,569,10923,29021
2021-02-26,MO,Buchanan,432,11355,29021
2021-02-27,MO,Buchanan,14,11369,29021
2021-02-28,MO,Buchanan,15,11384,29021
2021-03-01,MO,Buchanan,451,11835,29021
2021-03-02,MO,Buchanan,549,12384,29021
2021-03-03,MO,Buchanan,496,12880,29021
2021-03-04,MO,Buchanan,473,13353,29021
2021-03-05,MO,Buchanan,282,13635,29021
2021-03-06,MO,Buchanan,27,13662,29021
2021-03-07,MO,Buchanan,7,13669,29021
2021-03-08,MO,Buchanan,51,13720,29021
2021-03-09,MO,Buchanan,629,14349,29021
2021-03-10,MO,Buchanan,478,14827,29021
2021-03-11,MO,Buchanan,473,15300,29021
2021-03-12,MO,Buchanan,373,15673,29021
2021-03-13,MO,Buchanan,24,15697,29021
2021-03-14,MO,Buchanan,10,15707,29021
2021-03-15,MO,Buchanan,106,15813,29021
2021-03-16,MO,Buchanan,588,16401,29021
2021-03-17,MO,Buchanan,414,16815,29021
2021-03-18,MO,Buchanan,506,17321,29021
2021-03-19,MO,Buchanan,393,17714,29021
2021-03-20,MO,Buchanan,30,17744,29021
2021-03-21,MO,Buchanan,10,17754,29021
2021-03-22,MO,Buchanan,30,17784,29021
2021-03-23,MO,Buchanan,132,17916,29021
2021-03-24,MO,Buchanan,422,18338,29021
2021-03-25,MO,Buchanan,554,18892,29021
2021-03-26,MO,Buchanan,610,19502,29021
2021-03-27,MO,Buchanan,30,19532,29021
2021-03-28,MO,Buchanan,8,19540,29021
2021-03-29,MO,Buchanan,70,19610,29021
2021-03-30,MO,Buchanan,643,20253,29021
2021-03-31,MO,Buchanan,752,21005,29021
2021-04-01,MO,Buchanan,752,21757,29021
2021-04-02,MO,Buchanan,399,22156,29021
2021-04-03,MO,Buchanan,30,22186,29021
2021-04-04,MO,Buchanan,11,22197,29021
2021-04-05,MO,Buchanan,67,22264,29021
2021-04-06,MO,Buchanan,470,22734,29021
2021-04-07,MO,Buchanan,502,23236,29021
2021-04-08,MO,Buchanan,523,23759,29021
2021-04-09,MO,Buchanan,519,24278,29021
2021-04-10,MO,Buchanan,52,24330,29021
2021-04-11,MO,Buchanan,13,24343,29021
2021-04-12,MO,Buchanan,78,24421,29021
2021-04-13,MO,Buchanan,453,24874,29021
2021-04-14,MO,Buchanan,815,25689,29021
2021-04-15,MO,Buchanan,579,26268,29021
2021-04-16,MO,Buchanan,695,26963,29021
2021-04-17,MO,Buchanan,23,26986,29021
2021-04-18,MO,Buchanan,15,27001,29021
2021-04-19,MO,Buchanan,43,27044,29021
2021-04-20,MO,Buchanan,477,27521,29021
2021-04-21,MO,Buchanan,191,27712,29021
2021-04-22,MO,Buchanan,202,27914,29021
2021-04-23,MO,Buchanan,278,28192,29021
2021-04-24,MO,Buchanan,41,28233,29021
2021-04-25,MO,Buchanan,4,28237,29021
2020-12-14,MO,Butler,1,1,29023
2020-12-15,MO,Butler,3,4,29023
2020-12-16,MO,Butler,2,6,29023
2020-12-17,MO,Butler,6,12,29023
2020-12-18,MO,Butler,14,26,29023
2020-12-19,MO,Butler,1,27,29023
2020-12-20,MO,Butler,1,28,29023
2020-12-21,MO,Butler,5,33,29023
2020-12-22,MO,Butler,15,48,29023
2020-12-23,MO,Butler,72,120,29023
2020-12-26,MO,Butler,1,121,29023
2020-12-27,MO,Butler,1,122,29023
2020-12-28,MO,Butler,40,162,29023
2020-12-29,MO,Butler,12,174,29023
2020-12-30,MO,Butler,42,216,29023
2020-12-31,MO,Butler,39,255,29023
2021-01-01,MO,Butler,3,258,29023
2021-01-02,MO,Butler,2,260,29023
2021-01-03,MO,Butler,11,271,29023
2021-01-04,MO,Butler,28,299,29023
2021-01-05,MO,Butler,208,507,29023
2021-01-06,MO,Butler,147,654,29023
2021-01-07,MO,Butler,102,756,29023
2021-01-08,MO,Butler,56,812,29023
2021-01-09,MO,Butler,6,818,29023
2021-01-10,MO,Butler,1,819,29023
2021-01-11,MO,Butler,67,886,29023
2021-01-12,MO,Butler,15,901,29023
2021-01-13,MO,Butler,11,912,29023
2021-01-14,MO,Butler,125,1037,29023
2021-01-15,MO,Butler,10,1047,29023
2021-01-16,MO,Butler,6,1053,29023
2021-01-18,MO,Butler,17,1070,29023
2021-01-19,MO,Butler,134,1204,29023
2021-01-20,MO,Butler,60,1264,29023
2021-01-21,MO,Butler,66,1330,29023
2021-01-22,MO,Butler,1258,2588,29023
2021-01-23,MO,Butler,276,2864,29023
2021-01-24,MO,Butler,19,2883,29023
2021-01-25,MO,Butler,83,2966,29023
2021-01-26,MO,Butler,234,3200,29023
2021-01-27,MO,Butler,117,3317,29023
2021-01-28,MO,Butler,99,3416,29023
2021-01-29,MO,Butler,101,3517,29023
2021-01-30,MO,Butler,3,3520,29023
2021-02-01,MO,Butler,50,3570,29023
2021-02-02,MO,Butler,24,3594,29023
2021-02-03,MO,Butler,117,3711,29023
2021-02-04,MO,Butler,190,3901,29023
2021-02-05,MO,Butler,196,4097,29023
2021-02-06,MO,Butler,20,4117,29023
2021-02-07,MO,Butler,1,4118,29023
2021-02-08,MO,Butler,99,4217,29023
2021-02-09,MO,Butler,225,4442,29023
2021-02-10,MO,Butler,158,4600,29023
2021-02-11,MO,Butler,23,4623,29023
2021-02-12,MO,Butler,1383,6006,29023
2021-02-13,MO,Butler,36,6042,29023
2021-02-14,MO,Butler,18,6060,29023
2021-02-15,MO,Butler,33,6093,29023
2021-02-16,MO,Butler,90,6183,29023
2021-02-17,MO,Butler,18,6201,29023
2021-02-18,MO,Butler,74,6275,29023
2021-02-19,MO,Butler,145,6420,29023
2021-02-20,MO,Butler,140,6560,29023
2021-02-21,MO,Butler,7,6567,29023
2021-02-22,MO,Butler,112,6679,29023
2021-02-23,MO,Butler,35,6714,29023
2021-02-24,MO,Butler,109,6823,29023
2021-02-25,MO,Butler,67,6890,29023
2021-02-26,MO,Butler,247,7137,29023
2021-02-27,MO,Butler,23,7160,29023
2021-02-28,MO,Butler,7,7167,29023
2021-03-01,MO,Butler,33,7200,29023
2021-03-02,MO,Butler,119,7319,29023
2021-03-03,MO,Butler,116,7435,29023
2021-03-04,MO,Butler,202,7637,29023
2021-03-05,MO,Butler,379,8016,29023
2021-03-06,MO,Butler,31,8047,29023
2021-03-07,MO,Butler,14,8061,29023
2021-03-08,MO,Butler,121,8182,29023
2021-03-09,MO,Butler,135,8317,29023
2021-03-10,MO,Butler,126,8443,29023
2021-03-11,MO,Butler,171,8614,29023
2021-03-12,MO,Butler,119,8733,29023
2021-03-13,MO,Butler,41,8774,29023
2021-03-14,MO,Butler,45,8819,29023
2021-03-15,MO,Butler,67,8886,29023
2021-03-16,MO,Butler,92,8978,29023
2021-03-17,MO,Butler,86,9064,29023
2021-03-18,MO,Butler,504,9568,29023
2021-03-19,MO,Butler,247,9815,29023
2021-03-20,MO,Butler,44,9859,29023
2021-03-21,MO,Butler,45,9904,29023
2021-03-22,MO,Butler,67,9971,29023
2021-03-23,MO,Butler,130,10101,29023
2021-03-24,MO,Butler,131,10232,29023
2021-03-25,MO,Butler,117,10349,29023
2021-03-26,MO,Butler,156,10505,29023
2021-03-27,MO,Butler,23,10528,29023
2021-03-28,MO,Butler,28,10556,29023
2021-03-29,MO,Butler,104,10660,29023
2021-03-30,MO,Butler,339,10999,29023
2021-03-31,MO,Butler,157,11156,29023
2021-04-01,MO,Butler,192,11348,29023
2021-04-02,MO,Butler,329,11677,29023
2021-04-03,MO,Butler,26,11703,29023
2021-04-04,MO,Butler,62,11765,29023
2021-04-05,MO,Butler,147,11912,29023
2021-04-06,MO,Butler,133,12045,29023
2021-04-07,MO,Butler,101,12146,29023
2021-04-08,MO,Butler,103,12249,29023
2021-04-09,MO,Butler,536,12785,29023
2021-04-10,MO,Butler,42,12827,29023
2021-04-11,MO,Butler,44,12871,29023
2021-04-12,MO,Butler,95,12966,29023
2021-04-13,MO,Butler,92,13058,29023
2021-04-14,MO,Butler,79,13137,29023
2021-04-15,MO,Butler,119,13256,29023
2021-04-16,MO,Butler,171,13427,29023
2021-04-17,MO,Butler,29,13456,29023
2021-04-18,MO,Butler,30,13486,29023
2021-04-19,MO,Butler,87,13573,29023
2021-04-20,MO,Butler,110,13683,29023
2021-04-21,MO,Butler,82,13765,29023
2021-04-22,MO,Butler,110,13875,29023
2021-04-23,MO,Butler,142,14017,29023
2021-04-24,MO,Butler,47,14064,29023
2021-04-25,MO,Butler,38,14102,29023
2020-12-16,MO,Caldwell,1,1,29025
2020-12-17,MO,Caldwell,2,3,29025
2020-12-19,MO,Caldwell,1,4,29025
2020-12-21,MO,Caldwell,3,7,29025
2020-12-22,MO,Caldwell,2,9,29025
2020-12-23,MO,Caldwell,3,12,29025
2020-12-24,MO,Caldwell,3,15,29025
2020-12-28,MO,Caldwell,10,25,29025
2020-12-29,MO,Caldwell,23,48,29025
2020-12-30,MO,Caldwell,8,56,29025
2020-12-31,MO,Caldwell,12,68,29025
2021-01-02,MO,Caldwell,4,72,29025
2021-01-03,MO,Caldwell,1,73,29025
2021-01-04,MO,Caldwell,7,80,29025
2021-01-05,MO,Caldwell,22,102,29025
2021-01-06,MO,Caldwell,6,108,29025
2021-01-07,MO,Caldwell,10,118,29025
2021-01-08,MO,Caldwell,10,128,29025
2021-01-09,MO,Caldwell,5,133,29025
2021-01-10,MO,Caldwell,1,134,29025
2021-01-11,MO,Caldwell,9,143,29025
2021-01-12,MO,Caldwell,9,152,29025
2021-01-13,MO,Caldwell,61,213,29025
2021-01-14,MO,Caldwell,39,252,29025
2021-01-15,MO,Caldwell,17,269,29025
2021-01-16,MO,Caldwell,7,276,29025
2021-01-18,MO,Caldwell,6,282,29025
2021-01-19,MO,Caldwell,9,291,29025
2021-01-20,MO,Caldwell,8,299,29025
2021-01-21,MO,Caldwell,29,328,29025
2021-01-22,MO,Caldwell,19,347,29025
2021-01-23,MO,Caldwell,1,348,29025
2021-01-25,MO,Caldwell,14,362,29025
2021-01-26,MO,Caldwell,18,380,29025
2021-01-27,MO,Caldwell,23,403,29025
2021-01-28,MO,Caldwell,24,427,29025
2021-01-29,MO,Caldwell,39,466,29025
2021-01-30,MO,Caldwell,26,492,29025
2021-01-31,MO,Caldwell,5,497,29025
2021-02-01,MO,Caldwell,11,508,29025
2021-02-02,MO,Caldwell,31,539,29025
2021-02-03,MO,Caldwell,77,616,29025
2021-02-04,MO,Caldwell,57,673,29025
2021-02-05,MO,Caldwell,57,730,29025
2021-02-06,MO,Caldwell,6,736,29025
2021-02-08,MO,Caldwell,28,764,29025
2021-02-09,MO,Caldwell,33,797,29025
2021-02-10,MO,Caldwell,33,830,29025
2021-02-11,MO,Caldwell,40,870,29025
2021-02-12,MO,Caldwell,33,903,29025
2021-02-13,MO,Caldwell,61,964,29025
2021-02-14,MO,Caldwell,8,972,29025
2021-02-15,MO,Caldwell,6,978,29025
2021-02-16,MO,Caldwell,6,984,29025
2021-02-17,MO,Caldwell,11,995,29025
2021-02-18,MO,Caldwell,32,1027,29025
2021-02-19,MO,Caldwell,13,1040,29025
2021-02-20,MO,Caldwell,421,1461,29025
2021-02-21,MO,Caldwell,3,1464,29025
2021-02-22,MO,Caldwell,26,1490,29025
2021-02-23,MO,Caldwell,31,1521,29025
2021-02-24,MO,Caldwell,27,1548,29025
2021-02-25,MO,Caldwell,58,1606,29025
2021-02-26,MO,Caldwell,42,1648,29025
2021-02-27,MO,Caldwell,26,1674,29025
2021-02-28,MO,Caldwell,2,1676,29025
2021-03-01,MO,Caldwell,28,1704,29025
2021-03-02,MO,Caldwell,49,1753,29025
2021-03-03,MO,Caldwell,59,1812,29025
2021-03-04,MO,Caldwell,41,1853,29025
2021-03-05,MO,Caldwell,56,1909,29025
2021-03-06,MO,Caldwell,13,1922,29025
2021-03-07,MO,Caldwell,3,1925,29025
2021-03-08,MO,Caldwell,14,1939,29025
2021-03-09,MO,Caldwell,34,1973,29025
2021-03-10,MO,Caldwell,11,1984,29025
2021-03-11,MO,Caldwell,22,2006,29025
2021-03-12,MO,Caldwell,34,2040,29025
2021-03-13,MO,Caldwell,3,2043,29025
2021-03-14,MO,Caldwell,3,2046,29025
2021-03-15,MO,Caldwell,29,2075,29025
2021-03-16,MO,Caldwell,34,2109,29025
2021-03-17,MO,Caldwell,37,2146,29025
2021-03-18,MO,Caldwell,70,2216,29025
2021-03-19,MO,Caldwell,43,2259,29025
2021-03-20,MO,Caldwell,433,2692,29025
2021-03-21,MO,Caldwell,2,2694,29025
2021-03-22,MO,Caldwell,17,2711,29025
2021-03-23,MO,Caldwell,26,2737,29025
2021-03-24,MO,Caldwell,50,2787,29025
2021-03-25,MO,Caldwell,49,2836,29025
2021-03-26,MO,Caldwell,39,2875,29025
2021-03-27,MO,Caldwell,4,2879,29025
2021-03-28,MO,Caldwell,1,2880,29025
2021-03-29,MO,Caldwell,19,2899,29025
2021-03-30,MO,Caldwell,28,2927,29025
2021-03-31,MO,Caldwell,22,2949,29025
2021-04-01,MO,Caldwell,24,2973,29025
2021-04-02,MO,Caldwell,30,3003,29025
2021-04-03,MO,Caldwell,5,3008,29025
2021-04-04,MO,Caldwell,1,3009,29025
2021-04-05,MO,Caldwell,13,3022,29025
2021-04-06,MO,Caldwell,31,3053,29025
2021-04-07,MO,Caldwell,34,3087,29025
2021-04-08,MO,Caldwell,48,3135,29025
2021-04-09,MO,Caldwell,61,3196,29025
2021-04-10,MO,Caldwell,36,3232,29025
2021-04-11,MO,Caldwell,3,3235,29025
2021-04-12,MO,Caldwell,46,3281,29025
2021-04-13,MO,Caldwell,28,3309,29025
2021-04-14,MO,Caldwell,58,3367,29025
2021-04-15,MO,Caldwell,68,3435,29025
2021-04-16,MO,Caldwell,53,3488,29025
2021-04-17,MO,Caldwell,6,3494,29025
2021-04-18,MO,Caldwell,4,3498,29025
2021-04-19,MO,Caldwell,9,3507,29025
2021-04-20,MO,Caldwell,28,3535,29025
2021-04-21,MO,Caldwell,23,3558,29025
2021-04-22,MO,Caldwell,42,3600,29025
2021-04-23,MO,Caldwell,18,3618,29025
2021-04-24,MO,Caldwell,6,3624,29025
2021-04-25,MO,Caldwell,2,3626,29025
2020-12-15,MO,Callaway,8,8,29027
2020-12-16,MO,Callaway,23,31,29027
2020-12-17,MO,Callaway,44,75,29027
2020-12-18,MO,Callaway,74,149,29027
2020-12-19,MO,Callaway,27,176,29027
2020-12-20,MO,Callaway,22,198,29027
2020-12-21,MO,Callaway,45,243,29027
2020-12-22,MO,Callaway,50,293,29027
2020-12-23,MO,Callaway,36,329,29027
2020-12-24,MO,Callaway,3,332,29027
2020-12-27,MO,Callaway,4,336,29027
2020-12-28,MO,Callaway,79,415,29027
2020-12-29,MO,Callaway,420,835,29027
2020-12-30,MO,Callaway,146,981,29027
2020-12-31,MO,Callaway,54,1035,29027
2021-01-01,MO,Callaway,1,1036,29027
2021-01-02,MO,Callaway,55,1091,29027
2021-01-03,MO,Callaway,11,1102,29027
2021-01-04,MO,Callaway,84,1186,29027
2021-01-05,MO,Callaway,64,1250,29027
2021-01-06,MO,Callaway,53,1303,29027
2021-01-07,MO,Callaway,78,1381,29027
2021-01-08,MO,Callaway,90,1471,29027
2021-01-09,MO,Callaway,87,1558,29027
2021-01-10,MO,Callaway,25,1583,29027
2021-01-11,MO,Callaway,84,1667,29027
2021-01-12,MO,Callaway,59,1726,29027
2021-01-13,MO,Callaway,45,1771,29027
2021-01-14,MO,Callaway,92,1863,29027
2021-01-15,MO,Callaway,49,1912,29027
2021-01-16,MO,Callaway,16,1928,29027
2021-01-17,MO,Callaway,12,1940,29027
2021-01-18,MO,Callaway,145,2085,29027
2021-01-19,MO,Callaway,417,2502,29027
2021-01-20,MO,Callaway,138,2640,29027
2021-01-21,MO,Callaway,192,2832,29027
2021-01-22,MO,Callaway,159,2991,29027
2021-01-23,MO,Callaway,130,3121,29027
2021-01-24,MO,Callaway,9,3130,29027
2021-01-25,MO,Callaway,130,3260,29027
2021-01-26,MO,Callaway,206,3466,29027
2021-01-27,MO,Callaway,170,3636,29027
2021-01-28,MO,Callaway,225,3861,29027
2021-01-29,MO,Callaway,433,4294,29027
2021-01-30,MO,Callaway,119,4413,29027
2021-01-31,MO,Callaway,25,4438,29027
2021-02-01,MO,Callaway,116,4554,29027
2021-02-02,MO,Callaway,153,4707,29027
2021-02-03,MO,Callaway,245,4952,29027
2021-02-04,MO,Callaway,373,5325,29027
2021-02-05,MO,Callaway,306,5631,29027
2021-02-06,MO,Callaway,219,5850,29027
2021-02-08,MO,Callaway,74,5924,29027
2021-02-09,MO,Callaway,108,6032,29027
2021-02-10,MO,Callaway,350,6382,29027
2021-02-11,MO,Callaway,387,6769,29027
2021-02-12,MO,Callaway,184,6953,29027
2021-02-13,MO,Callaway,131,7084,29027
2021-02-14,MO,Callaway,21,7105,29027
2021-02-15,MO,Callaway,39,7144,29027
2021-02-16,MO,Callaway,144,7288,29027
2021-02-17,MO,Callaway,74,7362,29027
2021-02-18,MO,Callaway,220,7582,29027
2021-02-19,MO,Callaway,294,7876,29027
2021-02-20,MO,Callaway,79,7955,29027
2021-02-21,MO,Callaway,1,7956,29027
2021-02-22,MO,Callaway,297,8253,29027
2021-02-23,MO,Callaway,380,8633,29027
2021-02-24,MO,Callaway,174,8807,29027
2021-02-25,MO,Callaway,496,9303,29027
2021-02-26,MO,Callaway,386,9689,29027
2021-02-27,MO,Callaway,199,9888,29027
2021-02-28,MO,Callaway,10,9898,29027
2021-03-01,MO,Callaway,119,10017,29027
2021-03-02,MO,Callaway,299,10316,29027
2021-03-03,MO,Callaway,356,10672,29027
2021-03-04,MO,Callaway,421,11093,29027
2021-03-05,MO,Callaway,211,11304,29027
2021-03-06,MO,Callaway,185,11489,29027
2021-03-07,MO,Callaway,62,11551,29027
2021-03-08,MO,Callaway,81,11632,29027
2021-03-09,MO,Callaway,229,11861,29027
2021-03-10,MO,Callaway,395,12256,29027
2021-03-11,MO,Callaway,396,12652,29027
2021-03-12,MO,Callaway,262,12914,29027
2021-03-13,MO,Callaway,31,12945,29027
2021-03-14,MO,Callaway,10,12955,29027
2021-03-15,MO,Callaway,109,13064,29027
2021-03-16,MO,Callaway,661,13725,29027
2021-03-17,MO,Callaway,118,13843,29027
2021-03-18,MO,Callaway,179,14022,29027
2021-03-19,MO,Callaway,541,14563,29027
2021-03-20,MO,Callaway,53,14616,29027
2021-03-21,MO,Callaway,53,14669,29027
2021-03-22,MO,Callaway,560,15229,29027
2021-03-23,MO,Callaway,128,15357,29027
2021-03-24,MO,Callaway,143,15500,29027
2021-03-25,MO,Callaway,213,15713,29027
2021-03-26,MO,Callaway,582,16295,29027
2021-03-27,MO,Callaway,170,16465,29027
2021-03-28,MO,Callaway,55,16520,29027
2021-03-29,MO,Callaway,136,16656,29027
2021-03-30,MO,Callaway,151,16807,29027
2021-03-31,MO,Callaway,175,16982,29027
2021-04-01,MO,Callaway,308,17290,29027
2021-04-02,MO,Callaway,357,17647,29027
2021-04-03,MO,Callaway,91,17738,29027
2021-04-04,MO,Callaway,24,17762,29027
2021-04-05,MO,Callaway,197,17959,29027
2021-04-06,MO,Callaway,750,18709,29027
2021-04-07,MO,Callaway,166,18875,29027
2021-04-08,MO,Callaway,210,19085,29027
2021-04-09,MO,Callaway,383,19468,29027
2021-04-10,MO,Callaway,66,19534,29027
2021-04-11,MO,Callaway,48,19582,29027
2021-04-12,MO,Callaway,195,19777,29027
2021-04-13,MO,Callaway,216,19993,29027
2021-04-14,MO,Callaway,189,20182,29027
2021-04-15,MO,Callaway,228,20410,29027
2021-04-16,MO,Callaway,626,21036,29027
2021-04-17,MO,Callaway,96,21132,29027
2021-04-18,MO,Callaway,22,21154,29027
2021-04-19,MO,Callaway,108,21262,29027
2021-04-20,MO,Callaway,153,21415,29027
2021-04-21,MO,Callaway,77,21492,29027
2021-04-22,MO,Callaway,135,21627,29027
2021-04-23,MO,Callaway,132,21759,29027
2021-04-24,MO,Callaway,37,21796,29027
2021-04-25,MO,Callaway,7,21803,29027
2020-12-15,MO,Camden,5,5,29029
2020-12-16,MO,Camden,5,10,29029
2020-12-17,MO,Camden,12,22,29029
2020-12-18,MO,Camden,19,41,29029
2020-12-19,MO,Camden,4,45,29029
2020-12-20,MO,Camden,3,48,29029
2020-12-21,MO,Camden,102,150,29029
2020-12-22,MO,Camden,146,296,29029
2020-12-23,MO,Camden,78,374,29029
2020-12-26,MO,Camden,1,375,29029
2020-12-27,MO,Camden,1,376,29029
2020-12-28,MO,Camden,95,471,29029
2020-12-29,MO,Camden,145,616,29029
2020-12-30,MO,Camden,73,689,29029
2020-12-31,MO,Camden,8,697,29029
2021-01-01,MO,Camden,1,698,29029
2021-01-02,MO,Camden,1,699,29029
2021-01-04,MO,Camden,25,724,29029
2021-01-05,MO,Camden,24,748,29029
2021-01-06,MO,Camden,35,783,29029
2021-01-07,MO,Camden,50,833,29029
2021-01-08,MO,Camden,24,857,29029
2021-01-09,MO,Camden,4,861,29029
2021-01-10,MO,Camden,2,863,29029
2021-01-11,MO,Camden,144,1007,29029
2021-01-12,MO,Camden,107,1114,29029
2021-01-13,MO,Camden,57,1171,29029
2021-01-14,MO,Camden,64,1235,29029
2021-01-15,MO,Camden,63,1298,29029
2021-01-16,MO,Camden,34,1332,29029
2021-01-17,MO,Camden,3,1335,29029
2021-01-18,MO,Camden,81,1416,29029
2021-01-19,MO,Camden,133,1549,29029
2021-01-20,MO,Camden,100,1649,29029
2021-01-21,MO,Camden,51,1700,29029
2021-01-22,MO,Camden,259,1959,29029
2021-01-23,MO,Camden,28,1987,29029
2021-01-24,MO,Camden,3,1990,29029
2021-01-25,MO,Camden,279,2269,29029
2021-01-26,MO,Camden,105,2374,29029
2021-01-27,MO,Camden,465,2839,29029
2021-01-28,MO,Camden,96,2935,29029
2021-01-29,MO,Camden,419,3354,29029
2021-01-30,MO,Camden,26,3380,29029
2021-01-31,MO,Camden,3,3383,29029
2021-02-01,MO,Camden,294,3677,29029
2021-02-02,MO,Camden,108,3785,29029
2021-02-03,MO,Camden,399,4184,29029
2021-02-04,MO,Camden,189,4373,29029
2021-02-05,MO,Camden,406,4779,29029
2021-02-06,MO,Camden,350,5129,29029
2021-02-07,MO,Camden,1,5130,29029
2021-02-08,MO,Camden,130,5260,29029
2021-02-09,MO,Camden,47,5307,29029
2021-02-10,MO,Camden,171,5478,29029
2021-02-11,MO,Camden,483,5961,29029
2021-02-12,MO,Camden,547,6508,29029
2021-02-13,MO,Camden,77,6585,29029
2021-02-14,MO,Camden,9,6594,29029
2021-02-15,MO,Camden,19,6613,29029
2021-02-16,MO,Camden,47,6660,29029
2021-02-17,MO,Camden,25,6685,29029
2021-02-18,MO,Camden,89,6774,29029
2021-02-19,MO,Camden,680,7454,29029
2021-02-20,MO,Camden,20,7474,29029
2021-02-21,MO,Camden,6,7480,29029
2021-02-22,MO,Camden,610,8090,29029
2021-02-23,MO,Camden,277,8367,29029
2021-02-24,MO,Camden,496,8863,29029
2021-02-25,MO,Camden,660,9523,29029
2021-02-26,MO,Camden,717,10240,29029
2021-02-27,MO,Camden,95,10335,29029
2021-02-28,MO,Camden,20,10355,29029
2021-03-01,MO,Camden,169,10524,29029
2021-03-02,MO,Camden,199,10723,29029
2021-03-03,MO,Camden,314,11037,29029
2021-03-04,MO,Camden,293,11330,29029
2021-03-05,MO,Camden,302,11632,29029
2021-03-06,MO,Camden,348,11980,29029
2021-03-07,MO,Camden,1089,13069,29029
2021-03-08,MO,Camden,153,13222,29029
2021-03-09,MO,Camden,124,13346,29029
2021-03-10,MO,Camden,222,13568,29029
2021-03-11,MO,Camden,679,14247,29029
2021-03-12,MO,Camden,539,14786,29029
2021-03-13,MO,Camden,44,14830,29029
2021-03-14,MO,Camden,12,14842,29029
2021-03-15,MO,Camden,166,15008,29029
2021-03-16,MO,Camden,271,15279,29029
2021-03-17,MO,Camden,267,15546,29029
2021-03-18,MO,Camden,205,15751,29029
2021-03-19,MO,Camden,467,16218,29029
2021-03-20,MO,Camden,66,16284,29029
2021-03-21,MO,Camden,33,16317,29029
2021-03-22,MO,Camden,483,16800,29029
2021-03-23,MO,Camden,235,17035,29029
2021-03-24,MO,Camden,269,17304,29029
2021-03-25,MO,Camden,682,17986,29029
2021-03-26,MO,Camden,262,18248,29029
2021-03-27,MO,Camden,62,18310,29029
2021-03-28,MO,Camden,44,18354,29029
2021-03-29,MO,Camden,185,18539,29029
2021-03-30,MO,Camden,183,18722,29029
2021-03-31,MO,Camden,267,18989,29029
2021-04-01,MO,Camden,243,19232,29029
2021-04-02,MO,Camden,368,19600,29029
2021-04-03,MO,Camden,68,19668,29029
2021-04-04,MO,Camden,16,19684,29029
2021-04-05,MO,Camden,183,19867,29029
2021-04-06,MO,Camden,208,20075,29029
2021-04-07,MO,Camden,246,20321,29029
2021-04-08,MO,Camden,256,20577,29029
2021-04-09,MO,Camden,305,20882,29029
2021-04-10,MO,Camden,47,20929,29029
2021-04-11,MO,Camden,38,20967,29029
2021-04-12,MO,Camden,188,21155,29029
2021-04-13,MO,Camden,208,21363,29029
2021-04-14,MO,Camden,202,21565,29029
2021-04-15,MO,Camden,140,21705,29029
2021-04-16,MO,Camden,241,21946,29029
2021-04-17,MO,Camden,41,21987,29029
2021-04-18,MO,Camden,41,22028,29029
2021-04-19,MO,Camden,157,22185,29029
2021-04-20,MO,Camden,144,22329,29029
2021-04-21,MO,Camden,126,22455,29029
2021-04-22,MO,Camden,168,22623,29029
2021-04-23,MO,Camden,112,22735,29029
2021-04-24,MO,Camden,33,22768,29029
2021-04-25,MO,Camden,10,22778,29029
2020-12-15,MO,Cape Girardeau,8,8,29031
2020-12-16,MO,Cape Girardeau,16,24,29031
2020-12-17,MO,Cape Girardeau,173,197,29031
2020-12-18,MO,Cape Girardeau,152,349,29031
2020-12-19,MO,Cape Girardeau,21,370,29031
2020-12-20,MO,Cape Girardeau,6,376,29031
2020-12-21,MO,Cape Girardeau,556,932,29031
2020-12-22,MO,Cape Girardeau,567,1499,29031
2020-12-23,MO,Cape Girardeau,180,1679,29031
2020-12-24,MO,Cape Girardeau,74,1753,29031
2020-12-26,MO,Cape Girardeau,3,1756,29031
2020-12-27,MO,Cape Girardeau,2,1758,29031
2020-12-28,MO,Cape Girardeau,47,1805,29031
2020-12-29,MO,Cape Girardeau,92,1897,29031
2020-12-30,MO,Cape Girardeau,365,2262,29031
2020-12-31,MO,Cape Girardeau,144,2406,29031
2021-01-01,MO,Cape Girardeau,2,2408,29031
2021-01-02,MO,Cape Girardeau,10,2418,29031
2021-01-03,MO,Cape Girardeau,6,2424,29031
2021-01-04,MO,Cape Girardeau,57,2481,29031
2021-01-05,MO,Cape Girardeau,257,2738,29031
2021-01-06,MO,Cape Girardeau,151,2889,29031
2021-01-07,MO,Cape Girardeau,225,3114,29031
2021-01-08,MO,Cape Girardeau,304,3418,29031
2021-01-09,MO,Cape Girardeau,183,3601,29031
2021-01-10,MO,Cape Girardeau,5,3606,29031
2021-01-11,MO,Cape Girardeau,532,4138,29031
2021-01-12,MO,Cape Girardeau,444,4582,29031
2021-01-13,MO,Cape Girardeau,386,4968,29031
2021-01-14,MO,Cape Girardeau,207,5175,29031
2021-01-15,MO,Cape Girardeau,372,5547,29031
2021-01-16,MO,Cape Girardeau,104,5651,29031
2021-01-17,MO,Cape Girardeau,2,5653,29031
2021-01-18,MO,Cape Girardeau,608,6261,29031
2021-01-19,MO,Cape Girardeau,1062,7323,29031
2021-01-20,MO,Cape Girardeau,1475,8798,29031
2021-01-21,MO,Cape Girardeau,792,9590,29031
2021-01-22,MO,Cape Girardeau,1621,11211,29031
2021-01-23,MO,Cape Girardeau,22,11233,29031
2021-01-24,MO,Cape Girardeau,13,11246,29031
2021-01-25,MO,Cape Girardeau,718,11964,29031
2021-01-26,MO,Cape Girardeau,552,12516,29031
2021-01-27,MO,Cape Girardeau,380,12896,29031
2021-01-28,MO,Cape Girardeau,213,13109,29031
2021-01-29,MO,Cape Girardeau,771,13880,29031
2021-01-30,MO,Cape Girardeau,16,13896,29031
2021-02-01,MO,Cape Girardeau,169,14065,29031
2021-02-02,MO,Cape Girardeau,361,14426,29031
2021-02-03,MO,Cape Girardeau,161,14587,29031
2021-02-04,MO,Cape Girardeau,320,14907,29031
2021-02-05,MO,Cape Girardeau,945,15852,29031
2021-02-06,MO,Cape Girardeau,35,15887,29031
2021-02-07,MO,Cape Girardeau,2,15889,29031
2021-02-08,MO,Cape Girardeau,325,16214,29031
2021-02-09,MO,Cape Girardeau,1668,17882,29031
2021-02-10,MO,Cape Girardeau,1027,18909,29031
2021-02-11,MO,Cape Girardeau,623,19532,29031
2021-02-12,MO,Cape Girardeau,1253,20785,29031
2021-02-13,MO,Cape Girardeau,40,20825,29031
2021-02-14,MO,Cape Girardeau,14,20839,29031
2021-02-15,MO,Cape Girardeau,412,21251,29031
2021-02-16,MO,Cape Girardeau,261,21512,29031
2021-02-17,MO,Cape Girardeau,143,21655,29031
2021-02-18,MO,Cape Girardeau,47,21702,29031
2021-02-19,MO,Cape Girardeau,324,22026,29031
2021-02-20,MO,Cape Girardeau,474,22500,29031
2021-02-21,MO,Cape Girardeau,2,22502,29031
2021-02-22,MO,Cape Girardeau,560,23062,29031
2021-02-23,MO,Cape Girardeau,601,23663,29031
2021-02-24,MO,Cape Girardeau,699,24362,29031
2021-02-25,MO,Cape Girardeau,76,24438,29031
2021-02-26,MO,Cape Girardeau,420,24858,29031
2021-02-27,MO,Cape Girardeau,538,25396,29031
2021-02-28,MO,Cape Girardeau,10,25406,29031
2021-03-01,MO,Cape Girardeau,162,25568,29031
2021-03-02,MO,Cape Girardeau,616,26184,29031
2021-03-03,MO,Cape Girardeau,1033,27217,29031
2021-03-04,MO,Cape Girardeau,150,27367,29031
2021-03-05,MO,Cape Girardeau,428,27795,29031
2021-03-06,MO,Cape Girardeau,42,27837,29031
2021-03-07,MO,Cape Girardeau,7,27844,29031
2021-03-08,MO,Cape Girardeau,664,28508,29031
2021-03-09,MO,Cape Girardeau,497,29005,29031
2021-03-10,MO,Cape Girardeau,1088,30093,29031
2021-03-11,MO,Cape Girardeau,203,30296,29031
2021-03-12,MO,Cape Girardeau,406,30702,29031
2021-03-13,MO,Cape Girardeau,112,30814,29031
2021-03-14,MO,Cape Girardeau,75,30889,29031
2021-03-15,MO,Cape Girardeau,470,31359,29031
2021-03-16,MO,Cape Girardeau,302,31661,29031
2021-03-17,MO,Cape Girardeau,239,31900,29031
2021-03-18,MO,Cape Girardeau,170,32070,29031
2021-03-19,MO,Cape Girardeau,1302,33372,29031
2021-03-20,MO,Cape Girardeau,67,33439,29031
2021-03-21,MO,Cape Girardeau,27,33466,29031
2021-03-22,MO,Cape Girardeau,236,33702,29031
2021-03-23,MO,Cape Girardeau,242,33944,29031
2021-03-24,MO,Cape Girardeau,342,34286,29031
2021-03-25,MO,Cape Girardeau,314,34600,29031
2021-03-26,MO,Cape Girardeau,385,34985,29031
2021-03-27,MO,Cape Girardeau,43,35028,29031
2021-03-28,MO,Cape Girardeau,32,35060,29031
2021-03-29,MO,Cape Girardeau,345,35405,29031
2021-03-30,MO,Cape Girardeau,850,36255,29031
2021-03-31,MO,Cape Girardeau,1067,37322,29031
2021-04-01,MO,Cape Girardeau,294,37616,29031
2021-04-02,MO,Cape Girardeau,489,38105,29031
2021-04-03,MO,Cape Girardeau,55,38160,29031
2021-04-04,MO,Cape Girardeau,31,38191,29031
2021-04-05,MO,Cape Girardeau,464,38655,29031
2021-04-06,MO,Cape Girardeau,961,39616,29031
2021-04-07,MO,Cape Girardeau,1431,41047,29031
2021-04-08,MO,Cape Girardeau,165,41212,29031
2021-04-09,MO,Cape Girardeau,1329,42541,29031
2021-04-10,MO,Cape Girardeau,112,42653,29031
2021-04-11,MO,Cape Girardeau,90,42743,29031
2021-04-12,MO,Cape Girardeau,449,43192,29031
2021-04-13,MO,Cape Girardeau,297,43489,29031
2021-04-14,MO,Cape Girardeau,331,43820,29031
2021-04-15,MO,Cape Girardeau,250,44070,29031
2021-04-16,MO,Cape Girardeau,575,44645,29031
2021-04-17,MO,Cape Girardeau,66,44711,29031
2021-04-18,MO,Cape Girardeau,26,44737,29031
2021-04-19,MO,Cape Girardeau,336,45073,29031
2021-04-20,MO,Cape Girardeau,378,45451,29031
2021-04-21,MO,Cape Girardeau,230,45681,29031
2021-04-22,MO,Cape Girardeau,296,45977,29031
2021-04-23,MO,Cape Girardeau,143,46120,29031
2021-04-24,MO,Cape Girardeau,48,46168,29031
2021-04-25,MO,Cape Girardeau,20,46188,29031
2020-12-16,MO,Carroll,2,2,29033
2020-12-18,MO,Carroll,1,3,29033
2020-12-21,MO,Carroll,2,5,29033
2020-12-22,MO,Carroll,5,10,29033
2020-12-23,MO,Carroll,2,12,29033
2020-12-28,MO,Carroll,10,22,29033
2020-12-29,MO,Carroll,60,82,29033
2020-12-30,MO,Carroll,35,117,29033
2020-12-31,MO,Carroll,16,133,29033
2021-01-02,MO,Carroll,2,135,29033
2021-01-04,MO,Carroll,1,136,29033
2021-01-05,MO,Carroll,19,155,29033
2021-01-06,MO,Carroll,14,169,29033
2021-01-07,MO,Carroll,33,202,29033
2021-01-08,MO,Carroll,6,208,29033
2021-01-09,MO,Carroll,3,211,29033
2021-01-11,MO,Carroll,12,223,29033
2021-01-12,MO,Carroll,10,233,29033
2021-01-13,MO,Carroll,9,242,29033
2021-01-14,MO,Carroll,5,247,29033
2021-01-15,MO,Carroll,12,259,29033
2021-01-16,MO,Carroll,1,260,29033
2021-01-18,MO,Carroll,22,282,29033
2021-01-19,MO,Carroll,103,385,29033
2021-01-20,MO,Carroll,61,446,29033
2021-01-21,MO,Carroll,10,456,29033
2021-01-22,MO,Carroll,15,471,29033
2021-01-25,MO,Carroll,10,481,29033
2021-01-26,MO,Carroll,22,503,29033
2021-01-27,MO,Carroll,128,631,29033
2021-01-28,MO,Carroll,60,691,29033
2021-01-29,MO,Carroll,23,714,29033
2021-01-30,MO,Carroll,16,730,29033
2021-01-31,MO,Carroll,1,731,29033
2021-02-01,MO,Carroll,25,756,29033
2021-02-02,MO,Carroll,30,786,29033
2021-02-03,MO,Carroll,200,986,29033
2021-02-04,MO,Carroll,97,1083,29033
2021-02-05,MO,Carroll,24,1107,29033
2021-02-06,MO,Carroll,4,1111,29033
2021-02-08,MO,Carroll,16,1127,29033
2021-02-09,MO,Carroll,25,1152,29033
2021-02-10,MO,Carroll,13,1165,29033
2021-02-11,MO,Carroll,21,1186,29033
2021-02-12,MO,Carroll,29,1215,29033
2021-02-13,MO,Carroll,11,1226,29033
2021-02-14,MO,Carroll,2,1228,29033
2021-02-15,MO,Carroll,28,1256,29033
2021-02-16,MO,Carroll,108,1364,29033
2021-02-17,MO,Carroll,145,1509,29033
2021-02-18,MO,Carroll,70,1579,29033
2021-02-19,MO,Carroll,10,1589,29033
2021-02-20,MO,Carroll,11,1600,29033
2021-02-22,MO,Carroll,25,1625,29033
2021-02-23,MO,Carroll,27,1652,29033
2021-02-24,MO,Carroll,208,1860,29033
2021-02-25,MO,Carroll,236,2096,29033
2021-02-26,MO,Carroll,389,2485,29033
2021-02-27,MO,Carroll,14,2499,29033
2021-02-28,MO,Carroll,1,2500,29033
2021-03-01,MO,Carroll,14,2514,29033
2021-03-02,MO,Carroll,66,2580,29033
2021-03-03,MO,Carroll,25,2605,29033
2021-03-04,MO,Carroll,45,2650,29033
2021-03-05,MO,Carroll,34,2684,29033
2021-03-06,MO,Carroll,17,2701,29033
2021-03-07,MO,Carroll,2,2703,29033
2021-03-08,MO,Carroll,12,2715,29033
2021-03-09,MO,Carroll,17,2732,29033
2021-03-10,MO,Carroll,18,2750,29033
2021-03-11,MO,Carroll,13,2763,29033
2021-03-12,MO,Carroll,90,2853,29033
2021-03-13,MO,Carroll,7,2860,29033
2021-03-14,MO,Carroll,5,2865,29033
2021-03-15,MO,Carroll,36,2901,29033
2021-03-16,MO,Carroll,216,3117,29033
2021-03-17,MO,Carroll,72,3189,29033
2021-03-18,MO,Carroll,65,3254,29033
2021-03-19,MO,Carroll,113,3367,29033
2021-03-20,MO,Carroll,9,3376,29033
2021-03-21,MO,Carroll,1,3377,29033
2021-03-22,MO,Carroll,12,3389,29033
2021-03-23,MO,Carroll,15,3404,29033
2021-03-24,MO,Carroll,51,3455,29033
2021-03-25,MO,Carroll,220,3675,29033
2021-03-26,MO,Carroll,392,4067,29033
2021-03-27,MO,Carroll,5,4072,29033
2021-03-29,MO,Carroll,23,4095,29033
2021-03-30,MO,Carroll,49,4144,29033
2021-03-31,MO,Carroll,12,4156,29033
2021-04-01,MO,Carroll,32,4188,29033
2021-04-02,MO,Carroll,40,4228,29033
2021-04-03,MO,Carroll,1,4229,29033
2021-04-05,MO,Carroll,15,4244,29033
2021-04-06,MO,Carroll,15,4259,29033
2021-04-07,MO,Carroll,27,4286,29033
2021-04-08,MO,Carroll,29,4315,29033
2021-04-09,MO,Carroll,49,4364,29033
2021-04-10,MO,Carroll,5,4369,29033
2021-04-11,MO,Carroll,1,4370,29033
2021-04-12,MO,Carroll,26,4396,29033
2021-04-13,MO,Carroll,188,4584,29033
2021-04-14,MO,Carroll,20,4604,29033
2021-04-15,MO,Carroll,16,4620,29033
2021-04-16,MO,Carroll,92,4712,29033
2021-04-17,MO,Carroll,7,4719,29033
2021-04-19,MO,Carroll,11,4730,29033
2021-04-20,MO,Carroll,13,4743,29033
2021-04-21,MO,Carroll,9,4752,29033
2021-04-22,MO,Carroll,27,4779,29033
2021-04-23,MO,Carroll,17,4796,29033
2020-12-17,MO,Carter,2,2,29035
2020-12-18,MO,Carter,1,3,29035
2020-12-21,MO,Carter,1,4,29035
2020-12-22,MO,Carter,2,6,29035
2020-12-23,MO,Carter,5,11,29035
2020-12-26,MO,Carter,1,12,29035
2020-12-27,MO,Carter,1,13,29035
2020-12-28,MO,Carter,2,15,29035
2020-12-29,MO,Carter,4,19,29035
2020-12-30,MO,Carter,1,20,29035
2020-12-31,MO,Carter,1,21,29035
2021-01-03,MO,Carter,1,22,29035
2021-01-04,MO,Carter,4,26,29035
2021-01-05,MO,Carter,10,36,29035
2021-01-06,MO,Carter,8,44,29035
2021-01-07,MO,Carter,12,56,29035
2021-01-08,MO,Carter,5,61,29035
2021-01-09,MO,Carter,24,85,29035
2021-01-11,MO,Carter,5,90,29035
2021-01-12,MO,Carter,1,91,29035
2021-01-13,MO,Carter,18,109,29035
2021-01-14,MO,Carter,10,119,29035
2021-01-15,MO,Carter,5,124,29035
2021-01-16,MO,Carter,1,125,29035
2021-01-18,MO,Carter,3,128,29035
2021-01-19,MO,Carter,7,135,29035
2021-01-20,MO,Carter,4,139,29035
2021-01-21,MO,Carter,4,143,29035
2021-01-22,MO,Carter,69,212,29035
2021-01-23,MO,Carter,6,218,29035
2021-01-24,MO,Carter,3,221,29035
2021-01-25,MO,Carter,19,240,29035
2021-01-26,MO,Carter,12,252,29035
2021-01-27,MO,Carter,7,259,29035
2021-01-28,MO,Carter,81,340,29035
2021-01-29,MO,Carter,235,575,29035
2021-01-30,MO,Carter,2,577,29035
2021-02-01,MO,Carter,26,603,29035
2021-02-02,MO,Carter,2,605,29035
2021-02-03,MO,Carter,5,610,29035
2021-02-04,MO,Carter,89,699,29035
2021-02-05,MO,Carter,13,712,29035
2021-02-06,MO,Carter,48,760,29035
2021-02-08,MO,Carter,9,769,29035
2021-02-09,MO,Carter,7,776,29035
2021-02-10,MO,Carter,10,786,29035
2021-02-11,MO,Carter,4,790,29035
2021-02-12,MO,Carter,89,879,29035
2021-02-13,MO,Carter,6,885,29035
2021-02-14,MO,Carter,2,887,29035
2021-02-15,MO,Carter,6,893,29035
2021-02-16,MO,Carter,2,895,29035
2021-02-17,MO,Carter,2,897,29035
2021-02-18,MO,Carter,16,913,29035
2021-02-19,MO,Carter,8,921,29035
2021-02-20,MO,Carter,4,925,29035
2021-02-21,MO,Carter,1,926,29035
2021-02-22,MO,Carter,31,957,29035
2021-02-23,MO,Carter,81,1038,29035
2021-02-24,MO,Carter,10,1048,29035
2021-02-25,MO,Carter,264,1312,29035
2021-02-26,MO,Carter,9,1321,29035
2021-02-27,MO,Carter,7,1328,29035
2021-03-01,MO,Carter,17,1345,29035
2021-03-02,MO,Carter,8,1353,29035
2021-03-03,MO,Carter,8,1361,29035
2021-03-04,MO,Carter,86,1447,29035
2021-03-05,MO,Carter,11,1458,29035
2021-03-06,MO,Carter,26,1484,29035
2021-03-07,MO,Carter,1,1485,29035
2021-03-08,MO,Carter,6,1491,29035
2021-03-09,MO,Carter,36,1527,29035
2021-03-10,MO,Carter,19,1546,29035
2021-03-11,MO,Carter,18,1564,29035
2021-03-12,MO,Carter,9,1573,29035
2021-03-13,MO,Carter,3,1576,29035
2021-03-14,MO,Carter,1,1577,29035
2021-03-15,MO,Carter,5,1582,29035
2021-03-16,MO,Carter,24,1606,29035
2021-03-17,MO,Carter,7,1613,29035
2021-03-18,MO,Carter,38,1651,29035
2021-03-19,MO,Carter,9,1660,29035
2021-03-20,MO,Carter,5,1665,29035
2021-03-22,MO,Carter,1,1666,29035
2021-03-23,MO,Carter,72,1738,29035
2021-03-24,MO,Carter,18,1756,29035
2021-03-25,MO,Carter,3,1759,29035
2021-03-26,MO,Carter,5,1764,29035
2021-03-27,MO,Carter,6,1770,29035
2021-03-28,MO,Carter,2,1772,29035
2021-03-29,MO,Carter,17,1789,29035
2021-03-30,MO,Carter,17,1806,29035
2021-03-31,MO,Carter,14,1820,29035
2021-04-01,MO,Carter,18,1838,29035
2021-04-02,MO,Carter,9,1847,29035
2021-04-03,MO,Carter,3,1850,29035
2021-04-04,MO,Carter,3,1853,29035
2021-04-05,MO,Carter,5,1858,29035
2021-04-06,MO,Carter,10,1868,29035
2021-04-07,MO,Carter,37,1905,29035
2021-04-08,MO,Carter,42,1947,29035
2021-04-09,MO,Carter,31,1978,29035
2021-04-10,MO,Carter,5,1983,29035
2021-04-11,MO,Carter,2,1985,29035
2021-04-12,MO,Carter,16,2001,29035
2021-04-13,MO,Carter,28,2029,29035
2021-04-14,MO,Carter,8,2037,29035
2021-04-15,MO,Carter,34,2071,29035
2021-04-16,MO,Carter,9,2080,29035
2021-04-17,MO,Carter,3,2083,29035
2021-04-18,MO,Carter,3,2086,29035
2021-04-19,MO,Carter,6,2092,29035
2021-04-20,MO,Carter,10,2102,29035
2021-04-21,MO,Carter,12,2114,29035
2021-04-22,MO,Carter,15,2129,29035
2021-04-23,MO,Carter,8,2137,29035
2021-04-24,MO,Carter,3,2140,29035
2021-04-25,MO,Carter,5,2145,29035
2020-12-14,MO,Cass,1,1,29037
2020-12-15,MO,Cass,5,6,29037
2020-12-16,MO,Cass,9,15,29037
2020-12-17,MO,Cass,11,26,29037
2020-12-18,MO,Cass,66,92,29037
2020-12-19,MO,Cass,23,115,29037
2020-12-20,MO,Cass,5,120,29037
2020-12-21,MO,Cass,72,192,29037
2020-12-22,MO,Cass,137,329,29037
2020-12-23,MO,Cass,130,459,29037
2020-12-24,MO,Cass,39,498,29037
2020-12-26,MO,Cass,18,516,29037
2020-12-27,MO,Cass,6,522,29037
2020-12-28,MO,Cass,63,585,29037
2020-12-29,MO,Cass,150,735,29037
2020-12-30,MO,Cass,94,829,29037
2020-12-31,MO,Cass,164,993,29037
2021-01-02,MO,Cass,25,1018,29037
2021-01-03,MO,Cass,2,1020,29037
2021-01-04,MO,Cass,76,1096,29037
2021-01-05,MO,Cass,45,1141,29037
2021-01-06,MO,Cass,191,1332,29037
2021-01-07,MO,Cass,219,1551,29037
2021-01-08,MO,Cass,278,1829,29037
2021-01-09,MO,Cass,46,1875,29037
2021-01-10,MO,Cass,4,1879,29037
2021-01-11,MO,Cass,127,2006,29037
2021-01-12,MO,Cass,186,2192,29037
2021-01-13,MO,Cass,192,2384,29037
2021-01-14,MO,Cass,86,2470,29037
2021-01-15,MO,Cass,220,2690,29037
2021-01-16,MO,Cass,20,2710,29037
2021-01-18,MO,Cass,33,2743,29037
2021-01-19,MO,Cass,122,2865,29037
2021-01-20,MO,Cass,491,3356,29037
2021-01-21,MO,Cass,331,3687,29037
2021-01-22,MO,Cass,200,3887,29037
2021-01-23,MO,Cass,152,4039,29037
2021-01-24,MO,Cass,4,4043,29037
2021-01-25,MO,Cass,115,4158,29037
2021-01-26,MO,Cass,284,4442,29037
2021-01-27,MO,Cass,173,4615,29037
2021-01-28,MO,Cass,237,4852,29037
2021-01-29,MO,Cass,610,5462,29037
2021-01-30,MO,Cass,223,5685,29037
2021-01-31,MO,Cass,36,5721,29037
2021-02-01,MO,Cass,284,6005,29037
2021-02-02,MO,Cass,321,6326,29037
2021-02-03,MO,Cass,506,6832,29037
2021-02-04,MO,Cass,270,7102,29037
2021-02-05,MO,Cass,481,7583,29037
2021-02-06,MO,Cass,219,7802,29037
2021-02-07,MO,Cass,12,7814,29037
2021-02-08,MO,Cass,120,7934,29037
2021-02-09,MO,Cass,352,8286,29037
2021-02-10,MO,Cass,279,8565,29037
2021-02-11,MO,Cass,479,9044,29037
2021-02-12,MO,Cass,629,9673,29037
2021-02-13,MO,Cass,489,10162,29037
2021-02-14,MO,Cass,55,10217,29037
2021-02-15,MO,Cass,105,10322,29037
2021-02-16,MO,Cass,266,10588,29037
2021-02-17,MO,Cass,99,10687,29037
2021-02-18,MO,Cass,256,10943,29037
2021-02-19,MO,Cass,172,11115,29037
2021-02-20,MO,Cass,81,11196,29037
2021-02-21,MO,Cass,36,11232,29037
2021-02-22,MO,Cass,296,11528,29037
2021-02-23,MO,Cass,498,12026,29037
2021-02-24,MO,Cass,1013,13039,29037
2021-02-25,MO,Cass,1001,14040,29037
2021-02-26,MO,Cass,1317,15357,29037
2021-02-27,MO,Cass,639,15996,29037
2021-02-28,MO,Cass,128,16124,29037
2021-03-01,MO,Cass,159,16283,29037
2021-03-02,MO,Cass,707,16990,29037
2021-03-03,MO,Cass,864,17854,29037
2021-03-04,MO,Cass,607,18461,29037
2021-03-05,MO,Cass,335,18796,29037
2021-03-06,MO,Cass,209,19005,29037
2021-03-07,MO,Cass,133,19138,29037
2021-03-08,MO,Cass,230,19368,29037
2021-03-09,MO,Cass,894,20262,29037
2021-03-10,MO,Cass,615,20877,29037
2021-03-11,MO,Cass,1252,22129,29037
2021-03-12,MO,Cass,1741,23870,29037
2021-03-13,MO,Cass,1271,25141,29037
2021-03-14,MO,Cass,153,25294,29037
2021-03-15,MO,Cass,205,25499,29037
2021-03-16,MO,Cass,685,26184,29037
2021-03-17,MO,Cass,677,26861,29037
2021-03-18,MO,Cass,635,27496,29037
2021-03-19,MO,Cass,1536,29032,29037
2021-03-20,MO,Cass,1203,30235,29037
2021-03-21,MO,Cass,164,30399,29037
2021-03-22,MO,Cass,221,30620,29037
2021-03-23,MO,Cass,824,31444,29037
2021-03-24,MO,Cass,685,32129,29037
2021-03-25,MO,Cass,931,33060,29037
2021-03-26,MO,Cass,1622,34682,29037
2021-03-27,MO,Cass,580,35262,29037
2021-03-28,MO,Cass,139,35401,29037
2021-03-29,MO,Cass,236,35637,29037
2021-03-30,MO,Cass,755,36392,29037
2021-03-31,MO,Cass,1083,37475,29037
2021-04-01,MO,Cass,1262,38737,29037
2021-04-02,MO,Cass,954,39691,29037
2021-04-03,MO,Cass,447,40138,29037
2021-04-04,MO,Cass,73,40211,29037
2021-04-05,MO,Cass,334,40545,29037
2021-04-06,MO,Cass,1006,41551,29037
2021-04-07,MO,Cass,1011,42562,29037
2021-04-08,MO,Cass,1160,43722,29037
2021-04-09,MO,Cass,1325,45047,29037
2021-04-10,MO,Cass,876,45923,29037
2021-04-11,MO,Cass,142,46065,29037
2021-04-12,MO,Cass,310,46375,29037
2021-04-13,MO,Cass,739,47114,29037
2021-04-14,MO,Cass,647,47761,29037
2021-04-15,MO,Cass,957,48718,29037
2021-04-16,MO,Cass,1155,49873,29037
2021-04-17,MO,Cass,453,50326,29037
2021-04-18,MO,Cass,86,50412,29037
2021-04-19,MO,Cass,212,50624,29037
2021-04-20,MO,Cass,527,51151,29037
2021-04-21,MO,Cass,161,51312,29037
2021-04-22,MO,Cass,318,51630,29037
2021-04-23,MO,Cass,247,51877,29037
2021-04-24,MO,Cass,268,52145,29037
2021-04-25,MO,Cass,17,52162,29037
2020-12-15,MO,Cedar,2,2,29039
2020-12-16,MO,Cedar,1,3,29039
2020-12-17,MO,Cedar,3,6,29039
2020-12-18,MO,Cedar,7,13,29039
2020-12-19,MO,Cedar,5,18,29039
2020-12-22,MO,Cedar,4,22,29039
2020-12-23,MO,Cedar,4,26,29039
2020-12-28,MO,Cedar,48,74,29039
2020-12-29,MO,Cedar,64,138,29039
2020-12-30,MO,Cedar,9,147,29039
2020-12-31,MO,Cedar,6,153,29039
2021-01-02,MO,Cedar,1,154,29039
2021-01-04,MO,Cedar,4,158,29039
2021-01-05,MO,Cedar,14,172,29039
2021-01-06,MO,Cedar,33,205,29039
2021-01-07,MO,Cedar,9,214,29039
2021-01-08,MO,Cedar,16,230,29039
2021-01-10,MO,Cedar,1,231,29039
2021-01-11,MO,Cedar,5,236,29039
2021-01-12,MO,Cedar,31,267,29039
2021-01-13,MO,Cedar,1,268,29039
2021-01-14,MO,Cedar,33,301,29039
2021-01-15,MO,Cedar,5,306,29039
2021-01-16,MO,Cedar,2,308,29039
2021-01-18,MO,Cedar,4,312,29039
2021-01-19,MO,Cedar,17,329,29039
2021-01-20,MO,Cedar,13,342,29039
2021-01-21,MO,Cedar,18,360,29039
2021-01-22,MO,Cedar,88,448,29039
2021-01-23,MO,Cedar,11,459,29039
2021-01-24,MO,Cedar,3,462,29039
2021-01-25,MO,Cedar,93,555,29039
2021-01-26,MO,Cedar,97,652,29039
2021-01-27,MO,Cedar,79,731,29039
2021-01-28,MO,Cedar,114,845,29039
2021-01-29,MO,Cedar,115,960,29039
2021-01-30,MO,Cedar,6,966,29039
2021-02-01,MO,Cedar,18,984,29039
2021-02-02,MO,Cedar,15,999,29039
2021-02-03,MO,Cedar,25,1024,29039
2021-02-04,MO,Cedar,13,1037,29039
2021-02-05,MO,Cedar,35,1072,29039
2021-02-06,MO,Cedar,5,1077,29039
2021-02-07,MO,Cedar,4,1081,29039
2021-02-08,MO,Cedar,8,1089,29039
2021-02-09,MO,Cedar,16,1105,29039
2021-02-10,MO,Cedar,61,1166,29039
2021-02-11,MO,Cedar,154,1320,29039
2021-02-12,MO,Cedar,117,1437,29039
2021-02-13,MO,Cedar,12,1449,29039
2021-02-14,MO,Cedar,4,1453,29039
2021-02-15,MO,Cedar,9,1462,29039
2021-02-16,MO,Cedar,11,1473,29039
2021-02-17,MO,Cedar,1,1474,29039
2021-02-18,MO,Cedar,14,1488,29039
2021-02-19,MO,Cedar,92,1580,29039
2021-02-20,MO,Cedar,8,1588,29039
2021-02-22,MO,Cedar,51,1639,29039
2021-02-23,MO,Cedar,54,1693,29039
2021-02-24,MO,Cedar,88,1781,29039
2021-02-25,MO,Cedar,357,2138,29039
2021-02-26,MO,Cedar,179,2317,29039
2021-02-27,MO,Cedar,53,2370,29039
2021-02-28,MO,Cedar,3,2373,29039
2021-03-01,MO,Cedar,140,2513,29039
2021-03-02,MO,Cedar,95,2608,29039
2021-03-03,MO,Cedar,109,2717,29039
2021-03-04,MO,Cedar,60,2777,29039
2021-03-05,MO,Cedar,55,2832,29039
2021-03-06,MO,Cedar,92,2924,29039
2021-03-07,MO,Cedar,7,2931,29039
2021-03-08,MO,Cedar,32,2963,29039
2021-03-09,MO,Cedar,83,3046,29039
2021-03-10,MO,Cedar,26,3072,29039
2021-03-11,MO,Cedar,149,3221,29039
2021-03-12,MO,Cedar,144,3365,29039
2021-03-13,MO,Cedar,6,3371,29039
2021-03-14,MO,Cedar,3,3374,29039
2021-03-15,MO,Cedar,49,3423,29039
2021-03-16,MO,Cedar,54,3477,29039
2021-03-17,MO,Cedar,37,3514,29039
2021-03-18,MO,Cedar,122,3636,29039
2021-03-19,MO,Cedar,58,3694,29039
2021-03-20,MO,Cedar,9,3703,29039
2021-03-21,MO,Cedar,2,3705,29039
2021-03-22,MO,Cedar,28,3733,29039
2021-03-23,MO,Cedar,49,3782,29039
2021-03-24,MO,Cedar,60,3842,29039
2021-03-25,MO,Cedar,252,4094,29039
2021-03-26,MO,Cedar,175,4269,29039
2021-03-27,MO,Cedar,52,4321,29039
2021-03-28,MO,Cedar,3,4324,29039
2021-03-29,MO,Cedar,146,4470,29039
2021-03-30,MO,Cedar,85,4555,29039
2021-03-31,MO,Cedar,79,4634,29039
2021-04-01,MO,Cedar,129,4763,29039
2021-04-02,MO,Cedar,33,4796,29039
2021-04-03,MO,Cedar,4,4800,29039
2021-04-05,MO,Cedar,31,4831,29039
2021-04-06,MO,Cedar,35,4866,29039
2021-04-07,MO,Cedar,38,4904,29039
2021-04-08,MO,Cedar,36,4940,29039
2021-04-09,MO,Cedar,60,5000,29039
2021-04-10,MO,Cedar,10,5010,29039
2021-04-11,MO,Cedar,3,5013,29039
2021-04-12,MO,Cedar,46,5059,29039
2021-04-13,MO,Cedar,40,5099,29039
2021-04-14,MO,Cedar,44,5143,29039
2021-04-15,MO,Cedar,98,5241,29039
2021-04-16,MO,Cedar,65,5306,29039
2021-04-17,MO,Cedar,1,5307,29039
2021-04-18,MO,Cedar,1,5308,29039
2021-04-19,MO,Cedar,21,5329,29039
2021-04-20,MO,Cedar,33,5362,29039
2021-04-21,MO,Cedar,13,5375,29039
2021-04-22,MO,Cedar,25,5400,29039
2021-04-23,MO,Cedar,18,5418,29039
2021-04-24,MO,Cedar,5,5423,29039
2021-04-25,MO,Cedar,2,5425,29039
2020-12-16,MO,Chariton,3,3,29041
2020-12-17,MO,Chariton,2,5,29041
2020-12-18,MO,Chariton,6,11,29041
2020-12-19,MO,Chariton,2,13,29041
2020-12-20,MO,Chariton,1,14,29041
2020-12-21,MO,Chariton,4,18,29041
2020-12-22,MO,Chariton,2,20,29041
2020-12-23,MO,Chariton,2,22,29041
2020-12-28,MO,Chariton,4,26,29041
2020-12-29,MO,Chariton,19,45,29041
2020-12-30,MO,Chariton,7,52,29041
2021-01-02,MO,Chariton,1,53,29041
2021-01-04,MO,Chariton,5,58,29041
2021-01-05,MO,Chariton,5,63,29041
2021-01-06,MO,Chariton,10,73,29041
2021-01-07,MO,Chariton,4,77,29041
2021-01-08,MO,Chariton,5,82,29041
2021-01-09,MO,Chariton,2,84,29041
2021-01-10,MO,Chariton,1,85,29041
2021-01-11,MO,Chariton,5,90,29041
2021-01-12,MO,Chariton,11,101,29041
2021-01-13,MO,Chariton,45,146,29041
2021-01-14,MO,Chariton,3,149,29041
2021-01-15,MO,Chariton,4,153,29041
2021-01-16,MO,Chariton,1,154,29041
2021-01-18,MO,Chariton,55,209,29041
2021-01-19,MO,Chariton,15,224,29041
2021-01-20,MO,Chariton,17,241,29041
2021-01-21,MO,Chariton,35,276,29041
2021-01-22,MO,Chariton,26,302,29041
2021-01-23,MO,Chariton,3,305,29041
2021-01-25,MO,Chariton,6,311,29041
2021-01-26,MO,Chariton,7,318,29041
2021-01-27,MO,Chariton,8,326,29041
2021-01-28,MO,Chariton,58,384,29041
2021-01-29,MO,Chariton,157,541,29041
2021-01-30,MO,Chariton,5,546,29041
2021-02-01,MO,Chariton,4,550,29041
2021-02-02,MO,Chariton,20,570,29041
2021-02-03,MO,Chariton,21,591,29041
2021-02-04,MO,Chariton,247,838,29041
2021-02-05,MO,Chariton,89,927,29041
2021-02-06,MO,Chariton,6,933,29041
2021-02-08,MO,Chariton,11,944,29041
2021-02-09,MO,Chariton,19,963,29041
2021-02-10,MO,Chariton,55,1018,29041
2021-02-11,MO,Chariton,33,1051,29041
2021-02-12,MO,Chariton,54,1105,29041
2021-02-13,MO,Chariton,5,1110,29041
2021-02-15,MO,Chariton,55,1165,29041
2021-02-16,MO,Chariton,25,1190,29041
2021-02-17,MO,Chariton,41,1231,29041
2021-02-18,MO,Chariton,63,1294,29041
2021-02-19,MO,Chariton,62,1356,29041
2021-02-20,MO,Chariton,7,1363,29041
2021-02-22,MO,Chariton,5,1368,29041
2021-02-23,MO,Chariton,89,1457,29041
2021-02-24,MO,Chariton,106,1563,29041
2021-02-25,MO,Chariton,60,1623,29041
2021-02-26,MO,Chariton,47,1670,29041
2021-02-27,MO,Chariton,2,1672,29041
2021-02-28,MO,Chariton,1,1673,29041
2021-03-01,MO,Chariton,51,1724,29041
2021-03-02,MO,Chariton,11,1735,29041
2021-03-03,MO,Chariton,19,1754,29041
2021-03-04,MO,Chariton,244,1998,29041
2021-03-05,MO,Chariton,3,2001,29041
2021-03-06,MO,Chariton,5,2006,29041
2021-03-07,MO,Chariton,3,2009,29041
2021-03-08,MO,Chariton,33,2042,29041
2021-03-09,MO,Chariton,106,2148,29041
2021-03-10,MO,Chariton,22,2170,29041
2021-03-11,MO,Chariton,42,2212,29041
2021-03-12,MO,Chariton,74,2286,29041
2021-03-14,MO,Chariton,2,2288,29041
2021-03-15,MO,Chariton,16,2304,29041
2021-03-16,MO,Chariton,69,2373,29041
2021-03-17,MO,Chariton,28,2401,29041
2021-03-18,MO,Chariton,16,2417,29041
2021-03-19,MO,Chariton,34,2451,29041
2021-03-20,MO,Chariton,2,2453,29041
2021-03-21,MO,Chariton,1,2454,29041
2021-03-22,MO,Chariton,23,2477,29041
2021-03-23,MO,Chariton,78,2555,29041
2021-03-24,MO,Chariton,62,2617,29041
2021-03-25,MO,Chariton,69,2686,29041
2021-03-26,MO,Chariton,100,2786,29041
2021-03-27,MO,Chariton,3,2789,29041
2021-03-28,MO,Chariton,3,2792,29041
2021-03-29,MO,Chariton,56,2848,29041
2021-03-30,MO,Chariton,10,2858,29041
2021-03-31,MO,Chariton,27,2885,29041
2021-04-01,MO,Chariton,7,2892,29041
2021-04-02,MO,Chariton,19,2911,29041
2021-04-03,MO,Chariton,2,2913,29041
2021-04-05,MO,Chariton,27,2940,29041
2021-04-06,MO,Chariton,16,2956,29041
2021-04-07,MO,Chariton,51,3007,29041
2021-04-08,MO,Chariton,57,3064,29041
2021-04-09,MO,Chariton,21,3085,29041
2021-04-10,MO,Chariton,2,3087,29041
2021-04-11,MO,Chariton,2,3089,29041
2021-04-12,MO,Chariton,16,3105,29041
2021-04-13,MO,Chariton,44,3149,29041
2021-04-14,MO,Chariton,21,3170,29041
2021-04-15,MO,Chariton,15,3185,29041
2021-04-16,MO,Chariton,45,3230,29041
2021-04-17,MO,Chariton,3,3233,29041
2021-04-18,MO,Chariton,1,3234,29041
2021-04-19,MO,Chariton,8,3242,29041
2021-04-20,MO,Chariton,10,3252,29041
2021-04-21,MO,Chariton,37,3289,29041
2021-04-22,MO,Chariton,13,3302,29041
2021-04-23,MO,Chariton,47,3349,29041
2021-04-24,MO,Chariton,6,3355,29041
2020-12-14,MO,Christian,2,2,29043
2020-12-15,MO,Christian,24,26,29043
2020-12-16,MO,Christian,95,121,29043
2020-12-17,MO,Christian,113,234,29043
2020-12-18,MO,Christian,83,317,29043
2020-12-19,MO,Christian,20,337,29043
2020-12-20,MO,Christian,14,351,29043
2020-12-21,MO,Christian,120,471,29043
2020-12-22,MO,Christian,273,744,29043
2020-12-23,MO,Christian,221,965,29043
2020-12-24,MO,Christian,134,1099,29043
2020-12-26,MO,Christian,80,1179,29043
2020-12-27,MO,Christian,37,1216,29043
2020-12-28,MO,Christian,150,1366,29043
2020-12-29,MO,Christian,169,1535,29043
2020-12-30,MO,Christian,187,1722,29043
2020-12-31,MO,Christian,228,1950,29043
2021-01-01,MO,Christian,1,1951,29043
2021-01-02,MO,Christian,23,1974,29043
2021-01-03,MO,Christian,6,1980,29043
2021-01-04,MO,Christian,67,2047,29043
2021-01-05,MO,Christian,115,2162,29043
2021-01-06,MO,Christian,95,2257,29043
2021-01-07,MO,Christian,57,2314,29043
2021-01-08,MO,Christian,206,2520,29043
2021-01-09,MO,Christian,33,2553,29043
2021-01-10,MO,Christian,25,2578,29043
2021-01-11,MO,Christian,85,2663,29043
2021-01-12,MO,Christian,158,2821,29043
2021-01-13,MO,Christian,174,2995,29043
2021-01-14,MO,Christian,156,3151,29043
2021-01-15,MO,Christian,156,3307,29043
2021-01-16,MO,Christian,102,3409,29043
2021-01-17,MO,Christian,21,3430,29043
2021-01-18,MO,Christian,111,3541,29043
2021-01-19,MO,Christian,160,3701,29043
2021-01-20,MO,Christian,220,3921,29043
2021-01-21,MO,Christian,544,4465,29043
2021-01-22,MO,Christian,358,4823,29043
2021-01-23,MO,Christian,131,4954,29043
2021-01-24,MO,Christian,69,5023,29043
2021-01-25,MO,Christian,311,5334,29043
2021-01-26,MO,Christian,363,5697,29043
2021-01-27,MO,Christian,415,6112,29043
2021-01-28,MO,Christian,726,6838,29043
2021-01-29,MO,Christian,267,7105,29043
2021-01-30,MO,Christian,51,7156,29043
2021-01-31,MO,Christian,3,7159,29043
2021-02-01,MO,Christian,290,7449,29043
2021-02-02,MO,Christian,151,7600,29043
2021-02-03,MO,Christian,330,7930,29043
2021-02-04,MO,Christian,384,8314,29043
2021-02-05,MO,Christian,505,8819,29043
2021-02-06,MO,Christian,380,9199,29043
2021-02-07,MO,Christian,7,9206,29043
2021-02-08,MO,Christian,277,9483,29043
2021-02-09,MO,Christian,332,9815,29043
2021-02-10,MO,Christian,198,10013,29043
2021-02-11,MO,Christian,604,10617,29043
2021-02-12,MO,Christian,428,11045,29043
2021-02-13,MO,Christian,213,11258,29043
2021-02-14,MO,Christian,131,11389,29043
2021-02-15,MO,Christian,97,11486,29043
2021-02-16,MO,Christian,163,11649,29043
2021-02-17,MO,Christian,130,11779,29043
2021-02-18,MO,Christian,275,12054,29043
2021-02-19,MO,Christian,278,12332,29043
2021-02-20,MO,Christian,19,12351,29043
2021-02-21,MO,Christian,15,12366,29043
2021-02-22,MO,Christian,389,12755,29043
2021-02-23,MO,Christian,237,12992,29043
2021-02-24,MO,Christian,354,13346,29043
2021-02-25,MO,Christian,332,13678,29043
2021-02-26,MO,Christian,861,14539,29043
2021-02-27,MO,Christian,648,15187,29043
2021-02-28,MO,Christian,59,15246,29043
2021-03-01,MO,Christian,541,15787,29043
2021-03-02,MO,Christian,312,16099,29043
2021-03-03,MO,Christian,804,16903,29043
2021-03-04,MO,Christian,906,17809,29043
2021-03-05,MO,Christian,988,18797,29043
2021-03-06,MO,Christian,484,19281,29043
2021-03-07,MO,Christian,93,19374,29043
2021-03-08,MO,Christian,499,19873,29043
2021-03-09,MO,Christian,694,20567,29043
2021-03-10,MO,Christian,410,20977,29043
2021-03-11,MO,Christian,525,21502,29043
2021-03-12,MO,Christian,410,21912,29043
2021-03-13,MO,Christian,331,22243,29043
2021-03-14,MO,Christian,112,22355,29043
2021-03-15,MO,Christian,430,22785,29043
2021-03-16,MO,Christian,370,23155,29043
2021-03-17,MO,Christian,446,23601,29043
2021-03-18,MO,Christian,864,24465,29043
2021-03-19,MO,Christian,817,25282,29043
2021-03-20,MO,Christian,264,25546,29043
2021-03-21,MO,Christian,133,25679,29043
2021-03-22,MO,Christian,912,26591,29043
2021-03-23,MO,Christian,602,27193,29043
2021-03-24,MO,Christian,680,27873,29043
2021-03-25,MO,Christian,486,28359,29043
2021-03-26,MO,Christian,830,29189,29043
2021-03-27,MO,Christian,563,29752,29043
2021-03-28,MO,Christian,92,29844,29043
2021-03-29,MO,Christian,509,30353,29043
2021-03-30,MO,Christian,458,30811,29043
2021-03-31,MO,Christian,921,31732,29043
2021-04-01,MO,Christian,903,32635,29043
2021-04-02,MO,Christian,823,33458,29043
2021-04-03,MO,Christian,573,34031,29043
2021-04-04,MO,Christian,116,34147,29043
2021-04-05,MO,Christian,632,34779,29043
2021-04-06,MO,Christian,879,35658,29043
2021-04-07,MO,Christian,625,36283,29043
2021-04-08,MO,Christian,1007,37290,29043
2021-04-09,MO,Christian,1402,38692,29043
2021-04-10,MO,Christian,282,38974,29043
2021-04-11,MO,Christian,107,39081,29043
2021-04-12,MO,Christian,664,39745,29043
2021-04-13,MO,Christian,546,40291,29043
2021-04-14,MO,Christian,543,40834,29043
2021-04-15,MO,Christian,456,41290,29043
2021-04-16,MO,Christian,388,41678,29043
2021-04-17,MO,Christian,195,41873,29043
2021-04-18,MO,Christian,76,41949,29043
2021-04-19,MO,Christian,279,42228,29043
2021-04-20,MO,Christian,328,42556,29043
2021-04-21,MO,Christian,363,42919,29043
2021-04-22,MO,Christian,298,43217,29043
2021-04-23,MO,Christian,272,43489,29043
2021-04-24,MO,Christian,417,43906,29043
2021-04-25,MO,Christian,35,43941,29043
2020-12-21,MO,Clark,3,3,29045
2020-12-23,MO,Clark,4,7,29045
2020-12-28,MO,Clark,3,10,29045
2020-12-29,MO,Clark,2,12,29045
2020-12-30,MO,Clark,3,15,29045
2021-01-02,MO,Clark,1,16,29045
2021-01-05,MO,Clark,1,17,29045
2021-01-07,MO,Clark,3,20,29045
2021-01-11,MO,Clark,4,24,29045
2021-01-12,MO,Clark,1,25,29045
2021-01-13,MO,Clark,1,26,29045
2021-01-15,MO,Clark,1,27,29045
2021-01-17,MO,Clark,1,28,29045
2021-01-18,MO,Clark,9,37,29045
2021-01-19,MO,Clark,6,43,29045
2021-01-20,MO,Clark,37,80,29045
2021-01-21,MO,Clark,20,100,29045
2021-01-22,MO,Clark,86,186,29045
2021-01-23,MO,Clark,2,188,29045
2021-01-26,MO,Clark,2,190,29045
2021-01-27,MO,Clark,3,193,29045
2021-01-28,MO,Clark,17,210,29045
2021-01-29,MO,Clark,25,235,29045
2021-02-01,MO,Clark,34,269,29045
2021-02-02,MO,Clark,24,293,29045
2021-02-03,MO,Clark,45,338,29045
2021-02-04,MO,Clark,36,374,29045
2021-02-05,MO,Clark,34,408,29045
2021-02-06,MO,Clark,8,416,29045
2021-02-08,MO,Clark,22,438,29045
2021-02-09,MO,Clark,35,473,29045
2021-02-10,MO,Clark,14,487,29045
2021-02-11,MO,Clark,28,515,29045
2021-02-12,MO,Clark,31,546,29045
2021-02-13,MO,Clark,1,547,29045
2021-02-14,MO,Clark,3,550,29045
2021-02-15,MO,Clark,3,553,29045
2021-02-16,MO,Clark,19,572,29045
2021-02-17,MO,Clark,57,629,29045
2021-02-19,MO,Clark,119,748,29045
2021-02-20,MO,Clark,1,749,29045
2021-02-22,MO,Clark,1,750,29045
2021-02-23,MO,Clark,10,760,29045
2021-02-24,MO,Clark,11,771,29045
2021-02-25,MO,Clark,37,808,29045
2021-02-26,MO,Clark,26,834,29045
2021-03-01,MO,Clark,65,899,29045
2021-03-02,MO,Clark,18,917,29045
2021-03-03,MO,Clark,46,963,29045
2021-03-04,MO,Clark,38,1001,29045
2021-03-05,MO,Clark,44,1045,29045
2021-03-06,MO,Clark,8,1053,29045
2021-03-08,MO,Clark,9,1062,29045
2021-03-09,MO,Clark,40,1102,29045
2021-03-10,MO,Clark,8,1110,29045
2021-03-11,MO,Clark,23,1133,29045
2021-03-12,MO,Clark,19,1152,29045
2021-03-13,MO,Clark,1,1153,29045
2021-03-14,MO,Clark,2,1155,29045
2021-03-15,MO,Clark,13,1168,29045
2021-03-16,MO,Clark,16,1184,29045
2021-03-17,MO,Clark,44,1228,29045
2021-03-18,MO,Clark,31,1259,29045
2021-03-19,MO,Clark,92,1351,29045
2021-03-20,MO,Clark,1,1352,29045
2021-03-21,MO,Clark,1,1353,29045
2021-03-22,MO,Clark,2,1355,29045
2021-03-23,MO,Clark,14,1369,29045
2021-03-24,MO,Clark,31,1400,29045
2021-03-25,MO,Clark,41,1441,29045
2021-03-26,MO,Clark,26,1467,29045
2021-03-27,MO,Clark,1,1468,29045
2021-03-28,MO,Clark,1,1469,29045
2021-03-29,MO,Clark,16,1485,29045
2021-03-30,MO,Clark,17,1502,29045
2021-03-31,MO,Clark,12,1514,29045
2021-04-01,MO,Clark,22,1536,29045
2021-04-02,MO,Clark,19,1555,29045
2021-04-03,MO,Clark,1,1556,29045
2021-04-05,MO,Clark,17,1573,29045
2021-04-06,MO,Clark,8,1581,29045
2021-04-07,MO,Clark,9,1590,29045
2021-04-08,MO,Clark,15,1605,29045
2021-04-09,MO,Clark,17,1622,29045
2021-04-10,MO,Clark,3,1625,29045
2021-04-11,MO,Clark,4,1629,29045
2021-04-12,MO,Clark,7,1636,29045
2021-04-13,MO,Clark,9,1645,29045
2021-04-14,MO,Clark,11,1656,29045
2021-04-15,MO,Clark,9,1665,29045
2021-04-16,MO,Clark,83,1748,29045
2021-04-17,MO,Clark,1,1749,29045
2021-04-18,MO,Clark,1,1750,29045
2021-04-19,MO,Clark,12,1762,29045
2021-04-20,MO,Clark,8,1770,29045
2021-04-21,MO,Clark,3,1773,29045
2021-04-22,MO,Clark,2,1775,29045
2021-04-23,MO,Clark,15,1790,29045
2021-04-24,MO,Clark,3,1793,29045
2021-04-25,MO,Clark,1,1794,29045
2020-12-14,MO,Clay,2,2,29047
2020-12-15,MO,Clay,7,9,29047
2020-12-16,MO,Clay,2,11,29047
2020-12-17,MO,Clay,25,36,29047
2020-12-18,MO,Clay,19,55,29047
2020-12-19,MO,Clay,34,89,29047
2020-12-20,MO,Clay,3,92,29047
2020-12-21,MO,Clay,109,201,29047
2020-12-22,MO,Clay,244,445,29047
2020-12-23,MO,Clay,145,590,29047
2020-12-24,MO,Clay,33,623,29047
2020-12-26,MO,Clay,6,629,29047
2020-12-27,MO,Clay,7,636,29047
2020-12-28,MO,Clay,50,686,29047
2020-12-29,MO,Clay,211,897,29047
2020-12-30,MO,Clay,343,1240,29047
2020-12-31,MO,Clay,275,1515,29047
2021-01-01,MO,Clay,2,1517,29047
2021-01-02,MO,Clay,54,1571,29047
2021-01-03,MO,Clay,16,1587,29047
2021-01-04,MO,Clay,35,1622,29047
2021-01-05,MO,Clay,155,1777,29047
2021-01-06,MO,Clay,262,2039,29047
2021-01-07,MO,Clay,190,2229,29047
2021-01-08,MO,Clay,165,2394,29047
2021-01-09,MO,Clay,94,2488,29047
2021-01-10,MO,Clay,6,2494,29047
2021-01-11,MO,Clay,334,2828,29047
2021-01-12,MO,Clay,396,3224,29047
2021-01-13,MO,Clay,194,3418,29047
2021-01-14,MO,Clay,194,3612,29047
2021-01-15,MO,Clay,379,3991,29047
2021-01-16,MO,Clay,53,4044,29047
2021-01-17,MO,Clay,3,4047,29047
2021-01-18,MO,Clay,98,4145,29047
2021-01-19,MO,Clay,355,4500,29047
2021-01-20,MO,Clay,289,4789,29047
2021-01-21,MO,Clay,395,5184,29047
2021-01-22,MO,Clay,305,5489,29047
2021-01-23,MO,Clay,67,5556,29047
2021-01-24,MO,Clay,4,5560,29047
2021-01-25,MO,Clay,168,5728,29047
2021-01-26,MO,Clay,292,6020,29047
2021-01-27,MO,Clay,303,6323,29047
2021-01-28,MO,Clay,481,6804,29047
2021-01-29,MO,Clay,380,7184,29047
2021-01-30,MO,Clay,452,7636,29047
2021-01-31,MO,Clay,82,7718,29047
2021-02-01,MO,Clay,274,7992,29047
2021-02-02,MO,Clay,212,8204,29047
2021-02-03,MO,Clay,324,8528,29047
2021-02-04,MO,Clay,681,9209,29047
2021-02-05,MO,Clay,1178,10387,29047
2021-02-06,MO,Clay,483,10870,29047
2021-02-07,MO,Clay,32,10902,29047
2021-02-08,MO,Clay,238,11140,29047
2021-02-09,MO,Clay,233,11373,29047
2021-02-10,MO,Clay,202,11575,29047
2021-02-11,MO,Clay,376,11951,29047
2021-02-12,MO,Clay,468,12419,29047
2021-02-13,MO,Clay,182,12601,29047
2021-02-14,MO,Clay,64,12665,29047
2021-02-15,MO,Clay,195,12860,29047
2021-02-16,MO,Clay,254,13114,29047
2021-02-17,MO,Clay,246,13360,29047
2021-02-18,MO,Clay,1067,14427,29047
2021-02-19,MO,Clay,259,14686,29047
2021-02-20,MO,Clay,392,15078,29047
2021-02-21,MO,Clay,30,15108,29047
2021-02-22,MO,Clay,269,15377,29047
2021-02-23,MO,Clay,283,15660,29047
2021-02-24,MO,Clay,399,16059,29047
2021-02-25,MO,Clay,1544,17603,29047
2021-02-26,MO,Clay,1675,19278,29047
2021-02-27,MO,Clay,360,19638,29047
2021-02-28,MO,Clay,85,19723,29047
2021-03-01,MO,Clay,452,20175,29047
2021-03-02,MO,Clay,321,20496,29047
2021-03-03,MO,Clay,582,21078,29047
2021-03-04,MO,Clay,1377,22455,29047
2021-03-05,MO,Clay,1101,23556,29047
2021-03-06,MO,Clay,616,24172,29047
2021-03-07,MO,Clay,133,24305,29047
2021-03-08,MO,Clay,1073,25378,29047
2021-03-09,MO,Clay,923,26301,29047
2021-03-10,MO,Clay,331,26632,29047
2021-03-11,MO,Clay,517,27149,29047
2021-03-12,MO,Clay,429,27578,29047
2021-03-13,MO,Clay,267,27845,29047
2021-03-14,MO,Clay,153,27998,29047
2021-03-15,MO,Clay,702,28700,29047
2021-03-16,MO,Clay,531,29231,29047
2021-03-17,MO,Clay,1150,30381,29047
2021-03-18,MO,Clay,1046,31427,29047
2021-03-19,MO,Clay,1058,32485,29047
2021-03-20,MO,Clay,340,32825,29047
2021-03-21,MO,Clay,191,33016,29047
2021-03-22,MO,Clay,323,33339,29047
2021-03-23,MO,Clay,581,33920,29047
2021-03-24,MO,Clay,741,34661,29047
2021-03-25,MO,Clay,1605,36266,29047
2021-03-26,MO,Clay,1699,37965,29047
2021-03-27,MO,Clay,513,38478,29047
2021-03-28,MO,Clay,81,38559,29047
2021-03-29,MO,Clay,1715,40274,29047
2021-03-30,MO,Clay,1787,42061,29047
2021-03-31,MO,Clay,558,42619,29047
2021-04-01,MO,Clay,1220,43839,29047
2021-04-02,MO,Clay,1158,44997,29047
2021-04-03,MO,Clay,240,45237,29047
2021-04-04,MO,Clay,89,45326,29047
2021-04-05,MO,Clay,691,46017,29047
2021-04-06,MO,Clay,806,46823,29047
2021-04-07,MO,Clay,596,47419,29047
2021-04-08,MO,Clay,1139,48558,29047
2021-04-09,MO,Clay,1478,50036,29047
2021-04-10,MO,Clay,388,50424,29047
2021-04-11,MO,Clay,138,50562,29047
2021-04-12,MO,Clay,498,51060,29047
2021-04-13,MO,Clay,670,51730,29047
2021-04-14,MO,Clay,537,52267,29047
2021-04-15,MO,Clay,1081,53348,29047
2021-04-16,MO,Clay,1001,54349,29047
2021-04-17,MO,Clay,206,54555,29047
2021-04-18,MO,Clay,108,54663,29047
2021-04-19,MO,Clay,401,55064,29047
2021-04-20,MO,Clay,407,55471,29047
2021-04-21,MO,Clay,495,55966,29047
2021-04-22,MO,Clay,1073,57039,29047
2021-04-23,MO,Clay,995,58034,29047
2021-04-24,MO,Clay,203,58237,29047
2021-04-25,MO,Clay,17,58254,29047
2020-12-18,MO,Clinton,2,2,29049
2020-12-19,MO,Clinton,2,4,29049
2020-12-20,MO,Clinton,1,5,29049
2020-12-21,MO,Clinton,15,20,29049
2020-12-22,MO,Clinton,18,38,29049
2020-12-23,MO,Clinton,27,65,29049
2020-12-24,MO,Clinton,8,73,29049
2020-12-27,MO,Clinton,7,80,29049
2020-12-28,MO,Clinton,29,109,29049
2020-12-29,MO,Clinton,34,143,29049
2020-12-30,MO,Clinton,39,182,29049
2020-12-31,MO,Clinton,28,210,29049
2021-01-02,MO,Clinton,33,243,29049
2021-01-03,MO,Clinton,8,251,29049
2021-01-04,MO,Clinton,23,274,29049
2021-01-05,MO,Clinton,19,293,29049
2021-01-06,MO,Clinton,62,355,29049
2021-01-07,MO,Clinton,12,367,29049
2021-01-08,MO,Clinton,28,395,29049
2021-01-09,MO,Clinton,8,403,29049
2021-01-11,MO,Clinton,46,449,29049
2021-01-12,MO,Clinton,42,491,29049
2021-01-13,MO,Clinton,83,574,29049
2021-01-14,MO,Clinton,91,665,29049
2021-01-15,MO,Clinton,42,707,29049
2021-01-16,MO,Clinton,74,781,29049
2021-01-17,MO,Clinton,3,784,29049
2021-01-18,MO,Clinton,26,810,29049
2021-01-19,MO,Clinton,99,909,29049
2021-01-20,MO,Clinton,86,995,29049
2021-01-21,MO,Clinton,70,1065,29049
2021-01-22,MO,Clinton,45,1110,29049
2021-01-23,MO,Clinton,4,1114,29049
2021-01-24,MO,Clinton,11,1125,29049
2021-01-25,MO,Clinton,68,1193,29049
2021-01-26,MO,Clinton,42,1235,29049
2021-01-27,MO,Clinton,27,1262,29049
2021-01-28,MO,Clinton,103,1365,29049
2021-01-29,MO,Clinton,101,1466,29049
2021-01-30,MO,Clinton,41,1507,29049
2021-01-31,MO,Clinton,20,1527,29049
2021-02-01,MO,Clinton,42,1569,29049
2021-02-02,MO,Clinton,81,1650,29049
2021-02-03,MO,Clinton,186,1836,29049
2021-02-04,MO,Clinton,260,2096,29049
2021-02-05,MO,Clinton,159,2255,29049
2021-02-06,MO,Clinton,33,2288,29049
2021-02-07,MO,Clinton,4,2292,29049
2021-02-08,MO,Clinton,50,2342,29049
2021-02-09,MO,Clinton,51,2393,29049
2021-02-10,MO,Clinton,36,2429,29049
2021-02-11,MO,Clinton,64,2493,29049
2021-02-12,MO,Clinton,63,2556,29049
2021-02-13,MO,Clinton,437,2993,29049
2021-02-14,MO,Clinton,84,3077,29049
2021-02-15,MO,Clinton,28,3105,29049
2021-02-16,MO,Clinton,53,3158,29049
2021-02-17,MO,Clinton,67,3225,29049
2021-02-18,MO,Clinton,62,3287,29049
2021-02-19,MO,Clinton,81,3368,29049
2021-02-20,MO,Clinton,72,3440,29049
2021-02-21,MO,Clinton,7,3447,29049
2021-02-22,MO,Clinton,117,3564,29049
2021-02-23,MO,Clinton,30,3594,29049
2021-02-24,MO,Clinton,79,3673,29049
2021-02-25,MO,Clinton,297,3970,29049
2021-02-26,MO,Clinton,91,4061,29049
2021-02-27,MO,Clinton,52,4113,29049
2021-02-28,MO,Clinton,9,4122,29049
2021-03-01,MO,Clinton,50,4172,29049
2021-03-02,MO,Clinton,65,4237,29049
2021-03-03,MO,Clinton,170,4407,29049
2021-03-04,MO,Clinton,163,4570,29049
2021-03-05,MO,Clinton,125,4695,29049
2021-03-06,MO,Clinton,70,4765,29049
2021-03-07,MO,Clinton,11,4776,29049
2021-03-08,MO,Clinton,55,4831,29049
2021-03-09,MO,Clinton,69,4900,29049
2021-03-10,MO,Clinton,59,4959,29049
2021-03-11,MO,Clinton,161,5120,29049
2021-03-12,MO,Clinton,67,5187,29049
2021-03-13,MO,Clinton,43,5230,29049
2021-03-14,MO,Clinton,16,5246,29049
2021-03-15,MO,Clinton,60,5306,29049
2021-03-16,MO,Clinton,69,5375,29049
2021-03-17,MO,Clinton,115,5490,29049
2021-03-18,MO,Clinton,209,5699,29049
2021-03-19,MO,Clinton,105,5804,29049
2021-03-20,MO,Clinton,48,5852,29049
2021-03-21,MO,Clinton,16,5868,29049
2021-03-22,MO,Clinton,40,5908,29049
2021-03-23,MO,Clinton,49,5957,29049
2021-03-24,MO,Clinton,174,6131,29049
2021-03-25,MO,Clinton,162,6293,29049
2021-03-26,MO,Clinton,165,6458,29049
2021-03-27,MO,Clinton,27,6485,29049
2021-03-28,MO,Clinton,4,6489,29049
2021-03-29,MO,Clinton,130,6619,29049
2021-03-30,MO,Clinton,106,6725,29049
2021-03-31,MO,Clinton,146,6871,29049
2021-04-01,MO,Clinton,185,7056,29049
2021-04-02,MO,Clinton,194,7250,29049
2021-04-03,MO,Clinton,17,7267,29049
2021-04-04,MO,Clinton,4,7271,29049
2021-04-05,MO,Clinton,53,7324,29049
2021-04-06,MO,Clinton,111,7435,29049
2021-04-07,MO,Clinton,89,7524,29049
2021-04-08,MO,Clinton,172,7696,29049
2021-04-09,MO,Clinton,181,7877,29049
2021-04-10,MO,Clinton,37,7914,29049
2021-04-11,MO,Clinton,14,7928,29049
2021-04-12,MO,Clinton,49,7977,29049
2021-04-13,MO,Clinton,91,8068,29049
2021-04-14,MO,Clinton,118,8186,29049
2021-04-15,MO,Clinton,159,8345,29049
2021-04-16,MO,Clinton,209,8554,29049
2021-04-17,MO,Clinton,19,8573,29049
2021-04-18,MO,Clinton,13,8586,29049
2021-04-19,MO,Clinton,117,8703,29049
2021-04-20,MO,Clinton,67,8770,29049
2021-04-21,MO,Clinton,59,8829,29049
2021-04-22,MO,Clinton,149,8978,29049
2021-04-23,MO,Clinton,188,9166,29049
2021-04-24,MO,Clinton,22,9188,29049
2021-04-25,MO,Clinton,1,9189,29049
2020-12-15,MO,Cole,36,36,29051
2020-12-16,MO,Cole,63,99,29051
2020-12-17,MO,Cole,184,283,29051
2020-12-18,MO,Cole,244,527,29051
2020-12-19,MO,Cole,18,545,29051
2020-12-20,MO,Cole,34,579,29051
2020-12-21,MO,Cole,122,701,29051
2020-12-22,MO,Cole,122,823,29051
2020-12-23,MO,Cole,84,907,29051
2020-12-24,MO,Cole,6,913,29051
2020-12-26,MO,Cole,3,916,29051
2020-12-27,MO,Cole,3,919,29051
2020-12-28,MO,Cole,43,962,29051
2020-12-29,MO,Cole,64,1026,29051
2020-12-30,MO,Cole,150,1176,29051
2020-12-31,MO,Cole,33,1209,29051
2021-01-01,MO,Cole,6,1215,29051
2021-01-02,MO,Cole,15,1230,29051
2021-01-03,MO,Cole,13,1243,29051
2021-01-04,MO,Cole,72,1315,29051
2021-01-05,MO,Cole,57,1372,29051
2021-01-06,MO,Cole,135,1507,29051
2021-01-07,MO,Cole,327,1834,29051
2021-01-08,MO,Cole,214,2048,29051
2021-01-09,MO,Cole,28,2076,29051
2021-01-10,MO,Cole,102,2178,29051
2021-01-11,MO,Cole,208,2386,29051
2021-01-12,MO,Cole,172,2558,29051
2021-01-13,MO,Cole,142,2700,29051
2021-01-14,MO,Cole,153,2853,29051
2021-01-15,MO,Cole,202,3055,29051
2021-01-16,MO,Cole,58,3113,29051
2021-01-17,MO,Cole,4,3117,29051
2021-01-18,MO,Cole,173,3290,29051
2021-01-19,MO,Cole,322,3612,29051
2021-01-20,MO,Cole,199,3811,29051
2021-01-21,MO,Cole,397,4208,29051
2021-01-22,MO,Cole,794,5002,29051
2021-01-23,MO,Cole,786,5788,29051
2021-01-24,MO,Cole,10,5798,29051
2021-01-25,MO,Cole,383,6181,29051
2021-01-26,MO,Cole,367,6548,29051
2021-01-27,MO,Cole,519,7067,29051
2021-01-28,MO,Cole,349,7416,29051
2021-01-29,MO,Cole,885,8301,29051
2021-01-30,MO,Cole,613,8914,29051
2021-01-31,MO,Cole,32,8946,29051
2021-02-01,MO,Cole,194,9140,29051
2021-02-02,MO,Cole,290,9430,29051
2021-02-03,MO,Cole,224,9654,29051
2021-02-04,MO,Cole,743,10397,29051
2021-02-05,MO,Cole,1355,11752,29051
2021-02-06,MO,Cole,267,12019,29051
2021-02-07,MO,Cole,1,12020,29051
2021-02-08,MO,Cole,319,12339,29051
2021-02-09,MO,Cole,288,12627,29051
2021-02-10,MO,Cole,281,12908,29051
2021-02-11,MO,Cole,695,13603,29051
2021-02-12,MO,Cole,849,14452,29051
2021-02-13,MO,Cole,895,15347,29051
2021-02-14,MO,Cole,10,15357,29051
2021-02-15,MO,Cole,98,15455,29051
2021-02-16,MO,Cole,233,15688,29051
2021-02-17,MO,Cole,300,15988,29051
2021-02-18,MO,Cole,661,16649,29051
2021-02-19,MO,Cole,1119,17768,29051
2021-02-20,MO,Cole,620,18388,29051
2021-02-21,MO,Cole,2,18390,29051
2021-02-22,MO,Cole,370,18760,29051
2021-02-23,MO,Cole,358,19118,29051
2021-02-24,MO,Cole,360,19478,29051
2021-02-25,MO,Cole,860,20338,29051
2021-02-26,MO,Cole,2032,22370,29051
2021-02-27,MO,Cole,325,22695,29051
2021-02-28,MO,Cole,22,22717,29051
2021-03-01,MO,Cole,735,23452,29051
2021-03-02,MO,Cole,400,23852,29051
2021-03-03,MO,Cole,491,24343,29051
2021-03-04,MO,Cole,601,24944,29051
2021-03-05,MO,Cole,372,25316,29051
2021-03-06,MO,Cole,67,25383,29051
2021-03-07,MO,Cole,77,25460,29051
2021-03-08,MO,Cole,160,25620,29051
2021-03-09,MO,Cole,214,25834,29051
2021-03-10,MO,Cole,506,26340,29051
2021-03-11,MO,Cole,567,26907,29051
2021-03-12,MO,Cole,677,27584,29051
2021-03-13,MO,Cole,30,27614,29051
2021-03-14,MO,Cole,7,27621,29051
2021-03-15,MO,Cole,548,28169,29051
2021-03-16,MO,Cole,559,28728,29051
2021-03-17,MO,Cole,367,29095,29051
2021-03-18,MO,Cole,327,29422,29051
2021-03-19,MO,Cole,1057,30479,29051
2021-03-20,MO,Cole,109,30588,29051
2021-03-21,MO,Cole,92,30680,29051
2021-03-22,MO,Cole,557,31237,29051
2021-03-23,MO,Cole,272,31509,29051
2021-03-24,MO,Cole,472,31981,29051
2021-03-25,MO,Cole,784,32765,29051
2021-03-26,MO,Cole,788,33553,29051
2021-03-27,MO,Cole,236,33789,29051
2021-03-28,MO,Cole,81,33870,29051
2021-03-29,MO,Cole,763,34633,29051
2021-03-30,MO,Cole,707,35340,29051
2021-03-31,MO,Cole,510,35850,29051
2021-04-01,MO,Cole,661,36511,29051
2021-04-02,MO,Cole,664,37175,29051
2021-04-03,MO,Cole,89,37264,29051
2021-04-04,MO,Cole,85,37349,29051
2021-04-05,MO,Cole,401,37750,29051
2021-04-06,MO,Cole,327,38077,29051
2021-04-07,MO,Cole,232,38309,29051
2021-04-08,MO,Cole,318,38627,29051
2021-04-09,MO,Cole,1112,39739,29051
2021-04-10,MO,Cole,69,39808,29051
2021-04-11,MO,Cole,72,39880,29051
2021-04-12,MO,Cole,489,40369,29051
2021-04-13,MO,Cole,570,40939,29051
2021-04-14,MO,Cole,626,41565,29051
2021-04-15,MO,Cole,435,42000,29051
2021-04-16,MO,Cole,290,42290,29051
2021-04-17,MO,Cole,114,42404,29051
2021-04-18,MO,Cole,30,42434,29051
2021-04-19,MO,Cole,552,42986,29051
2021-04-20,MO,Cole,370,43356,29051
2021-04-21,MO,Cole,291,43647,29051
2021-04-22,MO,Cole,333,43980,29051
2021-04-23,MO,Cole,225,44205,29051
2021-04-24,MO,Cole,61,44266,29051
2021-04-25,MO,Cole,15,44281,29051
2020-12-15,MO,Cooper,1,1,29053
2020-12-16,MO,Cooper,4,5,29053
2020-12-17,MO,Cooper,15,20,29053
2020-12-18,MO,Cooper,24,44,29053
2020-12-19,MO,Cooper,10,54,29053
2020-12-20,MO,Cooper,7,61,29053
2020-12-21,MO,Cooper,21,82,29053
2020-12-22,MO,Cooper,29,111,29053
2020-12-23,MO,Cooper,5,116,29053
2020-12-24,MO,Cooper,1,117,29053
2020-12-27,MO,Cooper,1,118,29053
2020-12-28,MO,Cooper,23,141,29053
2020-12-29,MO,Cooper,36,177,29053
2020-12-30,MO,Cooper,29,206,29053
2020-12-31,MO,Cooper,12,218,29053
2021-01-01,MO,Cooper,3,221,29053
2021-01-02,MO,Cooper,6,227,29053
2021-01-03,MO,Cooper,6,233,29053
2021-01-04,MO,Cooper,5,238,29053
2021-01-05,MO,Cooper,17,255,29053
2021-01-06,MO,Cooper,25,280,29053
2021-01-07,MO,Cooper,24,304,29053
2021-01-08,MO,Cooper,26,330,29053
2021-01-09,MO,Cooper,10,340,29053
2021-01-10,MO,Cooper,13,353,29053
2021-01-11,MO,Cooper,50,403,29053
2021-01-12,MO,Cooper,66,469,29053
2021-01-13,MO,Cooper,12,481,29053
2021-01-14,MO,Cooper,58,539,29053
2021-01-15,MO,Cooper,17,556,29053
2021-01-16,MO,Cooper,11,567,29053
2021-01-17,MO,Cooper,4,571,29053
2021-01-18,MO,Cooper,56,627,29053
2021-01-19,MO,Cooper,28,655,29053
2021-01-20,MO,Cooper,95,750,29053
2021-01-21,MO,Cooper,92,842,29053
2021-01-22,MO,Cooper,87,929,29053
2021-01-23,MO,Cooper,14,943,29053
2021-01-24,MO,Cooper,5,948,29053
2021-01-25,MO,Cooper,29,977,29053
2021-01-26,MO,Cooper,66,1043,29053
2021-01-27,MO,Cooper,22,1065,29053
2021-01-28,MO,Cooper,624,1689,29053
2021-01-29,MO,Cooper,356,2045,29053
2021-01-30,MO,Cooper,13,2058,29053
2021-01-31,MO,Cooper,4,2062,29053
2021-02-01,MO,Cooper,38,2100,29053
2021-02-02,MO,Cooper,32,2132,29053
2021-02-03,MO,Cooper,88,2220,29053
2021-02-04,MO,Cooper,191,2411,29053
2021-02-05,MO,Cooper,61,2472,29053
2021-02-06,MO,Cooper,42,2514,29053
2021-02-08,MO,Cooper,36,2550,29053
2021-02-09,MO,Cooper,62,2612,29053
2021-02-10,MO,Cooper,36,2648,29053
2021-02-11,MO,Cooper,59,2707,29053
2021-02-12,MO,Cooper,43,2750,29053
2021-02-13,MO,Cooper,28,2778,29053
2021-02-14,MO,Cooper,4,2782,29053
2021-02-15,MO,Cooper,56,2838,29053
2021-02-16,MO,Cooper,55,2893,29053
2021-02-17,MO,Cooper,214,3107,29053
2021-02-18,MO,Cooper,251,3358,29053
2021-02-19,MO,Cooper,323,3681,29053
2021-02-20,MO,Cooper,8,3689,29053
2021-02-21,MO,Cooper,1,3690,29053
2021-02-22,MO,Cooper,49,3739,29053
2021-02-23,MO,Cooper,286,4025,29053
2021-02-24,MO,Cooper,282,4307,29053
2021-02-25,MO,Cooper,203,4510,29053
2021-02-26,MO,Cooper,81,4591,29053
2021-02-27,MO,Cooper,60,4651,29053
2021-02-28,MO,Cooper,7,4658,29053
2021-03-01,MO,Cooper,156,4814,29053
2021-03-02,MO,Cooper,264,5078,29053
2021-03-03,MO,Cooper,146,5224,29053
2021-03-04,MO,Cooper,89,5313,29053
2021-03-05,MO,Cooper,136,5449,29053
2021-03-06,MO,Cooper,55,5504,29053
2021-03-07,MO,Cooper,6,5510,29053
2021-03-08,MO,Cooper,27,5537,29053
2021-03-09,MO,Cooper,65,5602,29053
2021-03-10,MO,Cooper,58,5660,29053
2021-03-11,MO,Cooper,58,5718,29053
2021-03-12,MO,Cooper,89,5807,29053
2021-03-13,MO,Cooper,22,5829,29053
2021-03-14,MO,Cooper,25,5854,29053
2021-03-15,MO,Cooper,47,5901,29053
2021-03-16,MO,Cooper,73,5974,29053
2021-03-17,MO,Cooper,109,6083,29053
2021-03-18,MO,Cooper,50,6133,29053
2021-03-19,MO,Cooper,86,6219,29053
2021-03-20,MO,Cooper,19,6238,29053
2021-03-21,MO,Cooper,26,6264,29053
2021-03-22,MO,Cooper,194,6458,29053
2021-03-23,MO,Cooper,230,6688,29053
2021-03-24,MO,Cooper,92,6780,29053
2021-03-25,MO,Cooper,99,6879,29053
2021-03-26,MO,Cooper,84,6963,29053
2021-03-27,MO,Cooper,84,7047,29053
2021-03-28,MO,Cooper,10,7057,29053
2021-03-29,MO,Cooper,59,7116,29053
2021-03-30,MO,Cooper,116,7232,29053
2021-03-31,MO,Cooper,204,7436,29053
2021-04-01,MO,Cooper,83,7519,29053
2021-04-02,MO,Cooper,139,7658,29053
2021-04-03,MO,Cooper,33,7691,29053
2021-04-04,MO,Cooper,7,7698,29053
2021-04-05,MO,Cooper,77,7775,29053
2021-04-06,MO,Cooper,72,7847,29053
2021-04-07,MO,Cooper,53,7900,29053
2021-04-08,MO,Cooper,62,7962,29053
2021-04-09,MO,Cooper,102,8064,29053
2021-04-10,MO,Cooper,20,8084,29053
2021-04-11,MO,Cooper,61,8145,29053
2021-04-12,MO,Cooper,72,8217,29053
2021-04-13,MO,Cooper,62,8279,29053
2021-04-14,MO,Cooper,55,8334,29053
2021-04-15,MO,Cooper,197,8531,29053
2021-04-16,MO,Cooper,60,8591,29053
2021-04-17,MO,Cooper,49,8640,29053
2021-04-18,MO,Cooper,11,8651,29053
2021-04-19,MO,Cooper,26,8677,29053
2021-04-20,MO,Cooper,67,8744,29053
2021-04-21,MO,Cooper,95,8839,29053
2021-04-22,MO,Cooper,47,8886,29053
2021-04-23,MO,Cooper,58,8944,29053
2021-04-24,MO,Cooper,22,8966,29053
2021-04-25,MO,Cooper,7,8973,29053
2020-12-16,MO,Crawford,2,2,29055
2020-12-17,MO,Crawford,2,4,29055
2020-12-18,MO,Crawford,15,19,29055
2020-12-19,MO,Crawford,3,22,29055
2020-12-20,MO,Crawford,2,24,29055
2020-12-21,MO,Crawford,6,30,29055
2020-12-22,MO,Crawford,12,42,29055
2020-12-23,MO,Crawford,8,50,29055
2020-12-24,MO,Crawford,1,51,29055
2020-12-26,MO,Crawford,1,52,29055
2020-12-28,MO,Crawford,7,59,29055
2020-12-29,MO,Crawford,11,70,29055
2020-12-30,MO,Crawford,17,87,29055
2020-12-31,MO,Crawford,12,99,29055
2021-01-01,MO,Crawford,7,106,29055
2021-01-02,MO,Crawford,17,123,29055
2021-01-03,MO,Crawford,4,127,29055
2021-01-04,MO,Crawford,15,142,29055
2021-01-05,MO,Crawford,17,159,29055
2021-01-06,MO,Crawford,22,181,29055
2021-01-07,MO,Crawford,24,205,29055
2021-01-08,MO,Crawford,18,223,29055
2021-01-09,MO,Crawford,8,231,29055
2021-01-10,MO,Crawford,1,232,29055
2021-01-11,MO,Crawford,19,251,29055
2021-01-12,MO,Crawford,18,269,29055
2021-01-13,MO,Crawford,29,298,29055
2021-01-14,MO,Crawford,17,315,29055
2021-01-15,MO,Crawford,15,330,29055
2021-01-16,MO,Crawford,8,338,29055
2021-01-18,MO,Crawford,17,355,29055
2021-01-19,MO,Crawford,73,428,29055
2021-01-20,MO,Crawford,63,491,29055
2021-01-21,MO,Crawford,33,524,29055
2021-01-22,MO,Crawford,28,552,29055
2021-01-23,MO,Crawford,49,601,29055
2021-01-24,MO,Crawford,1,602,29055
2021-01-25,MO,Crawford,40,642,29055
2021-01-26,MO,Crawford,24,666,29055
2021-01-27,MO,Crawford,28,694,29055
2021-01-28,MO,Crawford,76,770,29055
2021-01-29,MO,Crawford,53,823,29055
2021-01-30,MO,Crawford,54,877,29055
2021-01-31,MO,Crawford,3,880,29055
2021-02-01,MO,Crawford,14,894,29055
2021-02-02,MO,Crawford,16,910,29055
2021-02-03,MO,Crawford,46,956,29055
2021-02-04,MO,Crawford,91,1047,29055
2021-02-05,MO,Crawford,229,1276,29055
2021-02-06,MO,Crawford,30,1306,29055
2021-02-08,MO,Crawford,90,1396,29055
2021-02-09,MO,Crawford,115,1511,29055
2021-02-10,MO,Crawford,75,1586,29055
2021-02-11,MO,Crawford,73,1659,29055
2021-02-12,MO,Crawford,96,1755,29055
2021-02-13,MO,Crawford,35,1790,29055
2021-02-14,MO,Crawford,8,1798,29055
2021-02-15,MO,Crawford,21,1819,29055
2021-02-16,MO,Crawford,82,1901,29055
2021-02-17,MO,Crawford,57,1958,29055
2021-02-18,MO,Crawford,41,1999,29055
2021-02-19,MO,Crawford,45,2044,29055
2021-02-20,MO,Crawford,34,2078,29055
2021-02-21,MO,Crawford,1,2079,29055
2021-02-22,MO,Crawford,49,2128,29055
2021-02-23,MO,Crawford,81,2209,29055
2021-02-24,MO,Crawford,122,2331,29055
2021-02-25,MO,Crawford,77,2408,29055
2021-02-26,MO,Crawford,201,2609,29055
2021-02-27,MO,Crawford,62,2671,29055
2021-02-28,MO,Crawford,13,2684,29055
2021-03-01,MO,Crawford,138,2822,29055
2021-03-02,MO,Crawford,245,3067,29055
2021-03-03,MO,Crawford,88,3155,29055
2021-03-04,MO,Crawford,161,3316,29055
2021-03-05,MO,Crawford,301,3617,29055
2021-03-06,MO,Crawford,236,3853,29055
2021-03-07,MO,Crawford,10,3863,29055
2021-03-08,MO,Crawford,53,3916,29055
2021-03-09,MO,Crawford,79,3995,29055
2021-03-10,MO,Crawford,91,4086,29055
2021-03-11,MO,Crawford,78,4164,29055
2021-03-12,MO,Crawford,120,4284,29055
2021-03-13,MO,Crawford,17,4301,29055
2021-03-14,MO,Crawford,8,4309,29055
2021-03-15,MO,Crawford,66,4375,29055
2021-03-16,MO,Crawford,80,4455,29055
2021-03-17,MO,Crawford,55,4510,29055
2021-03-18,MO,Crawford,95,4605,29055
2021-03-19,MO,Crawford,92,4697,29055
2021-03-20,MO,Crawford,28,4725,29055
2021-03-21,MO,Crawford,17,4742,29055
2021-03-22,MO,Crawford,58,4800,29055
2021-03-23,MO,Crawford,162,4962,29055
2021-03-24,MO,Crawford,116,5078,29055
2021-03-25,MO,Crawford,117,5195,29055
2021-03-26,MO,Crawford,355,5550,29055
2021-03-27,MO,Crawford,226,5776,29055
2021-03-28,MO,Crawford,10,5786,29055
2021-03-29,MO,Crawford,101,5887,29055
2021-03-30,MO,Crawford,99,5986,29055
2021-03-31,MO,Crawford,149,6135,29055
2021-04-01,MO,Crawford,102,6237,29055
2021-04-02,MO,Crawford,68,6305,29055
2021-04-03,MO,Crawford,15,6320,29055
2021-04-04,MO,Crawford,7,6327,29055
2021-04-05,MO,Crawford,60,6387,29055
2021-04-06,MO,Crawford,56,6443,29055
2021-04-07,MO,Crawford,127,6570,29055
2021-04-08,MO,Crawford,59,6629,29055
2021-04-09,MO,Crawford,263,6892,29055
2021-04-10,MO,Crawford,31,6923,29055
2021-04-11,MO,Crawford,18,6941,29055
2021-04-12,MO,Crawford,157,7098,29055
2021-04-13,MO,Crawford,85,7183,29055
2021-04-14,MO,Crawford,173,7356,29055
2021-04-15,MO,Crawford,89,7445,29055
2021-04-16,MO,Crawford,77,7522,29055
2021-04-17,MO,Crawford,25,7547,29055
2021-04-18,MO,Crawford,16,7563,29055
2021-04-19,MO,Crawford,21,7584,29055
2021-04-20,MO,Crawford,69,7653,29055
2021-04-21,MO,Crawford,78,7731,29055
2021-04-22,MO,Crawford,48,7779,29055
2021-04-23,MO,Crawford,49,7828,29055
2021-04-24,MO,Crawford,10,7838,29055
2021-04-25,MO,Crawford,8,7846,29055
2020-12-16,MO,Dade,1,1,29057
2020-12-17,MO,Dade,2,3,29057
2020-12-18,MO,Dade,3,6,29057
2020-12-21,MO,Dade,3,9,29057
2020-12-22,MO,Dade,4,13,29057
2020-12-23,MO,Dade,6,19,29057
2020-12-24,MO,Dade,6,25,29057
2020-12-26,MO,Dade,3,28,29057
2020-12-28,MO,Dade,1,29,29057
2020-12-29,MO,Dade,5,34,29057
2020-12-30,MO,Dade,14,48,29057
2020-12-31,MO,Dade,5,53,29057
2021-01-03,MO,Dade,1,54,29057
2021-01-04,MO,Dade,4,58,29057
2021-01-05,MO,Dade,49,107,29057
2021-01-06,MO,Dade,3,110,29057
2021-01-07,MO,Dade,4,114,29057
2021-01-08,MO,Dade,68,182,29057
2021-01-10,MO,Dade,1,183,29057
2021-01-11,MO,Dade,5,188,29057
2021-01-12,MO,Dade,7,195,29057
2021-01-13,MO,Dade,4,199,29057
2021-01-14,MO,Dade,4,203,29057
2021-01-15,MO,Dade,13,216,29057
2021-01-16,MO,Dade,4,220,29057
2021-01-17,MO,Dade,1,221,29057
2021-01-18,MO,Dade,4,225,29057
2021-01-19,MO,Dade,6,231,29057
2021-01-20,MO,Dade,6,237,29057
2021-01-21,MO,Dade,18,255,29057
2021-01-22,MO,Dade,8,263,29057
2021-01-23,MO,Dade,7,270,29057
2021-01-24,MO,Dade,5,275,29057
2021-01-25,MO,Dade,89,364,29057
2021-01-26,MO,Dade,19,383,29057
2021-01-27,MO,Dade,22,405,29057
2021-01-28,MO,Dade,101,506,29057
2021-01-29,MO,Dade,125,631,29057
2021-01-30,MO,Dade,23,654,29057
2021-02-01,MO,Dade,77,731,29057
2021-02-02,MO,Dade,67,798,29057
2021-02-03,MO,Dade,5,803,29057
2021-02-04,MO,Dade,8,811,29057
2021-02-05,MO,Dade,148,959,29057
2021-02-06,MO,Dade,4,963,29057
2021-02-07,MO,Dade,1,964,29057
2021-02-08,MO,Dade,9,973,29057
2021-02-09,MO,Dade,10,983,29057
2021-02-10,MO,Dade,8,991,29057
2021-02-11,MO,Dade,19,1010,29057
2021-02-12,MO,Dade,101,1111,29057
2021-02-13,MO,Dade,16,1127,29057
2021-02-14,MO,Dade,5,1132,29057
2021-02-15,MO,Dade,1,1133,29057
2021-02-16,MO,Dade,8,1141,29057
2021-02-17,MO,Dade,8,1149,29057
2021-02-18,MO,Dade,10,1159,29057
2021-02-19,MO,Dade,107,1266,29057
2021-02-20,MO,Dade,37,1303,29057
2021-02-21,MO,Dade,2,1305,29057
2021-02-22,MO,Dade,104,1409,29057
2021-02-23,MO,Dade,111,1520,29057
2021-02-24,MO,Dade,20,1540,29057
2021-02-25,MO,Dade,21,1561,29057
2021-02-26,MO,Dade,128,1689,29057
2021-02-27,MO,Dade,14,1703,29057
2021-02-28,MO,Dade,5,1708,29057
2021-03-01,MO,Dade,102,1810,29057
2021-03-02,MO,Dade,31,1841,29057
2021-03-03,MO,Dade,18,1859,29057
2021-03-04,MO,Dade,20,1879,29057
2021-03-05,MO,Dade,111,1990,29057
2021-03-06,MO,Dade,35,2025,29057
2021-03-07,MO,Dade,2,2027,29057
2021-03-08,MO,Dade,115,2142,29057
2021-03-09,MO,Dade,31,2173,29057
2021-03-10,MO,Dade,18,2191,29057
2021-03-11,MO,Dade,65,2256,29057
2021-03-12,MO,Dade,90,2346,29057
2021-03-13,MO,Dade,12,2358,29057
2021-03-14,MO,Dade,3,2361,29057
2021-03-15,MO,Dade,87,2448,29057
2021-03-16,MO,Dade,63,2511,29057
2021-03-17,MO,Dade,107,2618,29057
2021-03-18,MO,Dade,28,2646,29057
2021-03-19,MO,Dade,90,2736,29057
2021-03-20,MO,Dade,13,2749,29057
2021-03-21,MO,Dade,4,2753,29057
2021-03-22,MO,Dade,54,2807,29057
2021-03-23,MO,Dade,39,2846,29057
2021-03-24,MO,Dade,19,2865,29057
2021-03-25,MO,Dade,44,2909,29057
2021-03-26,MO,Dade,111,3020,29057
2021-03-27,MO,Dade,12,3032,29057
2021-03-28,MO,Dade,4,3036,29057
2021-03-29,MO,Dade,57,3093,29057
2021-03-30,MO,Dade,24,3117,29057
2021-03-31,MO,Dade,43,3160,29057
2021-04-01,MO,Dade,33,3193,29057
2021-04-02,MO,Dade,45,3238,29057
2021-04-03,MO,Dade,15,3253,29057
2021-04-04,MO,Dade,1,3254,29057
2021-04-05,MO,Dade,37,3291,29057
2021-04-06,MO,Dade,41,3332,29057
2021-04-07,MO,Dade,13,3345,29057
2021-04-08,MO,Dade,66,3411,29057
2021-04-09,MO,Dade,105,3516,29057
2021-04-10,MO,Dade,13,3529,29057
2021-04-11,MO,Dade,4,3533,29057
2021-04-12,MO,Dade,88,3621,29057
2021-04-13,MO,Dade,64,3685,29057
2021-04-14,MO,Dade,17,3702,29057
2021-04-15,MO,Dade,36,3738,29057
2021-04-16,MO,Dade,109,3847,29057
2021-04-17,MO,Dade,11,3858,29057
2021-04-18,MO,Dade,3,3861,29057
2021-04-19,MO,Dade,34,3895,29057
2021-04-20,MO,Dade,23,3918,29057
2021-04-21,MO,Dade,20,3938,29057
2021-04-22,MO,Dade,38,3976,29057
2021-04-23,MO,Dade,12,3988,29057
2021-04-24,MO,Dade,10,3998,29057
2021-04-25,MO,Dade,2,4000,29057
2020-12-15,MO,Dallas,1,1,29059
2020-12-16,MO,Dallas,5,6,29059
2020-12-17,MO,Dallas,4,10,29059
2020-12-18,MO,Dallas,5,15,29059
2020-12-19,MO,Dallas,1,16,29059
2020-12-21,MO,Dallas,7,23,29059
2020-12-22,MO,Dallas,14,37,29059
2020-12-23,MO,Dallas,13,50,29059
2020-12-24,MO,Dallas,9,59,29059
2020-12-26,MO,Dallas,2,61,29059
2020-12-27,MO,Dallas,2,63,29059
2020-12-28,MO,Dallas,7,70,29059
2020-12-29,MO,Dallas,17,87,29059
2020-12-30,MO,Dallas,8,95,29059
2020-12-31,MO,Dallas,54,149,29059
2021-01-02,MO,Dallas,4,153,29059
2021-01-04,MO,Dallas,11,164,29059
2021-01-05,MO,Dallas,17,181,29059
2021-01-06,MO,Dallas,5,186,29059
2021-01-07,MO,Dallas,5,191,29059
2021-01-08,MO,Dallas,14,205,29059
2021-01-09,MO,Dallas,2,207,29059
2021-01-10,MO,Dallas,4,211,29059
2021-01-11,MO,Dallas,7,218,29059
2021-01-12,MO,Dallas,25,243,29059
2021-01-13,MO,Dallas,8,251,29059
2021-01-14,MO,Dallas,11,262,29059
2021-01-15,MO,Dallas,11,273,29059
2021-01-16,MO,Dallas,8,281,29059
2021-01-17,MO,Dallas,4,285,29059
2021-01-18,MO,Dallas,6,291,29059
2021-01-19,MO,Dallas,14,305,29059
2021-01-20,MO,Dallas,22,327,29059
2021-01-21,MO,Dallas,26,353,29059
2021-01-22,MO,Dallas,35,388,29059
2021-01-23,MO,Dallas,10,398,29059
2021-01-24,MO,Dallas,2,400,29059
2021-01-25,MO,Dallas,58,458,29059
2021-01-26,MO,Dallas,174,632,29059
2021-01-27,MO,Dallas,45,677,29059
2021-01-28,MO,Dallas,117,794,29059
2021-01-29,MO,Dallas,65,859,29059
2021-01-30,MO,Dallas,5,864,29059
2021-02-01,MO,Dallas,58,922,29059
2021-02-02,MO,Dallas,142,1064,29059
2021-02-03,MO,Dallas,42,1106,29059
2021-02-04,MO,Dallas,14,1120,29059
2021-02-05,MO,Dallas,45,1165,29059
2021-02-06,MO,Dallas,22,1187,29059
2021-02-07,MO,Dallas,1,1188,29059
2021-02-08,MO,Dallas,16,1204,29059
2021-02-09,MO,Dallas,36,1240,29059
2021-02-10,MO,Dallas,80,1320,29059
2021-02-11,MO,Dallas,128,1448,29059
2021-02-12,MO,Dallas,235,1683,29059
2021-02-13,MO,Dallas,26,1709,29059
2021-02-14,MO,Dallas,11,1720,29059
2021-02-15,MO,Dallas,12,1732,29059
2021-02-16,MO,Dallas,10,1742,29059
2021-02-17,MO,Dallas,26,1768,29059
2021-02-18,MO,Dallas,18,1786,29059
2021-02-19,MO,Dallas,270,2056,29059
2021-02-20,MO,Dallas,23,2079,29059
2021-02-21,MO,Dallas,1,2080,29059
2021-02-22,MO,Dallas,30,2110,29059
2021-02-23,MO,Dallas,144,2254,29059
2021-02-24,MO,Dallas,31,2285,29059
2021-02-25,MO,Dallas,95,2380,29059
2021-02-26,MO,Dallas,120,2500,29059
2021-02-27,MO,Dallas,42,2542,29059
2021-02-28,MO,Dallas,2,2544,29059
2021-03-01,MO,Dallas,74,2618,29059
2021-03-02,MO,Dallas,167,2785,29059
2021-03-03,MO,Dallas,76,2861,29059
2021-03-04,MO,Dallas,117,2978,29059
2021-03-05,MO,Dallas,81,3059,29059
2021-03-06,MO,Dallas,116,3175,29059
2021-03-07,MO,Dallas,7,3182,29059
2021-03-08,MO,Dallas,54,3236,29059
2021-03-09,MO,Dallas,112,3348,29059
2021-03-10,MO,Dallas,97,3445,29059
2021-03-11,MO,Dallas,86,3531,29059
2021-03-12,MO,Dallas,241,3772,29059
2021-03-13,MO,Dallas,31,3803,29059
2021-03-14,MO,Dallas,5,3808,29059
2021-03-15,MO,Dallas,172,3980,29059
2021-03-16,MO,Dallas,33,4013,29059
2021-03-17,MO,Dallas,208,4221,29059
2021-03-18,MO,Dallas,111,4332,29059
2021-03-19,MO,Dallas,278,4610,29059
2021-03-20,MO,Dallas,21,4631,29059
2021-03-21,MO,Dallas,15,4646,29059
2021-03-22,MO,Dallas,62,4708,29059
2021-03-23,MO,Dallas,49,4757,29059
2021-03-24,MO,Dallas,52,4809,29059
2021-03-25,MO,Dallas,55,4864,29059
2021-03-26,MO,Dallas,117,4981,29059
2021-03-27,MO,Dallas,38,5019,29059
2021-03-28,MO,Dallas,29,5048,29059
2021-03-29,MO,Dallas,15,5063,29059
2021-03-30,MO,Dallas,43,5106,29059
2021-03-31,MO,Dallas,84,5190,29059
2021-04-01,MO,Dallas,59,5249,29059
2021-04-02,MO,Dallas,103,5352,29059
2021-04-03,MO,Dallas,29,5381,29059
2021-04-04,MO,Dallas,26,5407,29059
2021-04-05,MO,Dallas,36,5443,29059
2021-04-06,MO,Dallas,78,5521,29059
2021-04-07,MO,Dallas,63,5584,29059
2021-04-08,MO,Dallas,93,5677,29059
2021-04-09,MO,Dallas,99,5776,29059
2021-04-10,MO,Dallas,30,5806,29059
2021-04-11,MO,Dallas,30,5836,29059
2021-04-12,MO,Dallas,55,5891,29059
2021-04-13,MO,Dallas,43,5934,29059
2021-04-14,MO,Dallas,49,5983,29059
2021-04-15,MO,Dallas,34,6017,29059
2021-04-16,MO,Dallas,75,6092,29059
2021-04-17,MO,Dallas,150,6242,29059
2021-04-18,MO,Dallas,15,6257,29059
2021-04-19,MO,Dallas,23,6280,29059
2021-04-20,MO,Dallas,22,6302,29059
2021-04-21,MO,Dallas,30,6332,29059
2021-04-22,MO,Dallas,32,6364,29059
2021-04-23,MO,Dallas,30,6394,29059
2021-04-24,MO,Dallas,14,6408,29059
2021-04-25,MO,Dallas,6,6414,29059
2020-12-21,MO,Daviess,3,3,29061
2020-12-22,MO,Daviess,4,7,29061
2020-12-23,MO,Daviess,2,9,29061
2020-12-24,MO,Daviess,1,10,29061
2020-12-26,MO,Daviess,1,11,29061
2020-12-28,MO,Daviess,7,18,29061
2020-12-29,MO,Daviess,47,65,29061
2020-12-30,MO,Daviess,23,88,29061
2020-12-31,MO,Daviess,12,100,29061
2021-01-02,MO,Daviess,2,102,29061
2021-01-04,MO,Daviess,2,104,29061
2021-01-05,MO,Daviess,12,116,29061
2021-01-06,MO,Daviess,2,118,29061
2021-01-07,MO,Daviess,3,121,29061
2021-01-08,MO,Daviess,10,131,29061
2021-01-09,MO,Daviess,1,132,29061
2021-01-11,MO,Daviess,5,137,29061
2021-01-12,MO,Daviess,23,160,29061
2021-01-13,MO,Daviess,25,185,29061
2021-01-14,MO,Daviess,15,200,29061
2021-01-15,MO,Daviess,14,214,29061
2021-01-16,MO,Daviess,13,227,29061
2021-01-17,MO,Daviess,1,228,29061
2021-01-18,MO,Daviess,1,229,29061
2021-01-19,MO,Daviess,2,231,29061
2021-01-20,MO,Daviess,6,237,29061
2021-01-21,MO,Daviess,11,248,29061
2021-01-22,MO,Daviess,13,261,29061
2021-01-23,MO,Daviess,3,264,29061
2021-01-25,MO,Daviess,10,274,29061
2021-01-26,MO,Daviess,4,278,29061
2021-01-27,MO,Daviess,22,300,29061
2021-01-28,MO,Daviess,58,358,29061
2021-01-29,MO,Daviess,97,455,29061
2021-01-30,MO,Daviess,42,497,29061
2021-01-31,MO,Daviess,2,499,29061
2021-02-01,MO,Daviess,13,512,29061
2021-02-02,MO,Daviess,21,533,29061
2021-02-03,MO,Daviess,33,566,29061
2021-02-04,MO,Daviess,63,629,29061
2021-02-05,MO,Daviess,132,761,29061
2021-02-06,MO,Daviess,1,762,29061
2021-02-08,MO,Daviess,8,770,29061
2021-02-09,MO,Daviess,37,807,29061
2021-02-10,MO,Daviess,21,828,29061
2021-02-11,MO,Daviess,21,849,29061
2021-02-12,MO,Daviess,124,973,29061
2021-02-13,MO,Daviess,15,988,29061
2021-02-14,MO,Daviess,15,1003,29061
2021-02-16,MO,Daviess,3,1006,29061
2021-02-17,MO,Daviess,5,1011,29061
2021-02-18,MO,Daviess,20,1031,29061
2021-02-19,MO,Daviess,16,1047,29061
2021-02-20,MO,Daviess,6,1053,29061
2021-02-22,MO,Daviess,13,1066,29061
2021-02-23,MO,Daviess,15,1081,29061
2021-02-24,MO,Daviess,29,1110,29061
2021-02-25,MO,Daviess,127,1237,29061
2021-02-26,MO,Daviess,104,1341,29061
2021-02-27,MO,Daviess,75,1416,29061
2021-02-28,MO,Daviess,2,1418,29061
2021-03-01,MO,Daviess,6,1424,29061
2021-03-02,MO,Daviess,7,1431,29061
2021-03-03,MO,Daviess,22,1453,29061
2021-03-04,MO,Daviess,14,1467,29061
2021-03-05,MO,Daviess,140,1607,29061
2021-03-06,MO,Daviess,31,1638,29061
2021-03-07,MO,Daviess,2,1640,29061
2021-03-08,MO,Daviess,16,1656,29061
2021-03-09,MO,Daviess,14,1670,29061
2021-03-10,MO,Daviess,6,1676,29061
2021-03-11,MO,Daviess,65,1741,29061
2021-03-12,MO,Daviess,132,1873,29061
2021-03-13,MO,Daviess,1,1874,29061
2021-03-14,MO,Daviess,3,1877,29061
2021-03-15,MO,Daviess,26,1903,29061
2021-03-16,MO,Daviess,31,1934,29061
2021-03-17,MO,Daviess,40,1974,29061
2021-03-18,MO,Daviess,77,2051,29061
2021-03-19,MO,Daviess,41,2092,29061
2021-03-20,MO,Daviess,7,2099,29061
2021-03-21,MO,Daviess,3,2102,29061
2021-03-22,MO,Daviess,15,2117,29061
2021-03-23,MO,Daviess,17,2134,29061
2021-03-24,MO,Daviess,27,2161,29061
2021-03-25,MO,Daviess,104,2265,29061
2021-03-26,MO,Daviess,32,2297,29061
2021-03-27,MO,Daviess,12,2309,29061
2021-03-29,MO,Daviess,28,2337,29061
2021-03-30,MO,Daviess,11,2348,29061
2021-03-31,MO,Daviess,16,2364,29061
2021-04-01,MO,Daviess,35,2399,29061
2021-04-02,MO,Daviess,13,2412,29061
2021-04-03,MO,Daviess,7,2419,29061
2021-04-05,MO,Daviess,18,2437,29061
2021-04-06,MO,Daviess,9,2446,29061
2021-04-07,MO,Daviess,18,2464,29061
2021-04-08,MO,Daviess,19,2483,29061
2021-04-09,MO,Daviess,76,2559,29061
2021-04-10,MO,Daviess,7,2566,29061
2021-04-11,MO,Daviess,6,2572,29061
2021-04-12,MO,Daviess,20,2592,29061
2021-04-13,MO,Daviess,14,2606,29061
2021-04-14,MO,Daviess,19,2625,29061
2021-04-15,MO,Daviess,44,2669,29061
2021-04-16,MO,Daviess,17,2686,29061
2021-04-17,MO,Daviess,1,2687,29061
2021-04-18,MO,Daviess,3,2690,29061
2021-04-19,MO,Daviess,9,2699,29061
2021-04-20,MO,Daviess,17,2716,29061
2021-04-21,MO,Daviess,17,2733,29061
2021-04-22,MO,Daviess,12,2745,29061
2021-04-23,MO,Daviess,10,2755,29061
2021-04-24,MO,Daviess,8,2763,29061
2020-12-16,MO,DeKalb,2,2,29063
2020-12-20,MO,DeKalb,1,3,29063
2020-12-21,MO,DeKalb,1,4,29063
2020-12-22,MO,DeKalb,3,7,29063
2020-12-23,MO,DeKalb,4,11,29063
2020-12-24,MO,DeKalb,1,12,29063
2020-12-27,MO,DeKalb,6,18,29063
2020-12-28,MO,DeKalb,13,31,29063
2020-12-29,MO,DeKalb,14,45,29063
2020-12-30,MO,DeKalb,34,79,29063
2020-12-31,MO,DeKalb,5,84,29063
2021-01-02,MO,DeKalb,1,85,29063
2021-01-03,MO,DeKalb,9,94,29063
2021-01-04,MO,DeKalb,13,107,29063
2021-01-05,MO,DeKalb,13,120,29063
2021-01-06,MO,DeKalb,17,137,29063
2021-01-07,MO,DeKalb,6,143,29063
2021-01-08,MO,DeKalb,5,148,29063
2021-01-10,MO,DeKalb,2,150,29063
2021-01-11,MO,DeKalb,2,152,29063
2021-01-12,MO,DeKalb,5,157,29063
2021-01-13,MO,DeKalb,30,187,29063
2021-01-14,MO,DeKalb,24,211,29063
2021-01-15,MO,DeKalb,9,220,29063
2021-01-16,MO,DeKalb,8,228,29063
2021-01-17,MO,DeKalb,2,230,29063
2021-01-18,MO,DeKalb,3,233,29063
2021-01-19,MO,DeKalb,4,237,29063
2021-01-20,MO,DeKalb,25,262,29063
2021-01-21,MO,DeKalb,25,287,29063
2021-01-22,MO,DeKalb,10,297,29063
2021-01-25,MO,DeKalb,15,312,29063
2021-01-26,MO,DeKalb,22,334,29063
2021-01-27,MO,DeKalb,41,375,29063
2021-01-28,MO,DeKalb,27,402,29063
2021-01-29,MO,DeKalb,55,457,29063
2021-01-30,MO,DeKalb,6,463,29063
2021-01-31,MO,DeKalb,6,469,29063
2021-02-01,MO,DeKalb,157,626,29063
2021-02-02,MO,DeKalb,40,666,29063
2021-02-03,MO,DeKalb,59,725,29063
2021-02-04,MO,DeKalb,57,782,29063
2021-02-05,MO,DeKalb,52,834,29063
2021-02-06,MO,DeKalb,1,835,29063
2021-02-07,MO,DeKalb,2,837,29063
2021-02-08,MO,DeKalb,16,853,29063
2021-02-09,MO,DeKalb,38,891,29063
2021-02-10,MO,DeKalb,40,931,29063
2021-02-11,MO,DeKalb,60,991,29063
2021-02-12,MO,DeKalb,27,1018,29063
2021-02-13,MO,DeKalb,49,1067,29063
2021-02-14,MO,DeKalb,8,1075,29063
2021-02-15,MO,DeKalb,1,1076,29063
2021-02-16,MO,DeKalb,16,1092,29063
2021-02-17,MO,DeKalb,22,1114,29063
2021-02-18,MO,DeKalb,25,1139,29063
2021-02-19,MO,DeKalb,80,1219,29063
2021-02-20,MO,DeKalb,5,1224,29063
2021-02-22,MO,DeKalb,177,1401,29063
2021-02-23,MO,DeKalb,16,1417,29063
2021-02-24,MO,DeKalb,30,1447,29063
2021-02-25,MO,DeKalb,65,1512,29063
2021-02-26,MO,DeKalb,36,1548,29063
2021-02-27,MO,DeKalb,23,1571,29063
2021-03-01,MO,DeKalb,55,1626,29063
2021-03-02,MO,DeKalb,41,1667,29063
2021-03-03,MO,DeKalb,71,1738,29063
2021-03-04,MO,DeKalb,78,1816,29063
2021-03-05,MO,DeKalb,38,1854,29063
2021-03-06,MO,DeKalb,19,1873,29063
2021-03-07,MO,DeKalb,1,1874,29063
2021-03-08,MO,DeKalb,18,1892,29063
2021-03-09,MO,DeKalb,73,1965,29063
2021-03-10,MO,DeKalb,255,2220,29063
2021-03-11,MO,DeKalb,160,2380,29063
2021-03-12,MO,DeKalb,55,2435,29063
2021-03-13,MO,DeKalb,6,2441,29063
2021-03-14,MO,DeKalb,1,2442,29063
2021-03-15,MO,DeKalb,40,2482,29063
2021-03-16,MO,DeKalb,54,2536,29063
2021-03-17,MO,DeKalb,46,2582,29063
2021-03-18,MO,DeKalb,52,2634,29063
2021-03-19,MO,DeKalb,91,2725,29063
2021-03-20,MO,DeKalb,1,2726,29063
2021-03-22,MO,DeKalb,7,2733,29063
2021-03-23,MO,DeKalb,46,2779,29063
2021-03-24,MO,DeKalb,45,2824,29063
2021-03-25,MO,DeKalb,77,2901,29063
2021-03-26,MO,DeKalb,57,2958,29063
2021-03-27,MO,DeKalb,2,2960,29063
2021-03-29,MO,DeKalb,51,3011,29063
2021-03-30,MO,DeKalb,56,3067,29063
2021-03-31,MO,DeKalb,47,3114,29063
2021-04-01,MO,DeKalb,48,3162,29063
2021-04-02,MO,DeKalb,30,3192,29063
2021-04-03,MO,DeKalb,5,3197,29063
2021-04-04,MO,DeKalb,2,3199,29063
2021-04-05,MO,DeKalb,13,3212,29063
2021-04-06,MO,DeKalb,44,3256,29063
2021-04-07,MO,DeKalb,234,3490,29063
2021-04-08,MO,DeKalb,148,3638,29063
2021-04-09,MO,DeKalb,76,3714,29063
2021-04-10,MO,DeKalb,4,3718,29063
2021-04-11,MO,DeKalb,2,3720,29063
2021-04-12,MO,DeKalb,23,3743,29063
2021-04-13,MO,DeKalb,27,3770,29063
2021-04-14,MO,DeKalb,65,3835,29063
2021-04-15,MO,DeKalb,48,3883,29063
2021-04-16,MO,DeKalb,55,3938,29063
2021-04-17,MO,DeKalb,6,3944,29063
2021-04-18,MO,DeKalb,3,3947,29063
2021-04-19,MO,DeKalb,32,3979,29063
2021-04-20,MO,DeKalb,56,4035,29063
2021-04-21,MO,DeKalb,11,4046,29063
2021-04-22,MO,DeKalb,23,4069,29063
2021-04-23,MO,DeKalb,20,4089,29063
2021-04-24,MO,DeKalb,4,4093,29063
2021-04-25,MO,DeKalb,1,4094,29063
2020-12-15,MO,Dent,2,2,29065
2020-12-16,MO,Dent,3,5,29065
2020-12-17,MO,Dent,2,7,29065
2020-12-18,MO,Dent,7,14,29065
2020-12-21,MO,Dent,1,15,29065
2020-12-22,MO,Dent,2,17,29065
2020-12-23,MO,Dent,2,19,29065
2020-12-27,MO,Dent,1,20,29065
2020-12-28,MO,Dent,4,24,29065
2020-12-29,MO,Dent,10,34,29065
2020-12-30,MO,Dent,10,44,29065
2020-12-31,MO,Dent,4,48,29065
2021-01-01,MO,Dent,5,53,29065
2021-01-02,MO,Dent,9,62,29065
2021-01-03,MO,Dent,5,67,29065
2021-01-04,MO,Dent,7,74,29065
2021-01-05,MO,Dent,12,86,29065
2021-01-06,MO,Dent,18,104,29065
2021-01-07,MO,Dent,12,116,29065
2021-01-08,MO,Dent,15,131,29065
2021-01-11,MO,Dent,22,153,29065
2021-01-12,MO,Dent,31,184,29065
2021-01-13,MO,Dent,36,220,29065
2021-01-14,MO,Dent,54,274,29065
2021-01-15,MO,Dent,33,307,29065
2021-01-16,MO,Dent,38,345,29065
2021-01-18,MO,Dent,20,365,29065
2021-01-19,MO,Dent,37,402,29065
2021-01-20,MO,Dent,15,417,29065
2021-01-21,MO,Dent,9,426,29065
2021-01-22,MO,Dent,23,449,29065
2021-01-23,MO,Dent,45,494,29065
2021-01-25,MO,Dent,46,540,29065
2021-01-26,MO,Dent,5,545,29065
2021-01-27,MO,Dent,15,560,29065
2021-01-28,MO,Dent,23,583,29065
2021-01-29,MO,Dent,32,615,29065
2021-01-30,MO,Dent,27,642,29065
2021-01-31,MO,Dent,1,643,29065
2021-02-01,MO,Dent,22,665,29065
2021-02-02,MO,Dent,40,705,29065
2021-02-03,MO,Dent,50,755,29065
2021-02-04,MO,Dent,78,833,29065
2021-02-05,MO,Dent,244,1077,29065
2021-02-06,MO,Dent,10,1087,29065
2021-02-08,MO,Dent,32,1119,29065
2021-02-09,MO,Dent,12,1131,29065
2021-02-10,MO,Dent,150,1281,29065
2021-02-11,MO,Dent,333,1614,29065
2021-02-12,MO,Dent,189,1803,29065
2021-02-13,MO,Dent,92,1895,29065
2021-02-14,MO,Dent,6,1901,29065
2021-02-15,MO,Dent,15,1916,29065
2021-02-16,MO,Dent,25,1941,29065
2021-02-17,MO,Dent,2,1943,29065
2021-02-18,MO,Dent,72,2015,29065
2021-02-19,MO,Dent,20,2035,29065
2021-02-20,MO,Dent,4,2039,29065
2021-02-22,MO,Dent,42,2081,29065
2021-02-23,MO,Dent,18,2099,29065
2021-02-24,MO,Dent,42,2141,29065
2021-02-25,MO,Dent,92,2233,29065
2021-02-26,MO,Dent,53,2286,29065
2021-02-27,MO,Dent,43,2329,29065
2021-02-28,MO,Dent,5,2334,29065
2021-03-01,MO,Dent,20,2354,29065
2021-03-02,MO,Dent,43,2397,29065
2021-03-03,MO,Dent,215,2612,29065
2021-03-04,MO,Dent,69,2681,29065
2021-03-05,MO,Dent,13,2694,29065
2021-03-06,MO,Dent,17,2711,29065
2021-03-07,MO,Dent,7,2718,29065
2021-03-08,MO,Dent,29,2747,29065
2021-03-09,MO,Dent,37,2784,29065
2021-03-10,MO,Dent,176,2960,29065
2021-03-11,MO,Dent,328,3288,29065
2021-03-12,MO,Dent,197,3485,29065
2021-03-13,MO,Dent,28,3513,29065
2021-03-14,MO,Dent,5,3518,29065
2021-03-15,MO,Dent,18,3536,29065
2021-03-16,MO,Dent,28,3564,29065
2021-03-17,MO,Dent,110,3674,29065
2021-03-18,MO,Dent,31,3705,29065
2021-03-19,MO,Dent,82,3787,29065
2021-03-20,MO,Dent,5,3792,29065
2021-03-21,MO,Dent,16,3808,29065
2021-03-22,MO,Dent,22,3830,29065
2021-03-23,MO,Dent,39,3869,29065
2021-03-24,MO,Dent,49,3918,29065
2021-03-25,MO,Dent,96,4014,29065
2021-03-26,MO,Dent,25,4039,29065
2021-03-27,MO,Dent,12,4051,29065
2021-03-28,MO,Dent,22,4073,29065
2021-03-29,MO,Dent,11,4084,29065
2021-03-30,MO,Dent,44,4128,29065
2021-03-31,MO,Dent,84,4212,29065
2021-04-01,MO,Dent,58,4270,29065
2021-04-02,MO,Dent,25,4295,29065
2021-04-03,MO,Dent,18,4313,29065
2021-04-04,MO,Dent,6,4319,29065
2021-04-05,MO,Dent,19,4338,29065
2021-04-06,MO,Dent,46,4384,29065
2021-04-07,MO,Dent,63,4447,29065
2021-04-08,MO,Dent,58,4505,29065
2021-04-09,MO,Dent,35,4540,29065
2021-04-10,MO,Dent,16,4556,29065
2021-04-11,MO,Dent,19,4575,29065
2021-04-12,MO,Dent,26,4601,29065
2021-04-13,MO,Dent,32,4633,29065
2021-04-14,MO,Dent,133,4766,29065
2021-04-15,MO,Dent,9,4775,29065
2021-04-16,MO,Dent,100,4875,29065
2021-04-17,MO,Dent,8,4883,29065
2021-04-18,MO,Dent,19,4902,29065
2021-04-19,MO,Dent,22,4924,29065
2021-04-20,MO,Dent,33,4957,29065
2021-04-21,MO,Dent,54,5011,29065
2021-04-22,MO,Dent,25,5036,29065
2021-04-23,MO,Dent,5,5041,29065
2021-04-24,MO,Dent,6,5047,29065
2021-04-25,MO,Dent,27,5074,29065
2020-12-17,MO,Douglas,4,4,29067
2020-12-18,MO,Douglas,1,5,29067
2020-12-21,MO,Douglas,4,9,29067
2020-12-22,MO,Douglas,6,15,29067
2020-12-23,MO,Douglas,8,23,29067
2020-12-24,MO,Douglas,2,25,29067
2020-12-26,MO,Douglas,2,27,29067
2020-12-28,MO,Douglas,3,30,29067
2020-12-29,MO,Douglas,6,36,29067
2020-12-30,MO,Douglas,39,75,29067
2020-12-31,MO,Douglas,4,79,29067
2021-01-02,MO,Douglas,1,80,29067
2021-01-03,MO,Douglas,1,81,29067
2021-01-04,MO,Douglas,13,94,29067
2021-01-05,MO,Douglas,2,96,29067
2021-01-06,MO,Douglas,3,99,29067
2021-01-07,MO,Douglas,18,117,29067
2021-01-08,MO,Douglas,5,122,29067
2021-01-11,MO,Douglas,5,127,29067
2021-01-12,MO,Douglas,3,130,29067
2021-01-13,MO,Douglas,2,132,29067
2021-01-14,MO,Douglas,4,136,29067
2021-01-15,MO,Douglas,10,146,29067
2021-01-16,MO,Douglas,3,149,29067
2021-01-18,MO,Douglas,5,154,29067
2021-01-19,MO,Douglas,11,165,29067
2021-01-20,MO,Douglas,5,170,29067
2021-01-21,MO,Douglas,13,183,29067
2021-01-22,MO,Douglas,27,210,29067
2021-01-23,MO,Douglas,13,223,29067
2021-01-24,MO,Douglas,3,226,29067
2021-01-25,MO,Douglas,10,236,29067
2021-01-26,MO,Douglas,7,243,29067
2021-01-27,MO,Douglas,36,279,29067
2021-01-28,MO,Douglas,15,294,29067
2021-01-29,MO,Douglas,73,367,29067
2021-01-30,MO,Douglas,2,369,29067
2021-02-01,MO,Douglas,48,417,29067
2021-02-02,MO,Douglas,9,426,29067
2021-02-03,MO,Douglas,9,435,29067
2021-02-04,MO,Douglas,28,463,29067
2021-02-05,MO,Douglas,38,501,29067
2021-02-06,MO,Douglas,291,792,29067
2021-02-08,MO,Douglas,11,803,29067
2021-02-09,MO,Douglas,7,810,29067
2021-02-10,MO,Douglas,23,833,29067
2021-02-11,MO,Douglas,39,872,29067
2021-02-12,MO,Douglas,88,960,29067
2021-02-13,MO,Douglas,15,975,29067
2021-02-14,MO,Douglas,6,981,29067
2021-02-15,MO,Douglas,3,984,29067
2021-02-16,MO,Douglas,20,1004,29067
2021-02-17,MO,Douglas,1,1005,29067
2021-02-18,MO,Douglas,36,1041,29067
2021-02-19,MO,Douglas,32,1073,29067
2021-02-20,MO,Douglas,6,1079,29067
2021-02-21,MO,Douglas,1,1080,29067
2021-02-22,MO,Douglas,5,1085,29067
2021-02-23,MO,Douglas,54,1139,29067
2021-02-24,MO,Douglas,18,1157,29067
2021-02-25,MO,Douglas,31,1188,29067
2021-02-26,MO,Douglas,76,1264,29067
2021-02-27,MO,Douglas,307,1571,29067
2021-02-28,MO,Douglas,4,1575,29067
2021-03-01,MO,Douglas,52,1627,29067
2021-03-02,MO,Douglas,46,1673,29067
2021-03-03,MO,Douglas,48,1721,29067
2021-03-04,MO,Douglas,28,1749,29067
2021-03-05,MO,Douglas,32,1781,29067
2021-03-06,MO,Douglas,13,1794,29067
2021-03-07,MO,Douglas,1,1795,29067
2021-03-08,MO,Douglas,59,1854,29067
2021-03-09,MO,Douglas,33,1887,29067
2021-03-10,MO,Douglas,22,1909,29067
2021-03-11,MO,Douglas,33,1942,29067
2021-03-12,MO,Douglas,81,2023,29067
2021-03-13,MO,Douglas,14,2037,29067
2021-03-14,MO,Douglas,1,2038,29067
2021-03-15,MO,Douglas,76,2114,29067
2021-03-16,MO,Douglas,57,2171,29067
2021-03-17,MO,Douglas,27,2198,29067
2021-03-18,MO,Douglas,29,2227,29067
2021-03-19,MO,Douglas,63,2290,29067
2021-03-20,MO,Douglas,7,2297,29067
2021-03-22,MO,Douglas,42,2339,29067
2021-03-23,MO,Douglas,70,2409,29067
2021-03-24,MO,Douglas,34,2443,29067
2021-03-25,MO,Douglas,23,2466,29067
2021-03-26,MO,Douglas,55,2521,29067
2021-03-27,MO,Douglas,30,2551,29067
2021-03-28,MO,Douglas,2,2553,29067
2021-03-29,MO,Douglas,24,2577,29067
2021-03-30,MO,Douglas,61,2638,29067
2021-03-31,MO,Douglas,18,2656,29067
2021-04-01,MO,Douglas,26,2682,29067
2021-04-02,MO,Douglas,52,2734,29067
2021-04-03,MO,Douglas,9,2743,29067
2021-04-05,MO,Douglas,26,2769,29067
2021-04-06,MO,Douglas,81,2850,29067
2021-04-07,MO,Douglas,34,2884,29067
2021-04-08,MO,Douglas,39,2923,29067
2021-04-09,MO,Douglas,61,2984,29067
2021-04-10,MO,Douglas,7,2991,29067
2021-04-11,MO,Douglas,3,2994,29067
2021-04-12,MO,Douglas,63,3057,29067
2021-04-13,MO,Douglas,108,3165,29067
2021-04-14,MO,Douglas,23,3188,29067
2021-04-15,MO,Douglas,15,3203,29067
2021-04-16,MO,Douglas,36,3239,29067
2021-04-17,MO,Douglas,8,3247,29067
2021-04-18,MO,Douglas,2,3249,29067
2021-04-19,MO,Douglas,16,3265,29067
2021-04-20,MO,Douglas,36,3301,29067
2021-04-21,MO,Douglas,19,3320,29067
2021-04-22,MO,Douglas,21,3341,29067
2021-04-23,MO,Douglas,29,3370,29067
2021-04-24,MO,Douglas,10,3380,29067
2021-04-25,MO,Douglas,1,3381,29067
2020-12-17,MO,Dunklin,1,1,29069
2020-12-18,MO,Dunklin,2,3,29069
2020-12-19,MO,Dunklin,11,14,29069
2020-12-21,MO,Dunklin,48,62,29069
2020-12-22,MO,Dunklin,4,66,29069
2020-12-23,MO,Dunklin,8,74,29069
2020-12-28,MO,Dunklin,5,79,29069
2020-12-29,MO,Dunklin,60,139,29069
2020-12-30,MO,Dunklin,23,162,29069
2020-12-31,MO,Dunklin,7,169,29069
2021-01-02,MO,Dunklin,34,203,29069
2021-01-03,MO,Dunklin,30,233,29069
2021-01-04,MO,Dunklin,6,239,29069
2021-01-05,MO,Dunklin,23,262,29069
2021-01-06,MO,Dunklin,36,298,29069
2021-01-07,MO,Dunklin,15,313,29069
2021-01-08,MO,Dunklin,17,330,29069
2021-01-09,MO,Dunklin,2,332,29069
2021-01-11,MO,Dunklin,29,361,29069
2021-01-12,MO,Dunklin,108,469,29069
2021-01-13,MO,Dunklin,15,484,29069
2021-01-14,MO,Dunklin,25,509,29069
2021-01-15,MO,Dunklin,25,534,29069
2021-01-16,MO,Dunklin,30,564,29069
2021-01-18,MO,Dunklin,59,623,29069
2021-01-19,MO,Dunklin,57,680,29069
2021-01-20,MO,Dunklin,248,928,29069
2021-01-21,MO,Dunklin,48,976,29069
2021-01-22,MO,Dunklin,149,1125,29069
2021-01-23,MO,Dunklin,11,1136,29069
2021-01-24,MO,Dunklin,3,1139,29069
2021-01-25,MO,Dunklin,69,1208,29069
2021-01-26,MO,Dunklin,100,1308,29069
2021-01-27,MO,Dunklin,132,1440,29069
2021-01-28,MO,Dunklin,96,1536,29069
2021-01-29,MO,Dunklin,108,1644,29069
2021-01-30,MO,Dunklin,71,1715,29069
2021-02-01,MO,Dunklin,218,1933,29069
2021-02-02,MO,Dunklin,58,1991,29069
2021-02-03,MO,Dunklin,91,2082,29069
2021-02-04,MO,Dunklin,466,2548,29069
2021-02-05,MO,Dunklin,165,2713,29069
2021-02-06,MO,Dunklin,2,2715,29069
2021-02-08,MO,Dunklin,85,2800,29069
2021-02-09,MO,Dunklin,218,3018,29069
2021-02-10,MO,Dunklin,86,3104,29069
2021-02-11,MO,Dunklin,21,3125,29069
2021-02-12,MO,Dunklin,190,3315,29069
2021-02-13,MO,Dunklin,32,3347,29069
2021-02-14,MO,Dunklin,14,3361,29069
2021-02-15,MO,Dunklin,32,3393,29069
2021-02-16,MO,Dunklin,51,3444,29069
2021-02-17,MO,Dunklin,30,3474,29069
2021-02-18,MO,Dunklin,30,3504,29069
2021-02-19,MO,Dunklin,63,3567,29069
2021-02-20,MO,Dunklin,13,3580,29069
2021-02-21,MO,Dunklin,6,3586,29069
2021-02-22,MO,Dunklin,98,3684,29069
2021-02-23,MO,Dunklin,455,4139,29069
2021-02-24,MO,Dunklin,158,4297,29069
2021-02-25,MO,Dunklin,251,4548,29069
2021-02-26,MO,Dunklin,165,4713,29069
2021-02-27,MO,Dunklin,49,4762,29069
2021-03-01,MO,Dunklin,210,4972,29069
2021-03-02,MO,Dunklin,152,5124,29069
2021-03-03,MO,Dunklin,156,5280,29069
2021-03-04,MO,Dunklin,552,5832,29069
2021-03-05,MO,Dunklin,175,6007,29069
2021-03-06,MO,Dunklin,30,6037,29069
2021-03-07,MO,Dunklin,13,6050,29069
2021-03-08,MO,Dunklin,85,6135,29069
2021-03-09,MO,Dunklin,108,6243,29069
2021-03-10,MO,Dunklin,60,6303,29069
2021-03-11,MO,Dunklin,62,6365,29069
2021-03-12,MO,Dunklin,62,6427,29069
2021-03-13,MO,Dunklin,28,6455,29069
2021-03-14,MO,Dunklin,17,6472,29069
2021-03-15,MO,Dunklin,68,6540,29069
2021-03-16,MO,Dunklin,100,6640,29069
2021-03-17,MO,Dunklin,49,6689,29069
2021-03-18,MO,Dunklin,54,6743,29069
2021-03-19,MO,Dunklin,144,6887,29069
2021-03-20,MO,Dunklin,20,6907,29069
2021-03-21,MO,Dunklin,7,6914,29069
2021-03-22,MO,Dunklin,50,6964,29069
2021-03-23,MO,Dunklin,96,7060,29069
2021-03-24,MO,Dunklin,41,7101,29069
2021-03-25,MO,Dunklin,50,7151,29069
2021-03-26,MO,Dunklin,46,7197,29069
2021-03-27,MO,Dunklin,15,7212,29069
2021-03-28,MO,Dunklin,2,7214,29069
2021-03-29,MO,Dunklin,11,7225,29069
2021-03-30,MO,Dunklin,141,7366,29069
2021-03-31,MO,Dunklin,76,7442,29069
2021-04-01,MO,Dunklin,180,7622,29069
2021-04-02,MO,Dunklin,136,7758,29069
2021-04-03,MO,Dunklin,31,7789,29069
2021-04-04,MO,Dunklin,12,7801,29069
2021-04-05,MO,Dunklin,46,7847,29069
2021-04-06,MO,Dunklin,204,8051,29069
2021-04-07,MO,Dunklin,54,8105,29069
2021-04-08,MO,Dunklin,50,8155,29069
2021-04-09,MO,Dunklin,59,8214,29069
2021-04-10,MO,Dunklin,20,8234,29069
2021-04-11,MO,Dunklin,13,8247,29069
2021-04-12,MO,Dunklin,71,8318,29069
2021-04-13,MO,Dunklin,54,8372,29069
2021-04-14,MO,Dunklin,34,8406,29069
2021-04-15,MO,Dunklin,48,8454,29069
2021-04-16,MO,Dunklin,65,8519,29069
2021-04-17,MO,Dunklin,10,8529,29069
2021-04-18,MO,Dunklin,3,8532,29069
2021-04-19,MO,Dunklin,39,8571,29069
2021-04-20,MO,Dunklin,37,8608,29069
2021-04-21,MO,Dunklin,44,8652,29069
2021-04-22,MO,Dunklin,30,8682,29069
2021-04-23,MO,Dunklin,39,8721,29069
2021-04-24,MO,Dunklin,19,8740,29069
2021-04-25,MO,Dunklin,4,8744,29069
2020-12-14,MO,Franklin,2,2,29071
2020-12-15,MO,Franklin,52,54,29071
2020-12-16,MO,Franklin,93,147,29071
2020-12-17,MO,Franklin,141,288,29071
2020-12-18,MO,Franklin,150,438,29071
2020-12-19,MO,Franklin,29,467,29071
2020-12-20,MO,Franklin,8,475,29071
2020-12-21,MO,Franklin,146,621,29071
2020-12-22,MO,Franklin,140,761,29071
2020-12-23,MO,Franklin,142,903,29071
2020-12-24,MO,Franklin,28,931,29071
2020-12-26,MO,Franklin,18,949,29071
2020-12-27,MO,Franklin,12,961,29071
2020-12-28,MO,Franklin,114,1075,29071
2020-12-29,MO,Franklin,159,1234,29071
2020-12-30,MO,Franklin,176,1410,29071
2020-12-31,MO,Franklin,152,1562,29071
2021-01-01,MO,Franklin,3,1565,29071
2021-01-02,MO,Franklin,51,1616,29071
2021-01-03,MO,Franklin,6,1622,29071
2021-01-04,MO,Franklin,110,1732,29071
2021-01-05,MO,Franklin,143,1875,29071
2021-01-06,MO,Franklin,291,2166,29071
2021-01-07,MO,Franklin,201,2367,29071
2021-01-08,MO,Franklin,248,2615,29071
2021-01-09,MO,Franklin,75,2690,29071
2021-01-10,MO,Franklin,11,2701,29071
2021-01-11,MO,Franklin,295,2996,29071
2021-01-12,MO,Franklin,234,3230,29071
2021-01-13,MO,Franklin,201,3431,29071
2021-01-14,MO,Franklin,154,3585,29071
2021-01-15,MO,Franklin,320,3905,29071
2021-01-16,MO,Franklin,46,3951,29071
2021-01-17,MO,Franklin,20,3971,29071
2021-01-18,MO,Franklin,284,4255,29071
2021-01-19,MO,Franklin,301,4556,29071
2021-01-20,MO,Franklin,395,4951,29071
2021-01-21,MO,Franklin,317,5268,29071
2021-01-22,MO,Franklin,288,5556,29071
2021-01-23,MO,Franklin,183,5739,29071
2021-01-24,MO,Franklin,83,5822,29071
2021-01-25,MO,Franklin,270,6092,29071
2021-01-26,MO,Franklin,294,6386,29071
2021-01-27,MO,Franklin,210,6596,29071
2021-01-28,MO,Franklin,362,6958,29071
2021-01-29,MO,Franklin,367,7325,29071
2021-01-30,MO,Franklin,1174,8499,29071
2021-01-31,MO,Franklin,98,8597,29071
2021-02-01,MO,Franklin,313,8910,29071
2021-02-02,MO,Franklin,422,9332,29071
2021-02-03,MO,Franklin,358,9690,29071
2021-02-04,MO,Franklin,334,10024,29071
2021-02-05,MO,Franklin,262,10286,29071
2021-02-06,MO,Franklin,116,10402,29071
2021-02-07,MO,Franklin,7,10409,29071
2021-02-08,MO,Franklin,406,10815,29071
2021-02-09,MO,Franklin,477,11292,29071
2021-02-10,MO,Franklin,401,11693,29071
2021-02-11,MO,Franklin,505,12198,29071
2021-02-12,MO,Franklin,540,12738,29071
2021-02-13,MO,Franklin,204,12942,29071
2021-02-14,MO,Franklin,99,13041,29071
2021-02-15,MO,Franklin,196,13237,29071
2021-02-16,MO,Franklin,272,13509,29071
2021-02-17,MO,Franklin,341,13850,29071
2021-02-18,MO,Franklin,357,14207,29071
2021-02-19,MO,Franklin,398,14605,29071
2021-02-20,MO,Franklin,276,14881,29071
2021-02-21,MO,Franklin,10,14891,29071
2021-02-22,MO,Franklin,327,15218,29071
2021-02-23,MO,Franklin,499,15717,29071
2021-02-24,MO,Franklin,531,16248,29071
2021-02-25,MO,Franklin,779,17027,29071
2021-02-26,MO,Franklin,872,17899,29071
2021-02-27,MO,Franklin,1265,19164,29071
2021-02-28,MO,Franklin,45,19209,29071
2021-03-01,MO,Franklin,702,19911,29071
2021-03-02,MO,Franklin,763,20674,29071
2021-03-03,MO,Franklin,882,21556,29071
2021-03-04,MO,Franklin,645,22201,29071
2021-03-05,MO,Franklin,832,23033,29071
2021-03-06,MO,Franklin,303,23336,29071
2021-03-07,MO,Franklin,148,23484,29071
2021-03-08,MO,Franklin,637,24121,29071
2021-03-09,MO,Franklin,696,24817,29071
2021-03-10,MO,Franklin,782,25599,29071
2021-03-11,MO,Franklin,1151,26750,29071
2021-03-12,MO,Franklin,739,27489,29071
2021-03-13,MO,Franklin,199,27688,29071
2021-03-14,MO,Franklin,39,27727,29071
2021-03-15,MO,Franklin,641,28368,29071
2021-03-16,MO,Franklin,1072,29440,29071
2021-03-17,MO,Franklin,860,30300,29071
2021-03-18,MO,Franklin,1013,31313,29071
2021-03-19,MO,Franklin,1072,32385,29071
2021-03-20,MO,Franklin,210,32595,29071
2021-03-21,MO,Franklin,116,32711,29071
2021-03-22,MO,Franklin,673,33384,29071
2021-03-23,MO,Franklin,1259,34643,29071
2021-03-24,MO,Franklin,1057,35700,29071
2021-03-25,MO,Franklin,967,36667,29071
2021-03-26,MO,Franklin,1362,38029,29071
2021-03-27,MO,Franklin,425,38454,29071
2021-03-28,MO,Franklin,95,38549,29071
2021-03-29,MO,Franklin,755,39304,29071
2021-03-30,MO,Franklin,1839,41143,29071
2021-03-31,MO,Franklin,1480,42623,29071
2021-04-01,MO,Franklin,1392,44015,29071
2021-04-02,MO,Franklin,760,44775,29071
2021-04-03,MO,Franklin,199,44974,29071
2021-04-04,MO,Franklin,42,45016,29071
2021-04-05,MO,Franklin,901,45917,29071
2021-04-06,MO,Franklin,1088,47005,29071
2021-04-07,MO,Franklin,1239,48244,29071
2021-04-08,MO,Franklin,1264,49508,29071
2021-04-09,MO,Franklin,1147,50655,29071
2021-04-10,MO,Franklin,507,51162,29071
2021-04-11,MO,Franklin,173,51335,29071
2021-04-12,MO,Franklin,886,52221,29071
2021-04-13,MO,Franklin,1061,53282,29071
2021-04-14,MO,Franklin,1147,54429,29071
2021-04-15,MO,Franklin,814,55243,29071
2021-04-16,MO,Franklin,1147,56390,29071
2021-04-17,MO,Franklin,244,56634,29071
2021-04-18,MO,Franklin,100,56734,29071
2021-04-19,MO,Franklin,626,57360,29071
2021-04-20,MO,Franklin,916,58276,29071
2021-04-21,MO,Franklin,827,59103,29071
2021-04-22,MO,Franklin,597,59700,29071
2021-04-23,MO,Franklin,585,60285,29071
2021-04-24,MO,Franklin,158,60443,29071
2021-04-25,MO,Franklin,30,60473,29071
2020-12-15,MO,Gasconade,1,1,29073
2020-12-16,MO,Gasconade,4,5,29073
2020-12-17,MO,Gasconade,5,10,29073
2020-12-18,MO,Gasconade,18,28,29073
2020-12-19,MO,Gasconade,2,30,29073
2020-12-20,MO,Gasconade,1,31,29073
2020-12-21,MO,Gasconade,13,44,29073
2020-12-22,MO,Gasconade,19,63,29073
2020-12-23,MO,Gasconade,19,82,29073
2020-12-24,MO,Gasconade,6,88,29073
2020-12-26,MO,Gasconade,1,89,29073
2020-12-28,MO,Gasconade,17,106,29073
2020-12-29,MO,Gasconade,11,117,29073
2020-12-30,MO,Gasconade,15,132,29073
2020-12-31,MO,Gasconade,11,143,29073
2021-01-01,MO,Gasconade,1,144,29073
2021-01-02,MO,Gasconade,2,146,29073
2021-01-03,MO,Gasconade,3,149,29073
2021-01-04,MO,Gasconade,12,161,29073
2021-01-05,MO,Gasconade,88,249,29073
2021-01-06,MO,Gasconade,21,270,29073
2021-01-07,MO,Gasconade,51,321,29073
2021-01-08,MO,Gasconade,25,346,29073
2021-01-09,MO,Gasconade,3,349,29073
2021-01-10,MO,Gasconade,3,352,29073
2021-01-11,MO,Gasconade,17,369,29073
2021-01-12,MO,Gasconade,92,461,29073
2021-01-13,MO,Gasconade,33,494,29073
2021-01-14,MO,Gasconade,20,514,29073
2021-01-15,MO,Gasconade,52,566,29073
2021-01-16,MO,Gasconade,10,576,29073
2021-01-18,MO,Gasconade,35,611,29073
2021-01-19,MO,Gasconade,30,641,29073
2021-01-20,MO,Gasconade,29,670,29073
2021-01-21,MO,Gasconade,26,696,29073
2021-01-22,MO,Gasconade,38,734,29073
2021-01-23,MO,Gasconade,24,758,29073
2021-01-24,MO,Gasconade,6,764,29073
2021-01-25,MO,Gasconade,57,821,29073
2021-01-26,MO,Gasconade,174,995,29073
2021-01-27,MO,Gasconade,13,1008,29073
2021-01-28,MO,Gasconade,158,1166,29073
2021-01-29,MO,Gasconade,59,1225,29073
2021-01-30,MO,Gasconade,440,1665,29073
2021-01-31,MO,Gasconade,258,1923,29073
2021-02-01,MO,Gasconade,23,1946,29073
2021-02-02,MO,Gasconade,100,2046,29073
2021-02-03,MO,Gasconade,35,2081,29073
2021-02-04,MO,Gasconade,149,2230,29073
2021-02-05,MO,Gasconade,62,2292,29073
2021-02-06,MO,Gasconade,9,2301,29073
2021-02-07,MO,Gasconade,1,2302,29073
2021-02-08,MO,Gasconade,76,2378,29073
2021-02-09,MO,Gasconade,93,2471,29073
2021-02-10,MO,Gasconade,316,2787,29073
2021-02-11,MO,Gasconade,121,2908,29073
2021-02-12,MO,Gasconade,167,3075,29073
2021-02-13,MO,Gasconade,31,3106,29073
2021-02-14,MO,Gasconade,4,3110,29073
2021-02-15,MO,Gasconade,9,3119,29073
2021-02-16,MO,Gasconade,12,3131,29073
2021-02-17,MO,Gasconade,8,3139,29073
2021-02-18,MO,Gasconade,28,3167,29073
2021-02-19,MO,Gasconade,79,3246,29073
2021-02-20,MO,Gasconade,680,3926,29073
2021-02-21,MO,Gasconade,2,3928,29073
2021-02-22,MO,Gasconade,181,4109,29073
2021-02-23,MO,Gasconade,176,4285,29073
2021-02-24,MO,Gasconade,93,4378,29073
2021-02-25,MO,Gasconade,18,4396,29073
2021-02-26,MO,Gasconade,38,4434,29073
2021-02-27,MO,Gasconade,16,4450,29073
2021-02-28,MO,Gasconade,5,4455,29073
2021-03-01,MO,Gasconade,41,4496,29073
2021-03-02,MO,Gasconade,123,4619,29073
2021-03-03,MO,Gasconade,110,4729,29073
2021-03-04,MO,Gasconade,142,4871,29073
2021-03-05,MO,Gasconade,69,4940,29073
2021-03-06,MO,Gasconade,46,4986,29073
2021-03-07,MO,Gasconade,2,4988,29073
2021-03-08,MO,Gasconade,27,5015,29073
2021-03-09,MO,Gasconade,70,5085,29073
2021-03-10,MO,Gasconade,417,5502,29073
2021-03-11,MO,Gasconade,128,5630,29073
2021-03-12,MO,Gasconade,148,5778,29073
2021-03-13,MO,Gasconade,29,5807,29073
2021-03-14,MO,Gasconade,2,5809,29073
2021-03-15,MO,Gasconade,131,5940,29073
2021-03-16,MO,Gasconade,29,5969,29073
2021-03-17,MO,Gasconade,120,6089,29073
2021-03-18,MO,Gasconade,76,6165,29073
2021-03-19,MO,Gasconade,147,6312,29073
2021-03-20,MO,Gasconade,7,6319,29073
2021-03-21,MO,Gasconade,4,6323,29073
2021-03-22,MO,Gasconade,56,6379,29073
2021-03-23,MO,Gasconade,51,6430,29073
2021-03-24,MO,Gasconade,141,6571,29073
2021-03-25,MO,Gasconade,55,6626,29073
2021-03-26,MO,Gasconade,118,6744,29073
2021-03-27,MO,Gasconade,58,6802,29073
2021-03-28,MO,Gasconade,2,6804,29073
2021-03-29,MO,Gasconade,42,6846,29073
2021-03-30,MO,Gasconade,57,6903,29073
2021-03-31,MO,Gasconade,114,7017,29073
2021-04-01,MO,Gasconade,88,7105,29073
2021-04-02,MO,Gasconade,87,7192,29073
2021-04-03,MO,Gasconade,8,7200,29073
2021-04-05,MO,Gasconade,151,7351,29073
2021-04-06,MO,Gasconade,93,7444,29073
2021-04-07,MO,Gasconade,285,7729,29073
2021-04-08,MO,Gasconade,64,7793,29073
2021-04-09,MO,Gasconade,143,7936,29073
2021-04-10,MO,Gasconade,304,8240,29073
2021-04-11,MO,Gasconade,5,8245,29073
2021-04-12,MO,Gasconade,71,8316,29073
2021-04-13,MO,Gasconade,45,8361,29073
2021-04-14,MO,Gasconade,90,8451,29073
2021-04-15,MO,Gasconade,64,8515,29073
2021-04-16,MO,Gasconade,164,8679,29073
2021-04-17,MO,Gasconade,10,8689,29073
2021-04-18,MO,Gasconade,6,8695,29073
2021-04-19,MO,Gasconade,45,8740,29073
2021-04-20,MO,Gasconade,45,8785,29073
2021-04-21,MO,Gasconade,46,8831,29073
2021-04-22,MO,Gasconade,43,8874,29073
2021-04-23,MO,Gasconade,49,8923,29073
2021-04-24,MO,Gasconade,7,8930,29073
2021-04-25,MO,Gasconade,1,8931,29073
2020-12-21,MO,Gentry,2,2,29075
2020-12-22,MO,Gentry,2,4,29075
2020-12-23,MO,Gentry,10,14,29075
2020-12-27,MO,Gentry,6,20,29075
2020-12-28,MO,Gentry,14,34,29075
2020-12-29,MO,Gentry,9,43,29075
2020-12-30,MO,Gentry,10,53,29075
2020-12-31,MO,Gentry,3,56,29075
2021-01-02,MO,Gentry,2,58,29075
2021-01-03,MO,Gentry,31,89,29075
2021-01-04,MO,Gentry,53,142,29075
2021-01-05,MO,Gentry,22,164,29075
2021-01-06,MO,Gentry,5,169,29075
2021-01-07,MO,Gentry,3,172,29075
2021-01-08,MO,Gentry,3,175,29075
2021-01-11,MO,Gentry,5,180,29075
2021-01-12,MO,Gentry,13,193,29075
2021-01-13,MO,Gentry,16,209,29075
2021-01-14,MO,Gentry,32,241,29075
2021-01-15,MO,Gentry,11,252,29075
2021-01-16,MO,Gentry,1,253,29075
2021-01-17,MO,Gentry,1,254,29075
2021-01-18,MO,Gentry,2,256,29075
2021-01-19,MO,Gentry,2,258,29075
2021-01-20,MO,Gentry,65,323,29075
2021-01-21,MO,Gentry,35,358,29075
2021-01-22,MO,Gentry,41,399,29075
2021-01-23,MO,Gentry,1,400,29075
2021-01-25,MO,Gentry,3,403,29075
2021-01-26,MO,Gentry,20,423,29075
2021-01-27,MO,Gentry,84,507,29075
2021-01-28,MO,Gentry,65,572,29075
2021-01-29,MO,Gentry,13,585,29075
2021-01-30,MO,Gentry,3,588,29075
2021-01-31,MO,Gentry,4,592,29075
2021-02-01,MO,Gentry,267,859,29075
2021-02-02,MO,Gentry,31,890,29075
2021-02-03,MO,Gentry,97,987,29075
2021-02-04,MO,Gentry,77,1064,29075
2021-02-05,MO,Gentry,74,1138,29075
2021-02-06,MO,Gentry,1,1139,29075
2021-02-08,MO,Gentry,4,1143,29075
2021-02-09,MO,Gentry,32,1175,29075
2021-02-10,MO,Gentry,34,1209,29075
2021-02-11,MO,Gentry,67,1276,29075
2021-02-12,MO,Gentry,45,1321,29075
2021-02-13,MO,Gentry,7,1328,29075
2021-02-14,MO,Gentry,2,1330,29075
2021-02-15,MO,Gentry,5,1335,29075
2021-02-16,MO,Gentry,4,1339,29075
2021-02-17,MO,Gentry,54,1393,29075
2021-02-18,MO,Gentry,90,1483,29075
2021-02-19,MO,Gentry,26,1509,29075
2021-02-20,MO,Gentry,2,1511,29075
2021-02-22,MO,Gentry,260,1771,29075
2021-02-23,MO,Gentry,34,1805,29075
2021-02-24,MO,Gentry,28,1833,29075
2021-02-25,MO,Gentry,48,1881,29075
2021-02-26,MO,Gentry,146,2027,29075
2021-02-27,MO,Gentry,51,2078,29075
2021-03-01,MO,Gentry,3,2081,29075
2021-03-02,MO,Gentry,41,2122,29075
2021-03-03,MO,Gentry,54,2176,29075
2021-03-04,MO,Gentry,69,2245,29075
2021-03-05,MO,Gentry,60,2305,29075
2021-03-06,MO,Gentry,20,2325,29075
2021-03-07,MO,Gentry,3,2328,29075
2021-03-08,MO,Gentry,25,2353,29075
2021-03-09,MO,Gentry,14,2367,29075
2021-03-10,MO,Gentry,70,2437,29075
2021-03-11,MO,Gentry,18,2455,29075
2021-03-12,MO,Gentry,15,2470,29075
2021-03-13,MO,Gentry,6,2476,29075
2021-03-15,MO,Gentry,30,2506,29075
2021-03-16,MO,Gentry,42,2548,29075
2021-03-17,MO,Gentry,68,2616,29075
2021-03-18,MO,Gentry,42,2658,29075
2021-03-19,MO,Gentry,97,2755,29075
2021-03-20,MO,Gentry,6,2761,29075
2021-03-21,MO,Gentry,2,2763,29075
2021-03-22,MO,Gentry,13,2776,29075
2021-03-23,MO,Gentry,16,2792,29075
2021-03-24,MO,Gentry,24,2816,29075
2021-03-25,MO,Gentry,45,2861,29075
2021-03-26,MO,Gentry,41,2902,29075
2021-03-27,MO,Gentry,6,2908,29075
2021-03-28,MO,Gentry,2,2910,29075
2021-03-29,MO,Gentry,21,2931,29075
2021-03-30,MO,Gentry,30,2961,29075
2021-03-31,MO,Gentry,24,2985,29075
2021-04-01,MO,Gentry,34,3019,29075
2021-04-02,MO,Gentry,21,3040,29075
2021-04-03,MO,Gentry,7,3047,29075
2021-04-04,MO,Gentry,1,3048,29075
2021-04-05,MO,Gentry,14,3062,29075
2021-04-06,MO,Gentry,30,3092,29075
2021-04-07,MO,Gentry,40,3132,29075
2021-04-08,MO,Gentry,16,3148,29075
2021-04-09,MO,Gentry,86,3234,29075
2021-04-10,MO,Gentry,4,3238,29075
2021-04-11,MO,Gentry,3,3241,29075
2021-04-12,MO,Gentry,50,3291,29075
2021-04-13,MO,Gentry,15,3306,29075
2021-04-14,MO,Gentry,34,3340,29075
2021-04-15,MO,Gentry,19,3359,29075
2021-04-16,MO,Gentry,28,3387,29075
2021-04-17,MO,Gentry,3,3390,29075
2021-04-18,MO,Gentry,3,3393,29075
2021-04-19,MO,Gentry,8,3401,29075
2021-04-20,MO,Gentry,20,3421,29075
2021-04-21,MO,Gentry,9,3430,29075
2021-04-22,MO,Gentry,42,3472,29075
2021-04-23,MO,Gentry,7,3479,29075
2020-12-14,MO,Greene,12,12,29077
2020-12-15,MO,Greene,97,109,29077
2020-12-16,MO,Greene,353,462,29077
2020-12-17,MO,Greene,379,841,29077
2020-12-18,MO,Greene,297,1138,29077
2020-12-19,MO,Greene,95,1233,29077
2020-12-20,MO,Greene,52,1285,29077
2020-12-21,MO,Greene,429,1714,29077
2020-12-22,MO,Greene,829,2543,29077
2020-12-23,MO,Greene,856,3399,29077
2020-12-24,MO,Greene,538,3937,29077
2020-12-26,MO,Greene,305,4242,29077
2020-12-27,MO,Greene,119,4361,29077
2020-12-28,MO,Greene,487,4848,29077
2020-12-29,MO,Greene,648,5496,29077
2020-12-30,MO,Greene,696,6192,29077
2020-12-31,MO,Greene,702,6894,29077
2021-01-01,MO,Greene,1,6895,29077
2021-01-02,MO,Greene,141,7036,29077
2021-01-03,MO,Greene,78,7114,29077
2021-01-04,MO,Greene,320,7434,29077
2021-01-05,MO,Greene,378,7812,29077
2021-01-06,MO,Greene,311,8123,29077
2021-01-07,MO,Greene,240,8363,29077
2021-01-08,MO,Greene,788,9151,29077
2021-01-09,MO,Greene,139,9290,29077
2021-01-10,MO,Greene,128,9418,29077
2021-01-11,MO,Greene,374,9792,29077
2021-01-12,MO,Greene,604,10396,29077
2021-01-13,MO,Greene,688,11084,29077
2021-01-14,MO,Greene,526,11610,29077
2021-01-15,MO,Greene,505,12115,29077
2021-01-16,MO,Greene,426,12541,29077
2021-01-17,MO,Greene,187,12728,29077
2021-01-18,MO,Greene,535,13263,29077
2021-01-19,MO,Greene,702,13965,29077
2021-01-20,MO,Greene,996,14961,29077
2021-01-21,MO,Greene,1157,16118,29077
2021-01-22,MO,Greene,1285,17403,29077
2021-01-23,MO,Greene,573,17976,29077
2021-01-24,MO,Greene,344,18320,29077
2021-01-25,MO,Greene,1265,19585,29077
2021-01-26,MO,Greene,1401,20986,29077
2021-01-27,MO,Greene,1510,22496,29077
2021-01-28,MO,Greene,1656,24152,29077
2021-01-29,MO,Greene,576,24728,29077
2021-01-30,MO,Greene,285,25013,29077
2021-01-31,MO,Greene,10,25023,29077
2021-02-01,MO,Greene,756,25779,29077
2021-02-02,MO,Greene,359,26138,29077
2021-02-03,MO,Greene,928,27066,29077
2021-02-04,MO,Greene,835,27901,29077
2021-02-05,MO,Greene,2084,29985,29077
2021-02-06,MO,Greene,1779,31764,29077
2021-02-07,MO,Greene,66,31830,29077
2021-02-08,MO,Greene,1654,33484,29077
2021-02-09,MO,Greene,1151,34635,29077
2021-02-10,MO,Greene,933,35568,29077
2021-02-11,MO,Greene,1591,37159,29077
2021-02-12,MO,Greene,1719,38878,29077
2021-02-13,MO,Greene,1003,39881,29077
2021-02-14,MO,Greene,768,40649,29077
2021-02-15,MO,Greene,401,41050,29077
2021-02-16,MO,Greene,818,41868,29077
2021-02-17,MO,Greene,654,42522,29077
2021-02-18,MO,Greene,1531,44053,29077
2021-02-19,MO,Greene,792,44845,29077
2021-02-20,MO,Greene,69,44914,29077
2021-02-21,MO,Greene,127,45041,29077
2021-02-22,MO,Greene,531,45572,29077
2021-02-23,MO,Greene,868,46440,29077
2021-02-24,MO,Greene,1586,48026,29077
2021-02-25,MO,Greene,1633,49659,29077
2021-02-26,MO,Greene,2739,52398,29077
2021-02-27,MO,Greene,2571,54969,29077
2021-02-28,MO,Greene,258,55227,29077
2021-03-01,MO,Greene,2261,57488,29077
2021-03-02,MO,Greene,734,58222,29077
2021-03-03,MO,Greene,2682,60904,29077
2021-03-04,MO,Greene,3245,64149,29077
2021-03-05,MO,Greene,2436,66585,29077
2021-03-06,MO,Greene,2445,69030,29077
2021-03-07,MO,Greene,346,69376,29077
2021-03-08,MO,Greene,2621,71997,29077
2021-03-09,MO,Greene,2811,74808,29077
2021-03-10,MO,Greene,1423,76231,29077
2021-03-11,MO,Greene,1784,78015,29077
2021-03-12,MO,Greene,1715,79730,29077
2021-03-13,MO,Greene,926,80656,29077
2021-03-14,MO,Greene,424,81080,29077
2021-03-15,MO,Greene,1900,82980,29077
2021-03-16,MO,Greene,1752,84732,29077
2021-03-17,MO,Greene,1649,86381,29077
2021-03-18,MO,Greene,3126,89507,29077
2021-03-19,MO,Greene,3155,92662,29077
2021-03-20,MO,Greene,1156,93818,29077
2021-03-21,MO,Greene,662,94480,29077
2021-03-22,MO,Greene,2615,97095,29077
2021-03-23,MO,Greene,2069,99164,29077
2021-03-24,MO,Greene,2624,101788,29077
2021-03-25,MO,Greene,2107,103895,29077
2021-03-26,MO,Greene,3342,107237,29077
2021-03-27,MO,Greene,2103,109340,29077
2021-03-28,MO,Greene,431,109771,29077
2021-03-29,MO,Greene,2452,112223,29077
2021-03-30,MO,Greene,1817,114040,29077
2021-03-31,MO,Greene,3007,117047,29077
2021-04-01,MO,Greene,3347,120394,29077
2021-04-02,MO,Greene,2800,123194,29077
2021-04-03,MO,Greene,2098,125292,29077
2021-04-04,MO,Greene,376,125668,29077
2021-04-05,MO,Greene,2680,128348,29077
2021-04-06,MO,Greene,3310,131658,29077
2021-04-07,MO,Greene,2233,133891,29077
2021-04-08,MO,Greene,3642,137533,29077
2021-04-09,MO,Greene,4353,141886,29077
2021-04-10,MO,Greene,1225,143111,29077
2021-04-11,MO,Greene,547,143658,29077
2021-04-12,MO,Greene,2581,146239,29077
2021-04-13,MO,Greene,1864,148103,29077
2021-04-14,MO,Greene,2148,150251,29077
2021-04-15,MO,Greene,1469,151720,29077
2021-04-16,MO,Greene,1320,153040,29077
2021-04-17,MO,Greene,691,153731,29077
2021-04-18,MO,Greene,283,154014,29077
2021-04-19,MO,Greene,1336,155350,29077
2021-04-20,MO,Greene,1321,156671,29077
2021-04-21,MO,Greene,1212,157883,29077
2021-04-22,MO,Greene,1449,159332,29077
2021-04-23,MO,Greene,937,160269,29077
2021-04-24,MO,Greene,1749,162018,29077
2021-04-25,MO,Greene,220,162238,29077
2020-12-18,MO,Grundy,1,1,29079
2020-12-21,MO,Grundy,1,2,29079
2020-12-22,MO,Grundy,4,6,29079
2020-12-23,MO,Grundy,6,12,29079
2020-12-24,MO,Grundy,2,14,29079
2020-12-28,MO,Grundy,6,20,29079
2020-12-29,MO,Grundy,4,24,29079
2020-12-30,MO,Grundy,13,37,29079
2020-12-31,MO,Grundy,6,43,29079
2021-01-02,MO,Grundy,1,44,29079
2021-01-03,MO,Grundy,1,45,29079
2021-01-04,MO,Grundy,9,54,29079
2021-01-05,MO,Grundy,3,57,29079
2021-01-06,MO,Grundy,7,64,29079
2021-01-07,MO,Grundy,2,66,29079
2021-01-08,MO,Grundy,6,72,29079
2021-01-09,MO,Grundy,4,76,29079
2021-01-11,MO,Grundy,37,113,29079
2021-01-12,MO,Grundy,19,132,29079
2021-01-13,MO,Grundy,14,146,29079
2021-01-14,MO,Grundy,69,215,29079
2021-01-15,MO,Grundy,30,245,29079
2021-01-16,MO,Grundy,2,247,29079
2021-01-18,MO,Grundy,6,253,29079
2021-01-19,MO,Grundy,2,255,29079
2021-01-20,MO,Grundy,9,264,29079
2021-01-21,MO,Grundy,1,265,29079
2021-01-22,MO,Grundy,71,336,29079
2021-01-23,MO,Grundy,3,339,29079
2021-01-24,MO,Grundy,1,340,29079
2021-01-25,MO,Grundy,15,355,29079
2021-01-26,MO,Grundy,6,361,29079
2021-01-27,MO,Grundy,20,381,29079
2021-01-28,MO,Grundy,61,442,29079
2021-01-29,MO,Grundy,69,511,29079
2021-01-30,MO,Grundy,4,515,29079
2021-02-01,MO,Grundy,12,527,29079
2021-02-02,MO,Grundy,6,533,29079
2021-02-03,MO,Grundy,17,550,29079
2021-02-04,MO,Grundy,213,763,29079
2021-02-05,MO,Grundy,37,800,29079
2021-02-06,MO,Grundy,3,803,29079
2021-02-08,MO,Grundy,46,849,29079
2021-02-09,MO,Grundy,59,908,29079
2021-02-10,MO,Grundy,55,963,29079
2021-02-11,MO,Grundy,145,1108,29079
2021-02-12,MO,Grundy,57,1165,29079
2021-02-13,MO,Grundy,30,1195,29079
2021-02-15,MO,Grundy,3,1198,29079
2021-02-16,MO,Grundy,8,1206,29079
2021-02-17,MO,Grundy,17,1223,29079
2021-02-18,MO,Grundy,68,1291,29079
2021-02-19,MO,Grundy,68,1359,29079
2021-02-20,MO,Grundy,2,1361,29079
2021-02-21,MO,Grundy,1,1362,29079
2021-02-22,MO,Grundy,11,1373,29079
2021-02-23,MO,Grundy,86,1459,29079
2021-02-24,MO,Grundy,84,1543,29079
2021-02-25,MO,Grundy,257,1800,29079
2021-02-26,MO,Grundy,138,1938,29079
2021-02-27,MO,Grundy,91,2029,29079
2021-03-01,MO,Grundy,24,2053,29079
2021-03-02,MO,Grundy,7,2060,29079
2021-03-03,MO,Grundy,33,2093,29079
2021-03-04,MO,Grundy,84,2177,29079
2021-03-05,MO,Grundy,40,2217,29079
2021-03-06,MO,Grundy,29,2246,29079
2021-03-07,MO,Grundy,1,2247,29079
2021-03-08,MO,Grundy,17,2264,29079
2021-03-09,MO,Grundy,35,2299,29079
2021-03-10,MO,Grundy,21,2320,29079
2021-03-11,MO,Grundy,76,2396,29079
2021-03-12,MO,Grundy,40,2436,29079
2021-03-13,MO,Grundy,12,2448,29079
2021-03-15,MO,Grundy,9,2457,29079
2021-03-16,MO,Grundy,124,2581,29079
2021-03-17,MO,Grundy,103,2684,29079
2021-03-18,MO,Grundy,92,2776,29079
2021-03-19,MO,Grundy,168,2944,29079
2021-03-20,MO,Grundy,19,2963,29079
2021-03-22,MO,Grundy,23,2986,29079
2021-03-23,MO,Grundy,35,3021,29079
2021-03-24,MO,Grundy,38,3059,29079
2021-03-25,MO,Grundy,115,3174,29079
2021-03-26,MO,Grundy,125,3299,29079
2021-03-27,MO,Grundy,16,3315,29079
2021-03-28,MO,Grundy,3,3318,29079
2021-03-29,MO,Grundy,28,3346,29079
2021-03-30,MO,Grundy,20,3366,29079
2021-03-31,MO,Grundy,14,3380,29079
2021-04-01,MO,Grundy,126,3506,29079
2021-04-02,MO,Grundy,36,3542,29079
2021-04-03,MO,Grundy,19,3561,29079
2021-04-04,MO,Grundy,1,3562,29079
2021-04-05,MO,Grundy,18,3580,29079
2021-04-06,MO,Grundy,14,3594,29079
2021-04-07,MO,Grundy,21,3615,29079
2021-04-08,MO,Grundy,30,3645,29079
2021-04-09,MO,Grundy,119,3764,29079
2021-04-10,MO,Grundy,10,3774,29079
2021-04-11,MO,Grundy,1,3775,29079
2021-04-12,MO,Grundy,23,3798,29079
2021-04-13,MO,Grundy,20,3818,29079
2021-04-14,MO,Grundy,19,3837,29079
2021-04-15,MO,Grundy,23,3860,29079
2021-04-16,MO,Grundy,31,3891,29079
2021-04-17,MO,Grundy,5,3896,29079
2021-04-18,MO,Grundy,1,3897,29079
2021-04-19,MO,Grundy,10,3907,29079
2021-04-20,MO,Grundy,25,3932,29079
2021-04-21,MO,Grundy,11,3943,29079
2021-04-22,MO,Grundy,8,3951,29079
2021-04-23,MO,Grundy,22,3973,29079
2021-04-24,MO,Grundy,10,3983,29079
2020-12-20,MO,Harrison,1,1,29081
2020-12-21,MO,Harrison,2,3,29081
2020-12-22,MO,Harrison,2,5,29081
2020-12-23,MO,Harrison,3,8,29081
2020-12-24,MO,Harrison,2,10,29081
2020-12-27,MO,Harrison,5,15,29081
2020-12-28,MO,Harrison,10,25,29081
2020-12-29,MO,Harrison,18,43,29081
2020-12-30,MO,Harrison,52,95,29081
2020-12-31,MO,Harrison,3,98,29081
2021-01-03,MO,Harrison,2,100,29081
2021-01-04,MO,Harrison,6,106,29081
2021-01-05,MO,Harrison,3,109,29081
2021-01-06,MO,Harrison,9,118,29081
2021-01-07,MO,Harrison,10,128,29081
2021-01-08,MO,Harrison,9,137,29081
2021-01-09,MO,Harrison,2,139,29081
2021-01-11,MO,Harrison,1,140,29081
2021-01-12,MO,Harrison,9,149,29081
2021-01-13,MO,Harrison,37,186,29081
2021-01-14,MO,Harrison,14,200,29081
2021-01-15,MO,Harrison,15,215,29081
2021-01-16,MO,Harrison,1,216,29081
2021-01-18,MO,Harrison,2,218,29081
2021-01-19,MO,Harrison,5,223,29081
2021-01-20,MO,Harrison,15,238,29081
2021-01-21,MO,Harrison,12,250,29081
2021-01-22,MO,Harrison,6,256,29081
2021-01-23,MO,Harrison,1,257,29081
2021-01-25,MO,Harrison,6,263,29081
2021-01-26,MO,Harrison,6,269,29081
2021-01-27,MO,Harrison,90,359,29081
2021-01-28,MO,Harrison,28,387,29081
2021-01-29,MO,Harrison,247,634,29081
2021-01-30,MO,Harrison,2,636,29081
2021-01-31,MO,Harrison,1,637,29081
2021-02-01,MO,Harrison,63,700,29081
2021-02-02,MO,Harrison,13,713,29081
2021-02-03,MO,Harrison,63,776,29081
2021-02-04,MO,Harrison,22,798,29081
2021-02-05,MO,Harrison,40,838,29081
2021-02-06,MO,Harrison,2,840,29081
2021-02-07,MO,Harrison,1,841,29081
2021-02-08,MO,Harrison,22,863,29081
2021-02-09,MO,Harrison,89,952,29081
2021-02-10,MO,Harrison,103,1055,29081
2021-02-11,MO,Harrison,28,1083,29081
2021-02-12,MO,Harrison,58,1141,29081
2021-02-13,MO,Harrison,7,1148,29081
2021-02-14,MO,Harrison,3,1151,29081
2021-02-15,MO,Harrison,9,1160,29081
2021-02-16,MO,Harrison,8,1168,29081
2021-02-17,MO,Harrison,52,1220,29081
2021-02-18,MO,Harrison,14,1234,29081
2021-02-19,MO,Harrison,245,1479,29081
2021-02-20,MO,Harrison,7,1486,29081
2021-02-22,MO,Harrison,12,1498,29081
2021-02-23,MO,Harrison,5,1503,29081
2021-02-24,MO,Harrison,62,1565,29081
2021-02-25,MO,Harrison,27,1592,29081
2021-02-26,MO,Harrison,58,1650,29081
2021-02-27,MO,Harrison,192,1842,29081
2021-03-01,MO,Harrison,6,1848,29081
2021-03-02,MO,Harrison,20,1868,29081
2021-03-03,MO,Harrison,106,1974,29081
2021-03-04,MO,Harrison,20,1994,29081
2021-03-05,MO,Harrison,49,2043,29081
2021-03-06,MO,Harrison,86,2129,29081
2021-03-07,MO,Harrison,2,2131,29081
2021-03-08,MO,Harrison,13,2144,29081
2021-03-09,MO,Harrison,13,2157,29081
2021-03-10,MO,Harrison,8,2165,29081
2021-03-11,MO,Harrison,18,2183,29081
2021-03-12,MO,Harrison,15,2198,29081
2021-03-13,MO,Harrison,4,2202,29081
2021-03-14,MO,Harrison,1,2203,29081
2021-03-15,MO,Harrison,25,2228,29081
2021-03-16,MO,Harrison,40,2268,29081
2021-03-17,MO,Harrison,52,2320,29081
2021-03-18,MO,Harrison,54,2374,29081
2021-03-19,MO,Harrison,46,2420,29081
2021-03-20,MO,Harrison,6,2426,29081
2021-03-21,MO,Harrison,9,2435,29081
2021-03-22,MO,Harrison,13,2448,29081
2021-03-23,MO,Harrison,9,2457,29081
2021-03-24,MO,Harrison,25,2482,29081
2021-03-25,MO,Harrison,29,2511,29081
2021-03-26,MO,Harrison,21,2532,29081
2021-03-27,MO,Harrison,5,2537,29081
2021-03-28,MO,Harrison,3,2540,29081
2021-03-29,MO,Harrison,10,2550,29081
2021-03-30,MO,Harrison,9,2559,29081
2021-03-31,MO,Harrison,25,2584,29081
2021-04-01,MO,Harrison,5,2589,29081
2021-04-02,MO,Harrison,6,2595,29081
2021-04-03,MO,Harrison,5,2600,29081
2021-04-04,MO,Harrison,4,2604,29081
2021-04-05,MO,Harrison,7,2611,29081
2021-04-06,MO,Harrison,12,2623,29081
2021-04-07,MO,Harrison,25,2648,29081
2021-04-08,MO,Harrison,18,2666,29081
2021-04-09,MO,Harrison,49,2715,29081
2021-04-10,MO,Harrison,5,2720,29081
2021-04-11,MO,Harrison,11,2731,29081
2021-04-12,MO,Harrison,33,2764,29081
2021-04-13,MO,Harrison,7,2771,29081
2021-04-14,MO,Harrison,11,2782,29081
2021-04-15,MO,Harrison,32,2814,29081
2021-04-16,MO,Harrison,27,2841,29081
2021-04-17,MO,Harrison,8,2849,29081
2021-04-18,MO,Harrison,3,2852,29081
2021-04-19,MO,Harrison,9,2861,29081
2021-04-20,MO,Harrison,15,2876,29081
2021-04-21,MO,Harrison,10,2886,29081
2021-04-22,MO,Harrison,9,2895,29081
2021-04-23,MO,Harrison,21,2916,29081
2021-04-24,MO,Harrison,4,2920,29081
2021-04-25,MO,Harrison,1,2921,29081
2020-12-15,MO,Henry,2,2,29083
2020-12-16,MO,Henry,2,4,29083
2020-12-17,MO,Henry,7,11,29083
2020-12-18,MO,Henry,47,58,29083
2020-12-19,MO,Henry,8,66,29083
2020-12-20,MO,Henry,1,67,29083
2020-12-21,MO,Henry,57,124,29083
2020-12-22,MO,Henry,36,160,29083
2020-12-23,MO,Henry,5,165,29083
2020-12-24,MO,Henry,5,170,29083
2020-12-26,MO,Henry,1,171,29083
2020-12-27,MO,Henry,1,172,29083
2020-12-28,MO,Henry,9,181,29083
2020-12-29,MO,Henry,80,261,29083
2020-12-30,MO,Henry,62,323,29083
2020-12-31,MO,Henry,31,354,29083
2021-01-03,MO,Henry,1,355,29083
2021-01-04,MO,Henry,13,368,29083
2021-01-05,MO,Henry,16,384,29083
2021-01-06,MO,Henry,58,442,29083
2021-01-07,MO,Henry,12,454,29083
2021-01-08,MO,Henry,27,481,29083
2021-01-09,MO,Henry,1,482,29083
2021-01-11,MO,Henry,98,580,29083
2021-01-12,MO,Henry,45,625,29083
2021-01-13,MO,Henry,60,685,29083
2021-01-14,MO,Henry,65,750,29083
2021-01-15,MO,Henry,30,780,29083
2021-01-16,MO,Henry,5,785,29083
2021-01-17,MO,Henry,1,786,29083
2021-01-18,MO,Henry,6,792,29083
2021-01-19,MO,Henry,163,955,29083
2021-01-20,MO,Henry,67,1022,29083
2021-01-21,MO,Henry,47,1069,29083
2021-01-22,MO,Henry,25,1094,29083
2021-01-23,MO,Henry,292,1386,29083
2021-01-24,MO,Henry,1,1387,29083
2021-01-25,MO,Henry,32,1419,29083
2021-01-26,MO,Henry,201,1620,29083
2021-01-27,MO,Henry,159,1779,29083
2021-01-28,MO,Henry,223,2002,29083
2021-01-29,MO,Henry,84,2086,29083
2021-01-30,MO,Henry,10,2096,29083
2021-01-31,MO,Henry,4,2100,29083
2021-02-01,MO,Henry,44,2144,29083
2021-02-02,MO,Henry,50,2194,29083
2021-02-03,MO,Henry,61,2255,29083
2021-02-04,MO,Henry,32,2287,29083
2021-02-05,MO,Henry,513,2800,29083
2021-02-06,MO,Henry,2,2802,29083
2021-02-08,MO,Henry,53,2855,29083
2021-02-09,MO,Henry,197,3052,29083
2021-02-10,MO,Henry,106,3158,29083
2021-02-11,MO,Henry,92,3250,29083
2021-02-12,MO,Henry,65,3315,29083
2021-02-13,MO,Henry,602,3917,29083
2021-02-14,MO,Henry,279,4196,29083
2021-02-15,MO,Henry,51,4247,29083
2021-02-16,MO,Henry,135,4382,29083
2021-02-17,MO,Henry,131,4513,29083
2021-02-18,MO,Henry,135,4648,29083
2021-02-19,MO,Henry,14,4662,29083
2021-02-20,MO,Henry,7,4669,29083
2021-02-21,MO,Henry,3,4672,29083
2021-02-22,MO,Henry,32,4704,29083
2021-02-23,MO,Henry,88,4792,29083
2021-02-24,MO,Henry,77,4869,29083
2021-02-25,MO,Henry,73,4942,29083
2021-02-26,MO,Henry,318,5260,29083
2021-02-27,MO,Henry,252,5512,29083
2021-02-28,MO,Henry,138,5650,29083
2021-03-01,MO,Henry,45,5695,29083
2021-03-02,MO,Henry,206,5901,29083
2021-03-03,MO,Henry,78,5979,29083
2021-03-04,MO,Henry,74,6053,29083
2021-03-05,MO,Henry,350,6403,29083
2021-03-06,MO,Henry,5,6408,29083
2021-03-07,MO,Henry,3,6411,29083
2021-03-08,MO,Henry,24,6435,29083
2021-03-09,MO,Henry,50,6485,29083
2021-03-10,MO,Henry,63,6548,29083
2021-03-11,MO,Henry,81,6629,29083
2021-03-12,MO,Henry,181,6810,29083
2021-03-13,MO,Henry,526,7336,29083
2021-03-14,MO,Henry,280,7616,29083
2021-03-15,MO,Henry,66,7682,29083
2021-03-16,MO,Henry,72,7754,29083
2021-03-17,MO,Henry,117,7871,29083
2021-03-18,MO,Henry,95,7966,29083
2021-03-19,MO,Henry,74,8040,29083
2021-03-20,MO,Henry,40,8080,29083
2021-03-21,MO,Henry,13,8093,29083
2021-03-22,MO,Henry,58,8151,29083
2021-03-23,MO,Henry,81,8232,29083
2021-03-24,MO,Henry,80,8312,29083
2021-03-25,MO,Henry,199,8511,29083
2021-03-26,MO,Henry,130,8641,29083
2021-03-27,MO,Henry,261,8902,29083
2021-03-28,MO,Henry,151,9053,29083
2021-03-29,MO,Henry,37,9090,29083
2021-03-30,MO,Henry,148,9238,29083
2021-03-31,MO,Henry,52,9290,29083
2021-04-01,MO,Henry,80,9370,29083
2021-04-02,MO,Henry,80,9450,29083
2021-04-03,MO,Henry,46,9496,29083
2021-04-04,MO,Henry,7,9503,29083
2021-04-05,MO,Henry,64,9567,29083
2021-04-06,MO,Henry,99,9666,29083
2021-04-07,MO,Henry,71,9737,29083
2021-04-08,MO,Henry,76,9813,29083
2021-04-09,MO,Henry,222,10035,29083
2021-04-10,MO,Henry,283,10318,29083
2021-04-11,MO,Henry,8,10326,29083
2021-04-12,MO,Henry,88,10414,29083
2021-04-13,MO,Henry,83,10497,29083
2021-04-14,MO,Henry,70,10567,29083
2021-04-15,MO,Henry,183,10750,29083
2021-04-16,MO,Henry,119,10869,29083
2021-04-17,MO,Henry,43,10912,29083
2021-04-18,MO,Henry,11,10923,29083
2021-04-19,MO,Henry,42,10965,29083
2021-04-20,MO,Henry,58,11023,29083
2021-04-21,MO,Henry,47,11070,29083
2021-04-22,MO,Henry,47,11117,29083
2021-04-23,MO,Henry,38,11155,29083
2021-04-24,MO,Henry,36,11191,29083
2021-04-25,MO,Henry,6,11197,29083
2020-12-18,MO,Hickory,4,4,29085
2020-12-21,MO,Hickory,1,5,29085
2020-12-22,MO,Hickory,5,10,29085
2020-12-23,MO,Hickory,5,15,29085
2020-12-24,MO,Hickory,1,16,29085
2020-12-28,MO,Hickory,6,22,29085
2020-12-29,MO,Hickory,22,44,29085
2020-12-30,MO,Hickory,13,57,29085
2020-12-31,MO,Hickory,8,65,29085
2021-01-02,MO,Hickory,2,67,29085
2021-01-04,MO,Hickory,6,73,29085
2021-01-05,MO,Hickory,10,83,29085
2021-01-06,MO,Hickory,3,86,29085
2021-01-07,MO,Hickory,3,89,29085
2021-01-08,MO,Hickory,4,93,29085
2021-01-12,MO,Hickory,10,103,29085
2021-01-13,MO,Hickory,7,110,29085
2021-01-14,MO,Hickory,2,112,29085
2021-01-15,MO,Hickory,2,114,29085
2021-01-16,MO,Hickory,3,117,29085
2021-01-18,MO,Hickory,4,121,29085
2021-01-19,MO,Hickory,74,195,29085
2021-01-20,MO,Hickory,15,210,29085
2021-01-21,MO,Hickory,34,244,29085
2021-01-22,MO,Hickory,125,369,29085
2021-01-23,MO,Hickory,3,372,29085
2021-01-24,MO,Hickory,1,373,29085
2021-01-25,MO,Hickory,114,487,29085
2021-01-26,MO,Hickory,36,523,29085
2021-01-27,MO,Hickory,266,789,29085
2021-01-28,MO,Hickory,132,921,29085
2021-01-29,MO,Hickory,131,1052,29085
2021-01-30,MO,Hickory,2,1054,29085
2021-02-01,MO,Hickory,165,1219,29085
2021-02-02,MO,Hickory,65,1284,29085
2021-02-03,MO,Hickory,122,1406,29085
2021-02-04,MO,Hickory,2,1408,29085
2021-02-05,MO,Hickory,26,1434,29085
2021-02-06,MO,Hickory,4,1438,29085
2021-02-08,MO,Hickory,6,1444,29085
2021-02-09,MO,Hickory,18,1462,29085
2021-02-10,MO,Hickory,89,1551,29085
2021-02-11,MO,Hickory,51,1602,29085
2021-02-12,MO,Hickory,68,1670,29085
2021-02-13,MO,Hickory,5,1675,29085
2021-02-14,MO,Hickory,7,1682,29085
2021-02-15,MO,Hickory,3,1685,29085
2021-02-16,MO,Hickory,54,1739,29085
2021-02-17,MO,Hickory,70,1809,29085
2021-02-18,MO,Hickory,15,1824,29085
2021-02-19,MO,Hickory,110,1934,29085
2021-02-20,MO,Hickory,19,1953,29085
2021-02-22,MO,Hickory,127,2080,29085
2021-02-23,MO,Hickory,50,2130,29085
2021-02-24,MO,Hickory,271,2401,29085
2021-02-25,MO,Hickory,156,2557,29085
2021-02-26,MO,Hickory,173,2730,29085
2021-02-27,MO,Hickory,4,2734,29085
2021-02-28,MO,Hickory,3,2737,29085
2021-03-01,MO,Hickory,135,2872,29085
2021-03-02,MO,Hickory,26,2898,29085
2021-03-03,MO,Hickory,181,3079,29085
2021-03-04,MO,Hickory,85,3164,29085
2021-03-05,MO,Hickory,108,3272,29085
2021-03-06,MO,Hickory,13,3285,29085
2021-03-07,MO,Hickory,1,3286,29085
2021-03-08,MO,Hickory,20,3306,29085
2021-03-09,MO,Hickory,32,3338,29085
2021-03-10,MO,Hickory,137,3475,29085
2021-03-11,MO,Hickory,64,3539,29085
2021-03-12,MO,Hickory,95,3634,29085
2021-03-13,MO,Hickory,19,3653,29085
2021-03-14,MO,Hickory,2,3655,29085
2021-03-15,MO,Hickory,11,3666,29085
2021-03-16,MO,Hickory,43,3709,29085
2021-03-17,MO,Hickory,103,3812,29085
2021-03-18,MO,Hickory,34,3846,29085
2021-03-19,MO,Hickory,36,3882,29085
2021-03-20,MO,Hickory,4,3886,29085
2021-03-21,MO,Hickory,2,3888,29085
2021-03-22,MO,Hickory,10,3898,29085
2021-03-23,MO,Hickory,31,3929,29085
2021-03-24,MO,Hickory,41,3970,29085
2021-03-25,MO,Hickory,104,4074,29085
2021-03-26,MO,Hickory,94,4168,29085
2021-03-27,MO,Hickory,6,4174,29085
2021-03-28,MO,Hickory,4,4178,29085
2021-03-29,MO,Hickory,10,4188,29085
2021-03-30,MO,Hickory,28,4216,29085
2021-03-31,MO,Hickory,65,4281,29085
2021-04-01,MO,Hickory,12,4293,29085
2021-04-02,MO,Hickory,65,4358,29085
2021-04-03,MO,Hickory,8,4366,29085
2021-04-04,MO,Hickory,2,4368,29085
2021-04-05,MO,Hickory,12,4380,29085
2021-04-06,MO,Hickory,16,4396,29085
2021-04-07,MO,Hickory,12,4408,29085
2021-04-08,MO,Hickory,35,4443,29085
2021-04-09,MO,Hickory,96,4539,29085
2021-04-10,MO,Hickory,10,4549,29085
2021-04-11,MO,Hickory,5,4554,29085
2021-04-12,MO,Hickory,10,4564,29085
2021-04-13,MO,Hickory,25,4589,29085
2021-04-14,MO,Hickory,14,4603,29085
2021-04-15,MO,Hickory,7,4610,29085
2021-04-16,MO,Hickory,43,4653,29085
2021-04-17,MO,Hickory,8,4661,29085
2021-04-19,MO,Hickory,10,4671,29085
2021-04-20,MO,Hickory,4,4675,29085
2021-04-21,MO,Hickory,9,4684,29085
2021-04-22,MO,Hickory,27,4711,29085
2021-04-23,MO,Hickory,17,4728,29085
2021-04-24,MO,Hickory,3,4731,29085
2021-04-25,MO,Hickory,1,4732,29085
2020-12-23,MO,Holt,6,6,29087
2020-12-27,MO,Holt,3,9,29087
2020-12-28,MO,Holt,47,56,29087
2020-12-29,MO,Holt,5,61,29087
2020-12-30,MO,Holt,2,63,29087
2020-12-31,MO,Holt,44,107,29087
2021-01-01,MO,Holt,1,108,29087
2021-01-02,MO,Holt,8,116,29087
2021-01-04,MO,Holt,5,121,29087
2021-01-05,MO,Holt,5,126,29087
2021-01-06,MO,Holt,6,132,29087
2021-01-07,MO,Holt,6,138,29087
2021-01-09,MO,Holt,1,139,29087
2021-01-11,MO,Holt,1,140,29087
2021-01-13,MO,Holt,9,149,29087
2021-01-14,MO,Holt,11,160,29087
2021-01-15,MO,Holt,3,163,29087
2021-01-19,MO,Holt,1,164,29087
2021-01-20,MO,Holt,9,173,29087
2021-01-21,MO,Holt,5,178,29087
2021-01-22,MO,Holt,8,186,29087
2021-01-23,MO,Holt,1,187,29087
2021-01-25,MO,Holt,1,188,29087
2021-01-26,MO,Holt,8,196,29087
2021-01-27,MO,Holt,37,233,29087
2021-01-28,MO,Holt,26,259,29087
2021-01-29,MO,Holt,278,537,29087
2021-01-31,MO,Holt,3,540,29087
2021-02-01,MO,Holt,10,550,29087
2021-02-02,MO,Holt,54,604,29087
2021-02-03,MO,Holt,37,641,29087
2021-02-04,MO,Holt,76,717,29087
2021-02-05,MO,Holt,11,728,29087
2021-02-06,MO,Holt,1,729,29087
2021-02-08,MO,Holt,5,734,29087
2021-02-09,MO,Holt,9,743,29087
2021-02-10,MO,Holt,6,749,29087
2021-02-11,MO,Holt,26,775,29087
2021-02-12,MO,Holt,14,789,29087
2021-02-13,MO,Holt,3,792,29087
2021-02-16,MO,Holt,5,797,29087
2021-02-17,MO,Holt,9,806,29087
2021-02-18,MO,Holt,7,813,29087
2021-02-19,MO,Holt,5,818,29087
2021-02-22,MO,Holt,160,978,29087
2021-02-23,MO,Holt,36,1014,29087
2021-02-24,MO,Holt,4,1018,29087
2021-02-25,MO,Holt,114,1132,29087
2021-02-26,MO,Holt,71,1203,29087
2021-02-27,MO,Holt,3,1206,29087
2021-02-28,MO,Holt,1,1207,29087
2021-03-01,MO,Holt,13,1220,29087
2021-03-02,MO,Holt,24,1244,29087
2021-03-03,MO,Holt,8,1252,29087
2021-03-04,MO,Holt,17,1269,29087
2021-03-05,MO,Holt,15,1284,29087
2021-03-06,MO,Holt,3,1287,29087
2021-03-08,MO,Holt,26,1313,29087
2021-03-09,MO,Holt,62,1375,29087
2021-03-10,MO,Holt,13,1388,29087
2021-03-11,MO,Holt,60,1448,29087
2021-03-12,MO,Holt,19,1467,29087
2021-03-15,MO,Holt,50,1517,29087
2021-03-16,MO,Holt,10,1527,29087
2021-03-17,MO,Holt,8,1535,29087
2021-03-18,MO,Holt,87,1622,29087
2021-03-19,MO,Holt,10,1632,29087
2021-03-20,MO,Holt,4,1636,29087
2021-03-22,MO,Holt,15,1651,29087
2021-03-23,MO,Holt,3,1654,29087
2021-03-24,MO,Holt,13,1667,29087
2021-03-25,MO,Holt,11,1678,29087
2021-03-26,MO,Holt,11,1689,29087
2021-03-27,MO,Holt,2,1691,29087
2021-03-29,MO,Holt,16,1707,29087
2021-03-30,MO,Holt,47,1754,29087
2021-03-31,MO,Holt,15,1769,29087
2021-04-01,MO,Holt,6,1775,29087
2021-04-02,MO,Holt,15,1790,29087
2021-04-03,MO,Holt,1,1791,29087
2021-04-05,MO,Holt,23,1814,29087
2021-04-06,MO,Holt,13,1827,29087
2021-04-07,MO,Holt,23,1850,29087
2021-04-08,MO,Holt,27,1877,29087
2021-04-09,MO,Holt,14,1891,29087
2021-04-10,MO,Holt,2,1893,29087
2021-04-11,MO,Holt,1,1894,29087
2021-04-12,MO,Holt,9,1903,29087
2021-04-13,MO,Holt,13,1916,29087
2021-04-14,MO,Holt,27,1943,29087
2021-04-15,MO,Holt,24,1967,29087
2021-04-16,MO,Holt,15,1982,29087
2021-04-17,MO,Holt,2,1984,29087
2021-04-19,MO,Holt,9,1993,29087
2021-04-20,MO,Holt,10,2003,29087
2021-04-21,MO,Holt,1,2004,29087
2021-04-22,MO,Holt,2,2006,29087
2021-04-23,MO,Holt,3,2009,29087
2020-12-16,MO,Howard,2,2,29089
2020-12-17,MO,Howard,5,7,29089
2020-12-18,MO,Howard,6,13,29089
2020-12-19,MO,Howard,10,23,29089
2020-12-20,MO,Howard,2,25,29089
2020-12-21,MO,Howard,13,38,29089
2020-12-22,MO,Howard,14,52,29089
2020-12-23,MO,Howard,2,54,29089
2020-12-28,MO,Howard,11,65,29089
2020-12-29,MO,Howard,10,75,29089
2020-12-30,MO,Howard,20,95,29089
2020-12-31,MO,Howard,6,101,29089
2021-01-02,MO,Howard,6,107,29089
2021-01-03,MO,Howard,4,111,29089
2021-01-04,MO,Howard,3,114,29089
2021-01-05,MO,Howard,4,118,29089
2021-01-06,MO,Howard,8,126,29089
2021-01-07,MO,Howard,8,134,29089
2021-01-08,MO,Howard,8,142,29089
2021-01-09,MO,Howard,6,148,29089
2021-01-10,MO,Howard,4,152,29089
2021-01-11,MO,Howard,25,177,29089
2021-01-12,MO,Howard,54,231,29089
2021-01-13,MO,Howard,8,239,29089
2021-01-14,MO,Howard,11,250,29089
2021-01-15,MO,Howard,31,281,29089
2021-01-16,MO,Howard,12,293,29089
2021-01-18,MO,Howard,15,308,29089
2021-01-19,MO,Howard,9,317,29089
2021-01-20,MO,Howard,27,344,29089
2021-01-21,MO,Howard,18,362,29089
2021-01-22,MO,Howard,9,371,29089
2021-01-23,MO,Howard,9,380,29089
2021-01-24,MO,Howard,5,385,29089
2021-01-25,MO,Howard,11,396,29089
2021-01-26,MO,Howard,23,419,29089
2021-01-27,MO,Howard,13,432,29089
2021-01-28,MO,Howard,89,521,29089
2021-01-29,MO,Howard,93,614,29089
2021-01-30,MO,Howard,14,628,29089
2021-01-31,MO,Howard,4,632,29089
2021-02-01,MO,Howard,6,638,29089
2021-02-02,MO,Howard,14,652,29089
2021-02-03,MO,Howard,183,835,29089
2021-02-04,MO,Howard,79,914,29089
2021-02-05,MO,Howard,20,934,29089
2021-02-06,MO,Howard,20,954,29089
2021-02-08,MO,Howard,173,1127,29089
2021-02-09,MO,Howard,36,1163,29089
2021-02-10,MO,Howard,17,1180,29089
2021-02-11,MO,Howard,99,1279,29089
2021-02-12,MO,Howard,44,1323,29089
2021-02-13,MO,Howard,15,1338,29089
2021-02-15,MO,Howard,13,1351,29089
2021-02-16,MO,Howard,51,1402,29089
2021-02-17,MO,Howard,108,1510,29089
2021-02-18,MO,Howard,43,1553,29089
2021-02-19,MO,Howard,31,1584,29089
2021-02-20,MO,Howard,3,1587,29089
2021-02-22,MO,Howard,5,1592,29089
2021-02-23,MO,Howard,24,1616,29089
2021-02-24,MO,Howard,213,1829,29089
2021-02-25,MO,Howard,345,2174,29089
2021-02-26,MO,Howard,31,2205,29089
2021-02-27,MO,Howard,24,2229,29089
2021-02-28,MO,Howard,2,2231,29089
2021-03-01,MO,Howard,78,2309,29089
2021-03-02,MO,Howard,26,2335,29089
2021-03-03,MO,Howard,244,2579,29089
2021-03-04,MO,Howard,77,2656,29089
2021-03-05,MO,Howard,40,2696,29089
2021-03-06,MO,Howard,32,2728,29089
2021-03-07,MO,Howard,3,2731,29089
2021-03-08,MO,Howard,176,2907,29089
2021-03-09,MO,Howard,25,2932,29089
2021-03-10,MO,Howard,27,2959,29089
2021-03-11,MO,Howard,93,3052,29089
2021-03-12,MO,Howard,19,3071,29089
2021-03-13,MO,Howard,3,3074,29089
2021-03-14,MO,Howard,9,3083,29089
2021-03-15,MO,Howard,95,3178,29089
2021-03-16,MO,Howard,132,3310,29089
2021-03-17,MO,Howard,173,3483,29089
2021-03-18,MO,Howard,11,3494,29089
2021-03-19,MO,Howard,32,3526,29089
2021-03-20,MO,Howard,5,3531,29089
2021-03-21,MO,Howard,3,3534,29089
2021-03-22,MO,Howard,31,3565,29089
2021-03-23,MO,Howard,34,3599,29089
2021-03-24,MO,Howard,180,3779,29089
2021-03-25,MO,Howard,271,4050,29089
2021-03-26,MO,Howard,87,4137,29089
2021-03-27,MO,Howard,24,4161,29089
2021-03-28,MO,Howard,5,4166,29089
2021-03-29,MO,Howard,78,4244,29089
2021-03-30,MO,Howard,11,4255,29089
2021-03-31,MO,Howard,205,4460,29089
2021-04-01,MO,Howard,24,4484,29089
2021-04-02,MO,Howard,34,4518,29089
2021-04-03,MO,Howard,9,4527,29089
2021-04-05,MO,Howard,110,4637,29089
2021-04-06,MO,Howard,33,4670,29089
2021-04-07,MO,Howard,188,4858,29089
2021-04-08,MO,Howard,17,4875,29089
2021-04-09,MO,Howard,25,4900,29089
2021-04-10,MO,Howard,8,4908,29089
2021-04-11,MO,Howard,10,4918,29089
2021-04-12,MO,Howard,34,4952,29089
2021-04-13,MO,Howard,26,4978,29089
2021-04-14,MO,Howard,73,5051,29089
2021-04-15,MO,Howard,43,5094,29089
2021-04-16,MO,Howard,47,5141,29089
2021-04-17,MO,Howard,28,5169,29089
2021-04-18,MO,Howard,4,5173,29089
2021-04-19,MO,Howard,15,5188,29089
2021-04-20,MO,Howard,18,5206,29089
2021-04-21,MO,Howard,119,5325,29089
2021-04-22,MO,Howard,6,5331,29089
2021-04-23,MO,Howard,40,5371,29089
2021-04-24,MO,Howard,4,5375,29089
2021-04-25,MO,Howard,1,5376,29089
2020-12-15,MO,Howell,2,2,29091
2020-12-16,MO,Howell,3,5,29091
2020-12-17,MO,Howell,6,11,29091
2020-12-18,MO,Howell,7,18,29091
2020-12-19,MO,Howell,3,21,29091
2020-12-20,MO,Howell,2,23,29091
2020-12-21,MO,Howell,15,38,29091
2020-12-22,MO,Howell,114,152,29091
2020-12-23,MO,Howell,63,215,29091
2020-12-24,MO,Howell,10,225,29091
2020-12-26,MO,Howell,1,226,29091
2020-12-27,MO,Howell,1,227,29091
2020-12-28,MO,Howell,36,263,29091
2020-12-29,MO,Howell,52,315,29091
2020-12-30,MO,Howell,66,381,29091
2020-12-31,MO,Howell,29,410,29091
2021-01-01,MO,Howell,1,411,29091
2021-01-02,MO,Howell,42,453,29091
2021-01-04,MO,Howell,21,474,29091
2021-01-05,MO,Howell,66,540,29091
2021-01-06,MO,Howell,23,563,29091
2021-01-07,MO,Howell,7,570,29091
2021-01-08,MO,Howell,22,592,29091
2021-01-09,MO,Howell,69,661,29091
2021-01-10,MO,Howell,2,663,29091
2021-01-11,MO,Howell,16,679,29091
2021-01-12,MO,Howell,27,706,29091
2021-01-13,MO,Howell,13,719,29091
2021-01-14,MO,Howell,4,723,29091
2021-01-15,MO,Howell,11,734,29091
2021-01-16,MO,Howell,2,736,29091
2021-01-18,MO,Howell,68,804,29091
2021-01-19,MO,Howell,81,885,29091
2021-01-20,MO,Howell,124,1009,29091
2021-01-21,MO,Howell,65,1074,29091
2021-01-22,MO,Howell,90,1164,29091
2021-01-23,MO,Howell,6,1170,29091
2021-01-24,MO,Howell,2,1172,29091
2021-01-25,MO,Howell,102,1274,29091
2021-01-26,MO,Howell,112,1386,29091
2021-01-27,MO,Howell,541,1927,29091
2021-01-28,MO,Howell,519,2446,29091
2021-01-29,MO,Howell,1058,3504,29091
2021-01-30,MO,Howell,16,3520,29091
2021-01-31,MO,Howell,2,3522,29091
2021-02-01,MO,Howell,110,3632,29091
2021-02-02,MO,Howell,231,3863,29091
2021-02-03,MO,Howell,22,3885,29091
2021-02-04,MO,Howell,25,3910,29091
2021-02-05,MO,Howell,197,4107,29091
2021-02-06,MO,Howell,79,4186,29091
2021-02-08,MO,Howell,45,4231,29091
2021-02-09,MO,Howell,43,4274,29091
2021-02-10,MO,Howell,126,4400,29091
2021-02-11,MO,Howell,107,4507,29091
2021-02-12,MO,Howell,142,4649,29091
2021-02-13,MO,Howell,25,4674,29091
2021-02-14,MO,Howell,15,4689,29091
2021-02-15,MO,Howell,26,4715,29091
2021-02-16,MO,Howell,83,4798,29091
2021-02-17,MO,Howell,21,4819,29091
2021-02-18,MO,Howell,39,4858,29091
2021-02-19,MO,Howell,111,4969,29091
2021-02-20,MO,Howell,44,5013,29091
2021-02-21,MO,Howell,6,5019,29091
2021-02-22,MO,Howell,26,5045,29091
2021-02-23,MO,Howell,343,5388,29091
2021-02-24,MO,Howell,41,5429,29091
2021-02-25,MO,Howell,341,5770,29091
2021-02-26,MO,Howell,922,6692,29091
2021-02-27,MO,Howell,48,6740,29091
2021-02-28,MO,Howell,79,6819,29091
2021-03-01,MO,Howell,43,6862,29091
2021-03-02,MO,Howell,304,7166,29091
2021-03-03,MO,Howell,171,7337,29091
2021-03-04,MO,Howell,110,7447,29091
2021-03-05,MO,Howell,43,7490,29091
2021-03-06,MO,Howell,15,7505,29091
2021-03-07,MO,Howell,4,7509,29091
2021-03-08,MO,Howell,117,7626,29091
2021-03-09,MO,Howell,194,7820,29091
2021-03-10,MO,Howell,231,8051,29091
2021-03-11,MO,Howell,57,8108,29091
2021-03-12,MO,Howell,112,8220,29091
2021-03-13,MO,Howell,15,8235,29091
2021-03-14,MO,Howell,8,8243,29091
2021-03-15,MO,Howell,146,8389,29091
2021-03-16,MO,Howell,136,8525,29091
2021-03-17,MO,Howell,93,8618,29091
2021-03-18,MO,Howell,59,8677,29091
2021-03-19,MO,Howell,57,8734,29091
2021-03-20,MO,Howell,42,8776,29091
2021-03-21,MO,Howell,8,8784,29091
2021-03-22,MO,Howell,39,8823,29091
2021-03-23,MO,Howell,201,9024,29091
2021-03-24,MO,Howell,151,9175,29091
2021-03-25,MO,Howell,150,9325,29091
2021-03-26,MO,Howell,67,9392,29091
2021-03-27,MO,Howell,51,9443,29091
2021-03-28,MO,Howell,4,9447,29091
2021-03-29,MO,Howell,25,9472,29091
2021-03-30,MO,Howell,196,9668,29091
2021-03-31,MO,Howell,176,9844,29091
2021-04-01,MO,Howell,107,9951,29091
2021-04-02,MO,Howell,41,9992,29091
2021-04-03,MO,Howell,26,10018,29091
2021-04-04,MO,Howell,2,10020,29091
2021-04-05,MO,Howell,194,10214,29091
2021-04-06,MO,Howell,169,10383,29091
2021-04-07,MO,Howell,179,10562,29091
2021-04-08,MO,Howell,90,10652,29091
2021-04-09,MO,Howell,255,10907,29091
2021-04-10,MO,Howell,40,10947,29091
2021-04-11,MO,Howell,14,10961,29091
2021-04-12,MO,Howell,119,11080,29091
2021-04-13,MO,Howell,99,11179,29091
2021-04-14,MO,Howell,134,11313,29091
2021-04-15,MO,Howell,118,11431,29091
2021-04-16,MO,Howell,70,11501,29091
2021-04-17,MO,Howell,25,11526,29091
2021-04-18,MO,Howell,4,11530,29091
2021-04-19,MO,Howell,67,11597,29091
2021-04-20,MO,Howell,66,11663,29091
2021-04-21,MO,Howell,164,11827,29091
2021-04-22,MO,Howell,53,11880,29091
2021-04-23,MO,Howell,36,11916,29091
2021-04-24,MO,Howell,28,11944,29091
2021-04-25,MO,Howell,4,11948,29091
2020-12-13,MO,Iron,1,1,29093
2020-12-15,MO,Iron,1,2,29093
2020-12-16,MO,Iron,1,3,29093
2020-12-17,MO,Iron,5,8,29093
2020-12-18,MO,Iron,4,12,29093
2020-12-21,MO,Iron,2,14,29093
2020-12-22,MO,Iron,8,22,29093
2020-12-23,MO,Iron,29,51,29093
2020-12-28,MO,Iron,2,53,29093
2020-12-29,MO,Iron,6,59,29093
2020-12-30,MO,Iron,42,101,29093
2020-12-31,MO,Iron,69,170,29093
2021-01-02,MO,Iron,48,218,29093
2021-01-04,MO,Iron,5,223,29093
2021-01-05,MO,Iron,5,228,29093
2021-01-06,MO,Iron,6,234,29093
2021-01-07,MO,Iron,5,239,29093
2021-01-08,MO,Iron,7,246,29093
2021-01-09,MO,Iron,7,253,29093
2021-01-11,MO,Iron,5,258,29093
2021-01-12,MO,Iron,20,278,29093
2021-01-13,MO,Iron,35,313,29093
2021-01-14,MO,Iron,6,319,29093
2021-01-15,MO,Iron,29,348,29093
2021-01-17,MO,Iron,1,349,29093
2021-01-18,MO,Iron,6,355,29093
2021-01-19,MO,Iron,9,364,29093
2021-01-20,MO,Iron,22,386,29093
2021-01-21,MO,Iron,13,399,29093
2021-01-22,MO,Iron,34,433,29093
2021-01-23,MO,Iron,2,435,29093
2021-01-25,MO,Iron,29,464,29093
2021-01-26,MO,Iron,10,474,29093
2021-01-27,MO,Iron,37,511,29093
2021-01-28,MO,Iron,179,690,29093
2021-01-29,MO,Iron,33,723,29093
2021-01-30,MO,Iron,11,734,29093
2021-02-01,MO,Iron,19,753,29093
2021-02-02,MO,Iron,11,764,29093
2021-02-03,MO,Iron,8,772,29093
2021-02-04,MO,Iron,72,844,29093
2021-02-05,MO,Iron,26,870,29093
2021-02-06,MO,Iron,23,893,29093
2021-02-08,MO,Iron,24,917,29093
2021-02-09,MO,Iron,47,964,29093
2021-02-10,MO,Iron,10,974,29093
2021-02-11,MO,Iron,30,1004,29093
2021-02-12,MO,Iron,83,1087,29093
2021-02-13,MO,Iron,8,1095,29093
2021-02-14,MO,Iron,4,1099,29093
2021-02-15,MO,Iron,3,1102,29093
2021-02-16,MO,Iron,9,1111,29093
2021-02-17,MO,Iron,12,1123,29093
2021-02-18,MO,Iron,16,1139,29093
2021-02-19,MO,Iron,210,1349,29093
2021-02-20,MO,Iron,115,1464,29093
2021-02-21,MO,Iron,3,1467,29093
2021-02-22,MO,Iron,45,1512,29093
2021-02-23,MO,Iron,21,1533,29093
2021-02-24,MO,Iron,46,1579,29093
2021-02-25,MO,Iron,96,1675,29093
2021-02-26,MO,Iron,90,1765,29093
2021-02-27,MO,Iron,15,1780,29093
2021-03-01,MO,Iron,60,1840,29093
2021-03-02,MO,Iron,18,1858,29093
2021-03-03,MO,Iron,19,1877,29093
2021-03-04,MO,Iron,30,1907,29093
2021-03-05,MO,Iron,42,1949,29093
2021-03-06,MO,Iron,15,1964,29093
2021-03-07,MO,Iron,1,1965,29093
2021-03-08,MO,Iron,75,2040,29093
2021-03-09,MO,Iron,45,2085,29093
2021-03-10,MO,Iron,23,2108,29093
2021-03-11,MO,Iron,28,2136,29093
2021-03-12,MO,Iron,44,2180,29093
2021-03-13,MO,Iron,10,2190,29093
2021-03-14,MO,Iron,2,2192,29093
2021-03-15,MO,Iron,21,2213,29093
2021-03-16,MO,Iron,26,2239,29093
2021-03-17,MO,Iron,34,2273,29093
2021-03-18,MO,Iron,70,2343,29093
2021-03-19,MO,Iron,218,2561,29093
2021-03-20,MO,Iron,114,2675,29093
2021-03-21,MO,Iron,1,2676,29093
2021-03-22,MO,Iron,106,2782,29093
2021-03-23,MO,Iron,92,2874,29093
2021-03-24,MO,Iron,47,2921,29093
2021-03-25,MO,Iron,58,2979,29093
2021-03-26,MO,Iron,71,3050,29093
2021-03-27,MO,Iron,24,3074,29093
2021-03-28,MO,Iron,1,3075,29093
2021-03-29,MO,Iron,84,3159,29093
2021-03-30,MO,Iron,31,3190,29093
2021-03-31,MO,Iron,26,3216,29093
2021-04-01,MO,Iron,22,3238,29093
2021-04-02,MO,Iron,58,3296,29093
2021-04-03,MO,Iron,5,3301,29093
2021-04-04,MO,Iron,1,3302,29093
2021-04-05,MO,Iron,85,3387,29093
2021-04-06,MO,Iron,37,3424,29093
2021-04-07,MO,Iron,33,3457,29093
2021-04-08,MO,Iron,34,3491,29093
2021-04-09,MO,Iron,117,3608,29093
2021-04-10,MO,Iron,26,3634,29093
2021-04-12,MO,Iron,23,3657,29093
2021-04-13,MO,Iron,23,3680,29093
2021-04-14,MO,Iron,35,3715,29093
2021-04-15,MO,Iron,22,3737,29093
2021-04-16,MO,Iron,71,3808,29093
2021-04-17,MO,Iron,20,3828,29093
2021-04-18,MO,Iron,4,3832,29093
2021-04-19,MO,Iron,30,3862,29093
2021-04-20,MO,Iron,11,3873,29093
2021-04-21,MO,Iron,34,3907,29093
2021-04-22,MO,Iron,109,4016,29093
2021-04-23,MO,Iron,60,4076,29093
2021-04-24,MO,Iron,6,4082,29093
2021-04-25,MO,Iron,2,4084,29093
2020-12-13,MO,Jackson,2,2,29095
2020-12-14,MO,Jackson,9,11,29095
2020-12-15,MO,Jackson,40,51,29095
2020-12-16,MO,Jackson,75,126,29095
2020-12-17,MO,Jackson,124,250,29095
2020-12-18,MO,Jackson,307,557,29095
2020-12-19,MO,Jackson,82,639,29095
2020-12-20,MO,Jackson,25,664,29095
2020-12-21,MO,Jackson,420,1084,29095
2020-12-22,MO,Jackson,703,1787,29095
2020-12-23,MO,Jackson,629,2416,29095
2020-12-24,MO,Jackson,135,2551,29095
2020-12-25,MO,Jackson,1,2552,29095
2020-12-26,MO,Jackson,48,2600,29095
2020-12-27,MO,Jackson,35,2635,29095
2020-12-28,MO,Jackson,317,2952,29095
2020-12-29,MO,Jackson,327,3279,29095
2020-12-30,MO,Jackson,630,3909,29095
2020-12-31,MO,Jackson,660,4569,29095
2021-01-01,MO,Jackson,4,4573,29095
2021-01-02,MO,Jackson,113,4686,29095
2021-01-03,MO,Jackson,24,4710,29095
2021-01-04,MO,Jackson,144,4854,29095
2021-01-05,MO,Jackson,410,5264,29095
2021-01-06,MO,Jackson,862,6126,29095
2021-01-07,MO,Jackson,1095,7221,29095
2021-01-08,MO,Jackson,1174,8395,29095
2021-01-09,MO,Jackson,339,8734,29095
2021-01-10,MO,Jackson,64,8798,29095
2021-01-11,MO,Jackson,900,9698,29095
2021-01-12,MO,Jackson,815,10513,29095
2021-01-13,MO,Jackson,931,11444,29095
2021-01-14,MO,Jackson,765,12209,29095
2021-01-15,MO,Jackson,823,13032,29095
2021-01-16,MO,Jackson,92,13124,29095
2021-01-17,MO,Jackson,8,13132,29095
2021-01-18,MO,Jackson,381,13513,29095
2021-01-19,MO,Jackson,673,14186,29095
2021-01-20,MO,Jackson,1096,15282,29095
2021-01-21,MO,Jackson,1570,16852,29095
2021-01-22,MO,Jackson,1196,18048,29095
2021-01-23,MO,Jackson,237,18285,29095
2021-01-24,MO,Jackson,93,18378,29095
2021-01-25,MO,Jackson,1168,19546,29095
2021-01-26,MO,Jackson,1239,20785,29095
2021-01-27,MO,Jackson,1397,22182,29095
2021-01-28,MO,Jackson,1577,23759,29095
2021-01-29,MO,Jackson,1955,25714,29095
2021-01-30,MO,Jackson,644,26358,29095
2021-01-31,MO,Jackson,207,26565,29095
2021-02-01,MO,Jackson,986,27551,29095
2021-02-02,MO,Jackson,948,28499,29095
2021-02-03,MO,Jackson,2251,30750,29095
2021-02-04,MO,Jackson,1504,32254,29095
2021-02-05,MO,Jackson,1865,34119,29095
2021-02-06,MO,Jackson,493,34612,29095
2021-02-07,MO,Jackson,119,34731,29095
2021-02-08,MO,Jackson,1104,35835,29095
2021-02-09,MO,Jackson,1175,37010,29095
2021-02-10,MO,Jackson,972,37982,29095
2021-02-11,MO,Jackson,1865,39847,29095
2021-02-12,MO,Jackson,1842,41689,29095
2021-02-13,MO,Jackson,590,42279,29095
2021-02-14,MO,Jackson,299,42578,29095
2021-02-15,MO,Jackson,747,43325,29095
2021-02-16,MO,Jackson,971,44296,29095
2021-02-17,MO,Jackson,1148,45444,29095
2021-02-18,MO,Jackson,1699,47143,29095
2021-02-19,MO,Jackson,1852,48995,29095
2021-02-20,MO,Jackson,571,49566,29095
2021-02-21,MO,Jackson,262,49828,29095
2021-02-22,MO,Jackson,1593,51421,29095
2021-02-23,MO,Jackson,2022,53443,29095
2021-02-24,MO,Jackson,2925,56368,29095
2021-02-25,MO,Jackson,2708,59076,29095
2021-02-26,MO,Jackson,3847,62923,29095
2021-02-27,MO,Jackson,1450,64373,29095
2021-02-28,MO,Jackson,796,65169,29095
2021-03-01,MO,Jackson,1911,67080,29095
2021-03-02,MO,Jackson,2613,69693,29095
2021-03-03,MO,Jackson,3357,73050,29095
2021-03-04,MO,Jackson,3438,76488,29095
2021-03-05,MO,Jackson,3605,80093,29095
2021-03-06,MO,Jackson,1313,81406,29095
2021-03-07,MO,Jackson,356,81762,29095
2021-03-08,MO,Jackson,2303,84065,29095
2021-03-09,MO,Jackson,1970,86035,29095
2021-03-10,MO,Jackson,3071,89106,29095
2021-03-11,MO,Jackson,2965,92071,29095
2021-03-12,MO,Jackson,2757,94828,29095
2021-03-13,MO,Jackson,1478,96306,29095
2021-03-14,MO,Jackson,730,97036,29095
2021-03-15,MO,Jackson,2491,99527,29095
2021-03-16,MO,Jackson,2839,102366,29095
2021-03-17,MO,Jackson,2746,105112,29095
2021-03-18,MO,Jackson,2539,107651,29095
2021-03-19,MO,Jackson,4221,111872,29095
2021-03-20,MO,Jackson,3903,115775,29095
2021-03-21,MO,Jackson,1493,117268,29095
2021-03-22,MO,Jackson,2855,120123,29095
2021-03-23,MO,Jackson,3554,123677,29095
2021-03-24,MO,Jackson,3588,127265,29095
2021-03-25,MO,Jackson,4621,131886,29095
2021-03-26,MO,Jackson,4479,136365,29095
2021-03-27,MO,Jackson,1742,138107,29095
2021-03-28,MO,Jackson,439,138546,29095
2021-03-29,MO,Jackson,3957,142503,29095
2021-03-30,MO,Jackson,3428,145931,29095
2021-03-31,MO,Jackson,3517,149448,29095
2021-04-01,MO,Jackson,4379,153827,29095
2021-04-02,MO,Jackson,4083,157910,29095
2021-04-03,MO,Jackson,1178,159088,29095
2021-04-04,MO,Jackson,399,159487,29095
2021-04-05,MO,Jackson,3942,163429,29095
2021-04-06,MO,Jackson,4203,167632,29095
2021-04-07,MO,Jackson,4090,171722,29095
2021-04-08,MO,Jackson,4029,175751,29095
2021-04-09,MO,Jackson,4501,180252,29095
2021-04-10,MO,Jackson,3081,183333,29095
2021-04-11,MO,Jackson,1145,184478,29095
2021-04-12,MO,Jackson,3123,187601,29095
2021-04-13,MO,Jackson,3457,191058,29095
2021-04-14,MO,Jackson,3616,194674,29095
2021-04-15,MO,Jackson,3850,198524,29095
2021-04-16,MO,Jackson,3015,201539,29095
2021-04-17,MO,Jackson,953,202492,29095
2021-04-18,MO,Jackson,443,202935,29095
2021-04-19,MO,Jackson,2155,205090,29095
2021-04-20,MO,Jackson,2461,207551,29095
2021-04-21,MO,Jackson,1949,209500,29095
2021-04-22,MO,Jackson,1810,211310,29095
2021-04-23,MO,Jackson,1823,213133,29095
2021-04-24,MO,Jackson,844,213977,29095
2021-04-25,MO,Jackson,58,214035,29095
2020-12-15,MO,Jasper,2,2,29097
2020-12-16,MO,Jasper,11,13,29097
2020-12-17,MO,Jasper,49,62,29097
2020-12-18,MO,Jasper,35,97,29097
2020-12-19,MO,Jasper,12,109,29097
2020-12-20,MO,Jasper,3,112,29097
2020-12-21,MO,Jasper,52,164,29097
2020-12-22,MO,Jasper,56,220,29097
2020-12-23,MO,Jasper,66,286,29097
2020-12-26,MO,Jasper,2,288,29097
2020-12-28,MO,Jasper,35,323,29097
2020-12-29,MO,Jasper,23,346,29097
2020-12-30,MO,Jasper,226,572,29097
2020-12-31,MO,Jasper,141,713,29097
2021-01-02,MO,Jasper,1,714,29097
2021-01-04,MO,Jasper,16,730,29097
2021-01-05,MO,Jasper,27,757,29097
2021-01-06,MO,Jasper,76,833,29097
2021-01-07,MO,Jasper,108,941,29097
2021-01-08,MO,Jasper,92,1033,29097
2021-01-09,MO,Jasper,19,1052,29097
2021-01-10,MO,Jasper,6,1058,29097
2021-01-11,MO,Jasper,82,1140,29097
2021-01-12,MO,Jasper,165,1305,29097
2021-01-13,MO,Jasper,57,1362,29097
2021-01-14,MO,Jasper,130,1492,29097
2021-01-15,MO,Jasper,75,1567,29097
2021-01-16,MO,Jasper,29,1596,29097
2021-01-17,MO,Jasper,2,1598,29097
2021-01-18,MO,Jasper,124,1722,29097
2021-01-19,MO,Jasper,78,1800,29097
2021-01-20,MO,Jasper,209,2009,29097
2021-01-21,MO,Jasper,185,2194,29097
2021-01-22,MO,Jasper,101,2295,29097
2021-01-23,MO,Jasper,66,2361,29097
2021-01-25,MO,Jasper,99,2460,29097
2021-01-26,MO,Jasper,227,2687,29097
2021-01-27,MO,Jasper,293,2980,29097
2021-01-28,MO,Jasper,255,3235,29097
2021-01-29,MO,Jasper,251,3486,29097
2021-01-30,MO,Jasper,5,3491,29097
2021-02-01,MO,Jasper,319,3810,29097
2021-02-02,MO,Jasper,309,4119,29097
2021-02-03,MO,Jasper,518,4637,29097
2021-02-04,MO,Jasper,241,4878,29097
2021-02-05,MO,Jasper,302,5180,29097
2021-02-06,MO,Jasper,4,5184,29097
2021-02-07,MO,Jasper,1,5185,29097
2021-02-08,MO,Jasper,110,5295,29097
2021-02-09,MO,Jasper,275,5570,29097
2021-02-10,MO,Jasper,111,5681,29097
2021-02-11,MO,Jasper,501,6182,29097
2021-02-12,MO,Jasper,239,6421,29097
2021-02-13,MO,Jasper,184,6605,29097
2021-02-14,MO,Jasper,19,6624,29097
2021-02-15,MO,Jasper,108,6732,29097
2021-02-16,MO,Jasper,266,6998,29097
2021-02-17,MO,Jasper,235,7233,29097
2021-02-18,MO,Jasper,224,7457,29097
2021-02-19,MO,Jasper,157,7614,29097
2021-02-20,MO,Jasper,84,7698,29097
2021-02-22,MO,Jasper,293,7991,29097
2021-02-23,MO,Jasper,345,8336,29097
2021-02-24,MO,Jasper,439,8775,29097
2021-02-25,MO,Jasper,378,9153,29097
2021-02-26,MO,Jasper,471,9624,29097
2021-02-27,MO,Jasper,22,9646,29097
2021-02-28,MO,Jasper,15,9661,29097
2021-03-01,MO,Jasper,224,9885,29097
2021-03-02,MO,Jasper,710,10595,29097
2021-03-03,MO,Jasper,466,11061,29097
2021-03-04,MO,Jasper,194,11255,29097
2021-03-05,MO,Jasper,359,11614,29097
2021-03-06,MO,Jasper,93,11707,29097
2021-03-07,MO,Jasper,17,11724,29097
2021-03-08,MO,Jasper,115,11839,29097
2021-03-09,MO,Jasper,576,12415,29097
2021-03-10,MO,Jasper,206,12621,29097
2021-03-11,MO,Jasper,500,13121,29097
2021-03-12,MO,Jasper,297,13418,29097
2021-03-13,MO,Jasper,172,13590,29097
2021-03-14,MO,Jasper,54,13644,29097
2021-03-15,MO,Jasper,452,14096,29097
2021-03-16,MO,Jasper,506,14602,29097
2021-03-17,MO,Jasper,322,14924,29097
2021-03-18,MO,Jasper,451,15375,29097
2021-03-19,MO,Jasper,330,15705,29097
2021-03-20,MO,Jasper,93,15798,29097
2021-03-21,MO,Jasper,24,15822,29097
2021-03-22,MO,Jasper,149,15971,29097
2021-03-23,MO,Jasper,739,16710,29097
2021-03-24,MO,Jasper,444,17154,29097
2021-03-25,MO,Jasper,469,17623,29097
2021-03-26,MO,Jasper,374,17997,29097
2021-03-27,MO,Jasper,165,18162,29097
2021-03-28,MO,Jasper,52,18214,29097
2021-03-29,MO,Jasper,274,18488,29097
2021-03-30,MO,Jasper,435,18923,29097
2021-03-31,MO,Jasper,335,19258,29097
2021-04-01,MO,Jasper,427,19685,29097
2021-04-02,MO,Jasper,235,19920,29097
2021-04-03,MO,Jasper,68,19988,29097
2021-04-04,MO,Jasper,21,20009,29097
2021-04-05,MO,Jasper,421,20430,29097
2021-04-06,MO,Jasper,541,20971,29097
2021-04-07,MO,Jasper,298,21269,29097
2021-04-08,MO,Jasper,313,21582,29097
2021-04-09,MO,Jasper,662,22244,29097
2021-04-10,MO,Jasper,108,22352,29097
2021-04-11,MO,Jasper,36,22388,29097
2021-04-12,MO,Jasper,215,22603,29097
2021-04-13,MO,Jasper,302,22905,29097
2021-04-14,MO,Jasper,308,23213,29097
2021-04-15,MO,Jasper,354,23567,29097
2021-04-16,MO,Jasper,310,23877,29097
2021-04-17,MO,Jasper,83,23960,29097
2021-04-18,MO,Jasper,33,23993,29097
2021-04-19,MO,Jasper,125,24118,29097
2021-04-20,MO,Jasper,379,24497,29097
2021-04-21,MO,Jasper,178,24675,29097
2021-04-22,MO,Jasper,260,24935,29097
2021-04-23,MO,Jasper,225,25160,29097
2021-04-24,MO,Jasper,54,25214,29097
2021-04-25,MO,Jasper,15,25229,29097
2020-12-14,MO,Jefferson,5,5,29099
2020-12-15,MO,Jefferson,30,35,29099
2020-12-16,MO,Jefferson,106,141,29099
2020-12-17,MO,Jefferson,237,378,29099
2020-12-18,MO,Jefferson,272,650,29099
2020-12-19,MO,Jefferson,77,727,29099
2020-12-20,MO,Jefferson,37,764,29099
2020-12-21,MO,Jefferson,257,1021,29099
2020-12-22,MO,Jefferson,293,1314,29099
2020-12-23,MO,Jefferson,208,1522,29099
2020-12-24,MO,Jefferson,22,1544,29099
2020-12-26,MO,Jefferson,61,1605,29099
2020-12-27,MO,Jefferson,45,1650,29099
2020-12-28,MO,Jefferson,217,1867,29099
2020-12-29,MO,Jefferson,314,2181,29099
2020-12-30,MO,Jefferson,281,2462,29099
2020-12-31,MO,Jefferson,134,2596,29099
2021-01-01,MO,Jefferson,10,2606,29099
2021-01-02,MO,Jefferson,80,2686,29099
2021-01-03,MO,Jefferson,12,2698,29099
2021-01-04,MO,Jefferson,327,3025,29099
2021-01-05,MO,Jefferson,288,3313,29099
2021-01-06,MO,Jefferson,342,3655,29099
2021-01-07,MO,Jefferson,321,3976,29099
2021-01-08,MO,Jefferson,552,4528,29099
2021-01-09,MO,Jefferson,86,4614,29099
2021-01-10,MO,Jefferson,45,4659,29099
2021-01-11,MO,Jefferson,437,5096,29099
2021-01-12,MO,Jefferson,477,5573,29099
2021-01-13,MO,Jefferson,437,6010,29099
2021-01-14,MO,Jefferson,345,6355,29099
2021-01-15,MO,Jefferson,476,6831,29099
2021-01-16,MO,Jefferson,105,6936,29099
2021-01-17,MO,Jefferson,9,6945,29099
2021-01-18,MO,Jefferson,513,7458,29099
2021-01-19,MO,Jefferson,649,8107,29099
2021-01-20,MO,Jefferson,770,8877,29099
2021-01-21,MO,Jefferson,607,9484,29099
2021-01-22,MO,Jefferson,641,10125,29099
2021-01-23,MO,Jefferson,250,10375,29099
2021-01-24,MO,Jefferson,53,10428,29099
2021-01-25,MO,Jefferson,530,10958,29099
2021-01-26,MO,Jefferson,492,11450,29099
2021-01-27,MO,Jefferson,516,11966,29099
2021-01-28,MO,Jefferson,540,12506,29099
2021-01-29,MO,Jefferson,782,13288,29099
2021-01-30,MO,Jefferson,180,13468,29099
2021-01-31,MO,Jefferson,20,13488,29099
2021-02-01,MO,Jefferson,479,13967,29099
2021-02-02,MO,Jefferson,501,14468,29099
2021-02-03,MO,Jefferson,563,15031,29099
2021-02-04,MO,Jefferson,666,15697,29099
2021-02-05,MO,Jefferson,1147,16844,29099
2021-02-06,MO,Jefferson,116,16960,29099
2021-02-07,MO,Jefferson,23,16983,29099
2021-02-08,MO,Jefferson,535,17518,29099
2021-02-09,MO,Jefferson,736,18254,29099
2021-02-10,MO,Jefferson,749,19003,29099
2021-02-11,MO,Jefferson,867,19870,29099
2021-02-12,MO,Jefferson,977,20847,29099
2021-02-13,MO,Jefferson,580,21427,29099
2021-02-14,MO,Jefferson,59,21486,29099
2021-02-15,MO,Jefferson,251,21737,29099
2021-02-16,MO,Jefferson,449,22186,29099
2021-02-17,MO,Jefferson,700,22886,29099
2021-02-18,MO,Jefferson,779,23665,29099
2021-02-19,MO,Jefferson,793,24458,29099
2021-02-20,MO,Jefferson,645,25103,29099
2021-02-21,MO,Jefferson,24,25127,29099
2021-02-22,MO,Jefferson,655,25782,29099
2021-02-23,MO,Jefferson,712,26494,29099
2021-02-24,MO,Jefferson,692,27186,29099
2021-02-25,MO,Jefferson,877,28063,29099
2021-02-26,MO,Jefferson,1115,29178,29099
2021-02-27,MO,Jefferson,567,29745,29099
2021-02-28,MO,Jefferson,103,29848,29099
2021-03-01,MO,Jefferson,1633,31481,29099
2021-03-02,MO,Jefferson,1560,33041,29099
2021-03-03,MO,Jefferson,800,33841,29099
2021-03-04,MO,Jefferson,1241,35082,29099
2021-03-05,MO,Jefferson,1115,36197,29099
2021-03-06,MO,Jefferson,654,36851,29099
2021-03-07,MO,Jefferson,187,37038,29099
2021-03-08,MO,Jefferson,1822,38860,29099
2021-03-09,MO,Jefferson,1167,40027,29099
2021-03-10,MO,Jefferson,1517,41544,29099
2021-03-11,MO,Jefferson,1216,42760,29099
2021-03-12,MO,Jefferson,994,43754,29099
2021-03-13,MO,Jefferson,496,44250,29099
2021-03-14,MO,Jefferson,93,44343,29099
2021-03-15,MO,Jefferson,817,45160,29099
2021-03-16,MO,Jefferson,1198,46358,29099
2021-03-17,MO,Jefferson,1130,47488,29099
2021-03-18,MO,Jefferson,1942,49430,29099
2021-03-19,MO,Jefferson,1461,50891,29099
2021-03-20,MO,Jefferson,913,51804,29099
2021-03-21,MO,Jefferson,250,52054,29099
2021-03-22,MO,Jefferson,1144,53198,29099
2021-03-23,MO,Jefferson,1099,54297,29099
2021-03-24,MO,Jefferson,1322,55619,29099
2021-03-25,MO,Jefferson,1844,57463,29099
2021-03-26,MO,Jefferson,1102,58565,29099
2021-03-27,MO,Jefferson,741,59306,29099
2021-03-28,MO,Jefferson,255,59561,29099
2021-03-29,MO,Jefferson,1877,61438,29099
2021-03-30,MO,Jefferson,2440,63878,29099
2021-03-31,MO,Jefferson,1389,65267,29099
2021-04-01,MO,Jefferson,2327,67594,29099
2021-04-02,MO,Jefferson,1284,68878,29099
2021-04-03,MO,Jefferson,698,69576,29099
2021-04-04,MO,Jefferson,106,69682,29099
2021-04-05,MO,Jefferson,2057,71739,29099
2021-04-06,MO,Jefferson,1993,73732,29099
2021-04-07,MO,Jefferson,2426,76158,29099
2021-04-08,MO,Jefferson,1874,78032,29099
2021-04-09,MO,Jefferson,1554,79586,29099
2021-04-10,MO,Jefferson,705,80291,29099
2021-04-11,MO,Jefferson,249,80540,29099
2021-04-12,MO,Jefferson,1576,82116,29099
2021-04-13,MO,Jefferson,1555,83671,29099
2021-04-14,MO,Jefferson,1671,85342,29099
2021-04-15,MO,Jefferson,1820,87162,29099
2021-04-16,MO,Jefferson,1393,88555,29099
2021-04-17,MO,Jefferson,757,89312,29099
2021-04-18,MO,Jefferson,250,89562,29099
2021-04-19,MO,Jefferson,847,90409,29099
2021-04-20,MO,Jefferson,1342,91751,29099
2021-04-21,MO,Jefferson,1066,92817,29099
2021-04-22,MO,Jefferson,1468,94285,29099
2021-04-23,MO,Jefferson,791,95076,29099
2021-04-24,MO,Jefferson,620,95696,29099
2021-04-25,MO,Jefferson,91,95787,29099
2020-12-16,MO,Johnson,1,1,29101
2020-12-17,MO,Johnson,5,6,29101
2020-12-18,MO,Johnson,39,45,29101
2020-12-19,MO,Johnson,16,61,29101
2020-12-20,MO,Johnson,14,75,29101
2020-12-21,MO,Johnson,75,150,29101
2020-12-22,MO,Johnson,72,222,29101
2020-12-23,MO,Johnson,50,272,29101
2020-12-24,MO,Johnson,6,278,29101
2020-12-27,MO,Johnson,1,279,29101
2020-12-28,MO,Johnson,51,330,29101
2020-12-29,MO,Johnson,69,399,29101
2020-12-30,MO,Johnson,64,463,29101
2020-12-31,MO,Johnson,30,493,29101
2021-01-02,MO,Johnson,4,497,29101
2021-01-03,MO,Johnson,1,498,29101
2021-01-04,MO,Johnson,13,511,29101
2021-01-05,MO,Johnson,90,601,29101
2021-01-06,MO,Johnson,73,674,29101
2021-01-07,MO,Johnson,31,705,29101
2021-01-08,MO,Johnson,54,759,29101
2021-01-09,MO,Johnson,12,771,29101
2021-01-10,MO,Johnson,3,774,29101
2021-01-11,MO,Johnson,80,854,29101
2021-01-12,MO,Johnson,82,936,29101
2021-01-13,MO,Johnson,97,1033,29101
2021-01-14,MO,Johnson,40,1073,29101
2021-01-15,MO,Johnson,52,1125,29101
2021-01-16,MO,Johnson,107,1232,29101
2021-01-17,MO,Johnson,1,1233,29101
2021-01-18,MO,Johnson,40,1273,29101
2021-01-19,MO,Johnson,131,1404,29101
2021-01-20,MO,Johnson,64,1468,29101
2021-01-21,MO,Johnson,52,1520,29101
2021-01-22,MO,Johnson,336,1856,29101
2021-01-23,MO,Johnson,17,1873,29101
2021-01-25,MO,Johnson,36,1909,29101
2021-01-26,MO,Johnson,92,2001,29101
2021-01-27,MO,Johnson,372,2373,29101
2021-01-28,MO,Johnson,56,2429,29101
2021-01-29,MO,Johnson,642,3071,29101
2021-01-30,MO,Johnson,28,3099,29101
2021-01-31,MO,Johnson,18,3117,29101
2021-02-01,MO,Johnson,64,3181,29101
2021-02-02,MO,Johnson,244,3425,29101
2021-02-03,MO,Johnson,127,3552,29101
2021-02-04,MO,Johnson,263,3815,29101
2021-02-05,MO,Johnson,92,3907,29101
2021-02-06,MO,Johnson,10,3917,29101
2021-02-08,MO,Johnson,33,3950,29101
2021-02-09,MO,Johnson,56,4006,29101
2021-02-10,MO,Johnson,75,4081,29101
2021-02-11,MO,Johnson,54,4135,29101
2021-02-12,MO,Johnson,626,4761,29101
2021-02-13,MO,Johnson,189,4950,29101
2021-02-14,MO,Johnson,23,4973,29101
2021-02-15,MO,Johnson,33,5006,29101
2021-02-16,MO,Johnson,156,5162,29101
2021-02-17,MO,Johnson,40,5202,29101
2021-02-18,MO,Johnson,57,5259,29101
2021-02-19,MO,Johnson,379,5638,29101
2021-02-20,MO,Johnson,22,5660,29101
2021-02-21,MO,Johnson,15,5675,29101
2021-02-22,MO,Johnson,18,5693,29101
2021-02-23,MO,Johnson,163,5856,29101
2021-02-24,MO,Johnson,445,6301,29101
2021-02-25,MO,Johnson,85,6386,29101
2021-02-26,MO,Johnson,364,6750,29101
2021-02-27,MO,Johnson,129,6879,29101
2021-02-28,MO,Johnson,50,6929,29101
2021-03-01,MO,Johnson,431,7360,29101
2021-03-02,MO,Johnson,462,7822,29101
2021-03-03,MO,Johnson,296,8118,29101
2021-03-04,MO,Johnson,86,8204,29101
2021-03-05,MO,Johnson,88,8292,29101
2021-03-06,MO,Johnson,26,8318,29101
2021-03-07,MO,Johnson,11,8329,29101
2021-03-08,MO,Johnson,61,8390,29101
2021-03-09,MO,Johnson,139,8529,29101
2021-03-10,MO,Johnson,209,8738,29101
2021-03-11,MO,Johnson,173,8911,29101
2021-03-12,MO,Johnson,416,9327,29101
2021-03-13,MO,Johnson,170,9497,29101
2021-03-14,MO,Johnson,31,9528,29101
2021-03-15,MO,Johnson,138,9666,29101
2021-03-16,MO,Johnson,167,9833,29101
2021-03-17,MO,Johnson,765,10598,29101
2021-03-18,MO,Johnson,345,10943,29101
2021-03-19,MO,Johnson,150,11093,29101
2021-03-20,MO,Johnson,60,11153,29101
2021-03-21,MO,Johnson,17,11170,29101
2021-03-22,MO,Johnson,69,11239,29101
2021-03-23,MO,Johnson,81,11320,29101
2021-03-24,MO,Johnson,158,11478,29101
2021-03-25,MO,Johnson,400,11878,29101
2021-03-26,MO,Johnson,263,12141,29101
2021-03-27,MO,Johnson,132,12273,29101
2021-03-28,MO,Johnson,63,12336,29101
2021-03-29,MO,Johnson,471,12807,29101
2021-03-30,MO,Johnson,532,13339,29101
2021-03-31,MO,Johnson,338,13677,29101
2021-04-01,MO,Johnson,379,14056,29101
2021-04-02,MO,Johnson,158,14214,29101
2021-04-03,MO,Johnson,78,14292,29101
2021-04-04,MO,Johnson,8,14300,29101
2021-04-05,MO,Johnson,120,14420,29101
2021-04-06,MO,Johnson,138,14558,29101
2021-04-07,MO,Johnson,146,14704,29101
2021-04-08,MO,Johnson,203,14907,29101
2021-04-09,MO,Johnson,533,15440,29101
2021-04-10,MO,Johnson,177,15617,29101
2021-04-11,MO,Johnson,26,15643,29101
2021-04-12,MO,Johnson,231,15874,29101
2021-04-13,MO,Johnson,131,16005,29101
2021-04-14,MO,Johnson,808,16813,29101
2021-04-15,MO,Johnson,605,17418,29101
2021-04-16,MO,Johnson,203,17621,29101
2021-04-17,MO,Johnson,47,17668,29101
2021-04-18,MO,Johnson,20,17688,29101
2021-04-19,MO,Johnson,73,17761,29101
2021-04-20,MO,Johnson,233,17994,29101
2021-04-21,MO,Johnson,107,18101,29101
2021-04-22,MO,Johnson,318,18419,29101
2021-04-23,MO,Johnson,161,18580,29101
2021-04-24,MO,Johnson,49,18629,29101
2021-04-25,MO,Johnson,6,18635,29101
2020-12-15,MO,Joplin,11,11,29097
2020-12-16,MO,Joplin,53,64,29097
2020-12-17,MO,Joplin,130,194,29097
2020-12-18,MO,Joplin,100,294,29097
2020-12-19,MO,Joplin,12,306,29097
2020-12-20,MO,Joplin,9,315,29097
2020-12-21,MO,Joplin,65,380,29097
2020-12-22,MO,Joplin,131,511,29097
2020-12-23,MO,Joplin,126,637,29097
2020-12-24,MO,Joplin,7,644,29097
2020-12-26,MO,Joplin,2,646,29097
2020-12-28,MO,Joplin,61,707,29097
2020-12-29,MO,Joplin,40,747,29097
2020-12-30,MO,Joplin,329,1076,29097
2020-12-31,MO,Joplin,251,1327,29097
2021-01-01,MO,Joplin,1,1328,29097
2021-01-02,MO,Joplin,6,1334,29097
2021-01-03,MO,Joplin,3,1337,29097
2021-01-04,MO,Joplin,26,1363,29097
2021-01-05,MO,Joplin,54,1417,29097
2021-01-06,MO,Joplin,189,1606,29097
2021-01-07,MO,Joplin,167,1773,29097
2021-01-08,MO,Joplin,195,1968,29097
2021-01-09,MO,Joplin,53,2021,29097
2021-01-10,MO,Joplin,19,2040,29097
2021-01-11,MO,Joplin,162,2202,29097
2021-01-12,MO,Joplin,348,2550,29097
2021-01-13,MO,Joplin,83,2633,29097
2021-01-14,MO,Joplin,81,2714,29097
2021-01-15,MO,Joplin,75,2789,29097
2021-01-16,MO,Joplin,31,2820,29097
2021-01-17,MO,Joplin,3,2823,29097
2021-01-18,MO,Joplin,232,3055,29097
2021-01-19,MO,Joplin,205,3260,29097
2021-01-20,MO,Joplin,420,3680,29097
2021-01-21,MO,Joplin,359,4039,29097
2021-01-22,MO,Joplin,271,4310,29097
2021-01-23,MO,Joplin,35,4345,29097
2021-01-24,MO,Joplin,1,4346,29097
2021-01-25,MO,Joplin,174,4520,29097
2021-01-26,MO,Joplin,351,4871,29097
2021-01-27,MO,Joplin,394,5265,29097
2021-01-28,MO,Joplin,144,5409,29097
2021-01-29,MO,Joplin,551,5960,29097
2021-01-30,MO,Joplin,5,5965,29097
2021-01-31,MO,Joplin,1,5966,29097
2021-02-01,MO,Joplin,132,6098,29097
2021-02-02,MO,Joplin,593,6691,29097
2021-02-03,MO,Joplin,566,7257,29097
2021-02-04,MO,Joplin,443,7700,29097
2021-02-05,MO,Joplin,451,8151,29097
2021-02-06,MO,Joplin,7,8158,29097
2021-02-08,MO,Joplin,268,8426,29097
2021-02-09,MO,Joplin,546,8972,29097
2021-02-10,MO,Joplin,251,9223,29097
2021-02-11,MO,Joplin,771,9994,29097
2021-02-12,MO,Joplin,395,10389,29097
2021-02-13,MO,Joplin,211,10600,29097
2021-02-14,MO,Joplin,60,10660,29097
2021-02-15,MO,Joplin,152,10812,29097
2021-02-16,MO,Joplin,260,11072,29097
2021-02-17,MO,Joplin,177,11249,29097
2021-02-18,MO,Joplin,211,11460,29097
2021-02-19,MO,Joplin,143,11603,29097
2021-02-20,MO,Joplin,47,11650,29097
2021-02-21,MO,Joplin,2,11652,29097
2021-02-22,MO,Joplin,73,11725,29097
2021-02-23,MO,Joplin,683,12408,29097
2021-02-24,MO,Joplin,457,12865,29097
2021-02-25,MO,Joplin,691,13556,29097
2021-02-26,MO,Joplin,629,14185,29097
2021-02-27,MO,Joplin,39,14224,29097
2021-02-28,MO,Joplin,10,14234,29097
2021-03-01,MO,Joplin,284,14518,29097
2021-03-02,MO,Joplin,777,15295,29097
2021-03-03,MO,Joplin,641,15936,29097
2021-03-04,MO,Joplin,475,16411,29097
2021-03-05,MO,Joplin,662,17073,29097
2021-03-06,MO,Joplin,178,17251,29097
2021-03-07,MO,Joplin,27,17278,29097
2021-03-08,MO,Joplin,193,17471,29097
2021-03-09,MO,Joplin,761,18232,29097
2021-03-10,MO,Joplin,309,18541,29097
2021-03-11,MO,Joplin,897,19438,29097
2021-03-12,MO,Joplin,369,19807,29097
2021-03-13,MO,Joplin,209,20016,29097
2021-03-14,MO,Joplin,86,20102,29097
2021-03-15,MO,Joplin,532,20634,29097
2021-03-16,MO,Joplin,569,21203,29097
2021-03-17,MO,Joplin,477,21680,29097
2021-03-18,MO,Joplin,563,22243,29097
2021-03-19,MO,Joplin,387,22630,29097
2021-03-20,MO,Joplin,80,22710,29097
2021-03-21,MO,Joplin,31,22741,29097
2021-03-22,MO,Joplin,105,22846,29097
2021-03-23,MO,Joplin,727,23573,29097
2021-03-24,MO,Joplin,731,24304,29097
2021-03-25,MO,Joplin,678,24982,29097
2021-03-26,MO,Joplin,387,25369,29097
2021-03-27,MO,Joplin,301,25670,29097
2021-03-28,MO,Joplin,46,25716,29097
2021-03-29,MO,Joplin,343,26059,29097
2021-03-30,MO,Joplin,543,26602,29097
2021-03-31,MO,Joplin,411,27013,29097
2021-04-01,MO,Joplin,479,27492,29097
2021-04-02,MO,Joplin,257,27749,29097
2021-04-03,MO,Joplin,133,27882,29097
2021-04-04,MO,Joplin,36,27918,29097
2021-04-05,MO,Joplin,438,28356,29097
2021-04-06,MO,Joplin,902,29258,29097
2021-04-07,MO,Joplin,396,29654,29097
2021-04-08,MO,Joplin,320,29974,29097
2021-04-09,MO,Joplin,847,30821,29097
2021-04-10,MO,Joplin,128,30949,29097
2021-04-11,MO,Joplin,60,31009,29097
2021-04-12,MO,Joplin,313,31322,29097
2021-04-13,MO,Joplin,359,31681,29097
2021-04-14,MO,Joplin,384,32065,29097
2021-04-15,MO,Joplin,513,32578,29097
2021-04-16,MO,Joplin,245,32823,29097
2021-04-17,MO,Joplin,113,32936,29097
2021-04-18,MO,Joplin,32,32968,29097
2021-04-19,MO,Joplin,122,33090,29097
2021-04-20,MO,Joplin,542,33632,29097
2021-04-21,MO,Joplin,258,33890,29097
2021-04-22,MO,Joplin,430,34320,29097
2021-04-23,MO,Joplin,284,34604,29097
2021-04-24,MO,Joplin,67,34671,29097
2021-04-25,MO,Joplin,20,34691,29097
2020-12-13,MO,Kansas City,1,1,29095
2020-12-14,MO,Kansas City,23,24,29095
2020-12-15,MO,Kansas City,57,81,29095
2020-12-16,MO,Kansas City,105,186,29095
2020-12-17,MO,Kansas City,315,501,29095
2020-12-18,MO,Kansas City,203,704,29095
2020-12-19,MO,Kansas City,220,924,29095
2020-12-20,MO,Kansas City,14,938,29095
2020-12-21,MO,Kansas City,766,1704,29095
2020-12-22,MO,Kansas City,1092,2796,29095
2020-12-23,MO,Kansas City,617,3413,29095
2020-12-24,MO,Kansas City,124,3537,29095
2020-12-26,MO,Kansas City,33,3570,29095
2020-12-27,MO,Kansas City,43,3613,29095
2020-12-28,MO,Kansas City,450,4063,29095
2020-12-29,MO,Kansas City,785,4848,29095
2020-12-30,MO,Kansas City,1288,6136,29095
2020-12-31,MO,Kansas City,982,7118,29095
2021-01-01,MO,Kansas City,6,7124,29095
2021-01-02,MO,Kansas City,261,7385,29095
2021-01-03,MO,Kansas City,33,7418,29095
2021-01-04,MO,Kansas City,260,7678,29095
2021-01-05,MO,Kansas City,760,8438,29095
2021-01-06,MO,Kansas City,702,9140,29095
2021-01-07,MO,Kansas City,1661,10801,29095
2021-01-08,MO,Kansas City,1709,12510,29095
2021-01-09,MO,Kansas City,698,13208,29095
2021-01-10,MO,Kansas City,72,13280,29095
2021-01-11,MO,Kansas City,1364,14644,29095
2021-01-12,MO,Kansas City,1703,16347,29095
2021-01-13,MO,Kansas City,1204,17551,29095
2021-01-14,MO,Kansas City,1111,18662,29095
2021-01-15,MO,Kansas City,1265,19927,29095
2021-01-16,MO,Kansas City,187,20114,29095
2021-01-17,MO,Kansas City,8,20122,29095
2021-01-18,MO,Kansas City,593,20715,29095
2021-01-19,MO,Kansas City,1309,22024,29095
2021-01-20,MO,Kansas City,1794,23818,29095
2021-01-21,MO,Kansas City,2502,26320,29095
2021-01-22,MO,Kansas City,2142,28462,29095
2021-01-23,MO,Kansas City,457,28919,29095
2021-01-24,MO,Kansas City,48,28967,29095
2021-01-25,MO,Kansas City,1371,30338,29095
2021-01-26,MO,Kansas City,1952,32290,29095
2021-01-27,MO,Kansas City,1889,34179,29095
2021-01-28,MO,Kansas City,2573,36752,29095
2021-01-29,MO,Kansas City,2343,39095,29095
2021-01-30,MO,Kansas City,704,39799,29095
2021-01-31,MO,Kansas City,231,40030,29095
2021-02-01,MO,Kansas City,1130,41160,29095
2021-02-02,MO,Kansas City,1385,42545,29095
2021-02-03,MO,Kansas City,1894,44439,29095
2021-02-04,MO,Kansas City,2854,47293,29095
2021-02-05,MO,Kansas City,3778,51071,29095
2021-02-06,MO,Kansas City,1213,52284,29095
2021-02-07,MO,Kansas City,221,52505,29095
2021-02-08,MO,Kansas City,1576,54081,29095
2021-02-09,MO,Kansas City,1594,55675,29095
2021-02-10,MO,Kansas City,1620,57295,29095
2021-02-11,MO,Kansas City,2523,59818,29095
2021-02-12,MO,Kansas City,2658,62476,29095
2021-02-13,MO,Kansas City,594,63070,29095
2021-02-14,MO,Kansas City,283,63353,29095
2021-02-15,MO,Kansas City,1441,64794,29095
2021-02-16,MO,Kansas City,1627,66421,29095
2021-02-17,MO,Kansas City,1825,68246,29095
2021-02-18,MO,Kansas City,3223,71469,29095
2021-02-19,MO,Kansas City,2450,73919,29095
2021-02-20,MO,Kansas City,681,74600,29095
2021-02-21,MO,Kansas City,208,74808,29095
2021-02-22,MO,Kansas City,1589,76397,29095
2021-02-23,MO,Kansas City,1702,78099,29095
2021-02-24,MO,Kansas City,2338,80437,29095
2021-02-25,MO,Kansas City,4340,84777,29095
2021-02-26,MO,Kansas City,5250,90027,29095
2021-02-27,MO,Kansas City,1491,91518,29095
2021-02-28,MO,Kansas City,828,92346,29095
2021-03-01,MO,Kansas City,1688,94034,29095
2021-03-02,MO,Kansas City,2855,96889,29095
2021-03-03,MO,Kansas City,3627,100516,29095
2021-03-04,MO,Kansas City,4837,105353,29095
2021-03-05,MO,Kansas City,4753,110106,29095
2021-03-06,MO,Kansas City,2295,112401,29095
2021-03-07,MO,Kansas City,605,113006,29095
2021-03-08,MO,Kansas City,3285,116291,29095
2021-03-09,MO,Kansas City,3053,119344,29095
2021-03-10,MO,Kansas City,3223,122567,29095
2021-03-11,MO,Kansas City,3197,125764,29095
2021-03-12,MO,Kansas City,2902,128666,29095
2021-03-13,MO,Kansas City,1400,130066,29095
2021-03-14,MO,Kansas City,802,130868,29095
2021-03-15,MO,Kansas City,2668,133536,29095
2021-03-16,MO,Kansas City,2914,136450,29095
2021-03-17,MO,Kansas City,3611,140061,29095
2021-03-18,MO,Kansas City,4861,144922,29095
2021-03-19,MO,Kansas City,5666,150588,29095
2021-03-20,MO,Kansas City,2988,153576,29095
2021-03-21,MO,Kansas City,1346,154922,29095
2021-03-22,MO,Kansas City,3855,158777,29095
2021-03-23,MO,Kansas City,4096,162873,29095
2021-03-24,MO,Kansas City,4577,167450,29095
2021-03-25,MO,Kansas City,6022,173472,29095
2021-03-26,MO,Kansas City,6923,180395,29095
2021-03-27,MO,Kansas City,1905,182300,29095
2021-03-28,MO,Kansas City,718,183018,29095
2021-03-29,MO,Kansas City,5453,188471,29095
2021-03-30,MO,Kansas City,5406,193877,29095
2021-03-31,MO,Kansas City,4586,198463,29095
2021-04-01,MO,Kansas City,6461,204924,29095
2021-04-02,MO,Kansas City,5849,210773,29095
2021-04-03,MO,Kansas City,1878,212651,29095
2021-04-04,MO,Kansas City,556,213207,29095
2021-04-05,MO,Kansas City,3930,217137,29095
2021-04-06,MO,Kansas City,4983,222120,29095
2021-04-07,MO,Kansas City,4439,226559,29095
2021-04-08,MO,Kansas City,5825,232384,29095
2021-04-09,MO,Kansas City,6262,238646,29095
2021-04-10,MO,Kansas City,3524,242170,29095
2021-04-11,MO,Kansas City,1033,243203,29095
2021-04-12,MO,Kansas City,3842,247045,29095
2021-04-13,MO,Kansas City,4419,251464,29095
2021-04-14,MO,Kansas City,3887,255351,29095
2021-04-15,MO,Kansas City,4790,260141,29095
2021-04-16,MO,Kansas City,4976,265117,29095
2021-04-17,MO,Kansas City,1120,266237,29095
2021-04-18,MO,Kansas City,598,266835,29095
2021-04-19,MO,Kansas City,2256,269091,29095
2021-04-20,MO,Kansas City,3193,272284,29095
2021-04-21,MO,Kansas City,2595,274879,29095
2021-04-22,MO,Kansas City,3683,278562,29095
2021-04-23,MO,Kansas City,3327,281889,29095
2021-04-24,MO,Kansas City,1170,283059,29095
2021-04-25,MO,Kansas City,94,283153,29095
2020-12-16,MO,Knox,1,1,29103
2020-12-17,MO,Knox,1,2,29103
2020-12-21,MO,Knox,21,23,29103
2020-12-22,MO,Knox,1,24,29103
2020-12-23,MO,Knox,9,33,29103
2020-12-28,MO,Knox,2,35,29103
2020-12-29,MO,Knox,1,36,29103
2020-12-30,MO,Knox,1,37,29103
2021-01-04,MO,Knox,1,38,29103
2021-01-05,MO,Knox,1,39,29103
2021-01-06,MO,Knox,2,41,29103
2021-01-08,MO,Knox,1,42,29103
2021-01-09,MO,Knox,1,43,29103
2021-01-11,MO,Knox,23,66,29103
2021-01-12,MO,Knox,1,67,29103
2021-01-13,MO,Knox,10,77,29103
2021-01-14,MO,Knox,5,82,29103
2021-01-15,MO,Knox,36,118,29103
2021-01-16,MO,Knox,1,119,29103
2021-01-18,MO,Knox,4,123,29103
2021-01-19,MO,Knox,26,149,29103
2021-01-20,MO,Knox,85,234,29103
2021-01-21,MO,Knox,28,262,29103
2021-01-22,MO,Knox,16,278,29103
2021-01-27,MO,Knox,99,377,29103
2021-01-28,MO,Knox,84,461,29103
2021-01-29,MO,Knox,73,534,29103
2021-02-01,MO,Knox,3,537,29103
2021-02-02,MO,Knox,5,542,29103
2021-02-04,MO,Knox,5,547,29103
2021-02-05,MO,Knox,113,660,29103
2021-02-06,MO,Knox,7,667,29103
2021-02-08,MO,Knox,7,674,29103
2021-02-09,MO,Knox,15,689,29103
2021-02-10,MO,Knox,63,752,29103
2021-02-11,MO,Knox,22,774,29103
2021-02-12,MO,Knox,71,845,29103
2021-02-15,MO,Knox,7,852,29103
2021-02-16,MO,Knox,38,890,29103
2021-02-17,MO,Knox,3,893,29103
2021-02-18,MO,Knox,91,984,29103
2021-02-19,MO,Knox,8,992,29103
2021-02-22,MO,Knox,4,996,29103
2021-02-23,MO,Knox,10,1006,29103
2021-02-24,MO,Knox,15,1021,29103
2021-02-25,MO,Knox,178,1199,29103
2021-02-26,MO,Knox,25,1224,29103
2021-02-27,MO,Knox,4,1228,29103
2021-02-28,MO,Knox,3,1231,29103
2021-03-01,MO,Knox,3,1234,29103
2021-03-02,MO,Knox,43,1277,29103
2021-03-03,MO,Knox,9,1286,29103
2021-03-04,MO,Knox,106,1392,29103
2021-03-05,MO,Knox,40,1432,29103
2021-03-06,MO,Knox,7,1439,29103
2021-03-07,MO,Knox,1,1440,29103
2021-03-08,MO,Knox,7,1447,29103
2021-03-09,MO,Knox,6,1453,29103
2021-03-10,MO,Knox,4,1457,29103
2021-03-11,MO,Knox,90,1547,29103
2021-03-12,MO,Knox,25,1572,29103
2021-03-13,MO,Knox,1,1573,29103
2021-03-15,MO,Knox,5,1578,29103
2021-03-16,MO,Knox,17,1595,29103
2021-03-17,MO,Knox,5,1600,29103
2021-03-18,MO,Knox,7,1607,29103
2021-03-19,MO,Knox,23,1630,29103
2021-03-21,MO,Knox,5,1635,29103
2021-03-22,MO,Knox,1,1636,29103
2021-03-23,MO,Knox,51,1687,29103
2021-03-24,MO,Knox,2,1689,29103
2021-03-25,MO,Knox,31,1720,29103
2021-03-26,MO,Knox,24,1744,29103
2021-03-28,MO,Knox,1,1745,29103
2021-03-29,MO,Knox,55,1800,29103
2021-03-30,MO,Knox,7,1807,29103
2021-03-31,MO,Knox,14,1821,29103
2021-04-01,MO,Knox,6,1827,29103
2021-04-02,MO,Knox,8,1835,29103
2021-04-05,MO,Knox,5,1840,29103
2021-04-06,MO,Knox,4,1844,29103
2021-04-07,MO,Knox,1,1845,29103
2021-04-08,MO,Knox,77,1922,29103
2021-04-09,MO,Knox,8,1930,29103
2021-04-10,MO,Knox,6,1936,29103
2021-04-12,MO,Knox,14,1950,29103
2021-04-13,MO,Knox,15,1965,29103
2021-04-14,MO,Knox,6,1971,29103
2021-04-15,MO,Knox,2,1973,29103
2021-04-16,MO,Knox,15,1988,29103
2021-04-17,MO,Knox,1,1989,29103
2021-04-18,MO,Knox,1,1990,29103
2021-04-19,MO,Knox,1,1991,29103
2021-04-20,MO,Knox,6,1997,29103
2021-04-21,MO,Knox,3,2000,29103
2021-04-22,MO,Knox,13,2013,29103
2021-04-23,MO,Knox,3,2016,29103
2021-04-24,MO,Knox,1,2017,29103
2020-12-15,MO,Laclede,15,15,29105
2020-12-16,MO,Laclede,20,35,29105
2020-12-17,MO,Laclede,39,74,29105
2020-12-18,MO,Laclede,16,90,29105
2020-12-19,MO,Laclede,4,94,29105
2020-12-20,MO,Laclede,2,96,29105
2020-12-21,MO,Laclede,39,135,29105
2020-12-22,MO,Laclede,42,177,29105
2020-12-23,MO,Laclede,33,210,29105
2020-12-24,MO,Laclede,1,211,29105
2020-12-27,MO,Laclede,3,214,29105
2020-12-28,MO,Laclede,99,313,29105
2020-12-29,MO,Laclede,24,337,29105
2020-12-30,MO,Laclede,29,366,29105
2020-12-31,MO,Laclede,19,385,29105
2021-01-02,MO,Laclede,91,476,29105
2021-01-03,MO,Laclede,2,478,29105
2021-01-04,MO,Laclede,24,502,29105
2021-01-05,MO,Laclede,27,529,29105
2021-01-06,MO,Laclede,46,575,29105
2021-01-07,MO,Laclede,45,620,29105
2021-01-08,MO,Laclede,73,693,29105
2021-01-09,MO,Laclede,4,697,29105
2021-01-11,MO,Laclede,60,757,29105
2021-01-12,MO,Laclede,41,798,29105
2021-01-13,MO,Laclede,77,875,29105
2021-01-14,MO,Laclede,69,944,29105
2021-01-15,MO,Laclede,37,981,29105
2021-01-16,MO,Laclede,10,991,29105
2021-01-18,MO,Laclede,116,1107,29105
2021-01-19,MO,Laclede,54,1161,29105
2021-01-20,MO,Laclede,140,1301,29105
2021-01-21,MO,Laclede,88,1389,29105
2021-01-22,MO,Laclede,112,1501,29105
2021-01-23,MO,Laclede,10,1511,29105
2021-01-24,MO,Laclede,1,1512,29105
2021-01-25,MO,Laclede,75,1587,29105
2021-01-26,MO,Laclede,38,1625,29105
2021-01-27,MO,Laclede,85,1710,29105
2021-01-28,MO,Laclede,127,1837,29105
2021-01-29,MO,Laclede,164,2001,29105
2021-01-30,MO,Laclede,143,2144,29105
2021-01-31,MO,Laclede,1,2145,29105
2021-02-01,MO,Laclede,27,2172,29105
2021-02-02,MO,Laclede,31,2203,29105
2021-02-03,MO,Laclede,156,2359,29105
2021-02-04,MO,Laclede,51,2410,29105
2021-02-05,MO,Laclede,152,2562,29105
2021-02-06,MO,Laclede,58,2620,29105
2021-02-08,MO,Laclede,72,2692,29105
2021-02-09,MO,Laclede,52,2744,29105
2021-02-10,MO,Laclede,128,2872,29105
2021-02-11,MO,Laclede,229,3101,29105
2021-02-12,MO,Laclede,273,3374,29105
2021-02-13,MO,Laclede,29,3403,29105
2021-02-14,MO,Laclede,9,3412,29105
2021-02-15,MO,Laclede,62,3474,29105
2021-02-16,MO,Laclede,41,3515,29105
2021-02-17,MO,Laclede,50,3565,29105
2021-02-18,MO,Laclede,168,3733,29105
2021-02-19,MO,Laclede,168,3901,29105
2021-02-20,MO,Laclede,44,3945,29105
2021-02-21,MO,Laclede,5,3950,29105
2021-02-22,MO,Laclede,539,4489,29105
2021-02-23,MO,Laclede,569,5058,29105
2021-02-24,MO,Laclede,34,5092,29105
2021-02-25,MO,Laclede,174,5266,29105
2021-02-26,MO,Laclede,188,5454,29105
2021-02-27,MO,Laclede,143,5597,29105
2021-02-28,MO,Laclede,17,5614,29105
2021-03-01,MO,Laclede,80,5694,29105
2021-03-02,MO,Laclede,93,5787,29105
2021-03-03,MO,Laclede,85,5872,29105
2021-03-04,MO,Laclede,326,6198,29105
2021-03-05,MO,Laclede,87,6285,29105
2021-03-06,MO,Laclede,80,6365,29105
2021-03-07,MO,Laclede,102,6467,29105
2021-03-08,MO,Laclede,70,6537,29105
2021-03-09,MO,Laclede,99,6636,29105
2021-03-10,MO,Laclede,251,6887,29105
2021-03-11,MO,Laclede,194,7081,29105
2021-03-12,MO,Laclede,216,7297,29105
2021-03-13,MO,Laclede,15,7312,29105
2021-03-14,MO,Laclede,8,7320,29105
2021-03-15,MO,Laclede,95,7415,29105
2021-03-16,MO,Laclede,174,7589,29105
2021-03-17,MO,Laclede,121,7710,29105
2021-03-18,MO,Laclede,88,7798,29105
2021-03-19,MO,Laclede,347,8145,29105
2021-03-20,MO,Laclede,29,8174,29105
2021-03-21,MO,Laclede,12,8186,29105
2021-03-22,MO,Laclede,674,8860,29105
2021-03-23,MO,Laclede,628,9488,29105
2021-03-24,MO,Laclede,164,9652,29105
2021-03-25,MO,Laclede,298,9950,29105
2021-03-26,MO,Laclede,105,10055,29105
2021-03-27,MO,Laclede,61,10116,29105
2021-03-28,MO,Laclede,19,10135,29105
2021-03-29,MO,Laclede,91,10226,29105
2021-03-30,MO,Laclede,177,10403,29105
2021-03-31,MO,Laclede,151,10554,29105
2021-04-01,MO,Laclede,254,10808,29105
2021-04-02,MO,Laclede,103,10911,29105
2021-04-03,MO,Laclede,29,10940,29105
2021-04-04,MO,Laclede,7,10947,29105
2021-04-05,MO,Laclede,58,11005,29105
2021-04-06,MO,Laclede,221,11226,29105
2021-04-07,MO,Laclede,304,11530,29105
2021-04-08,MO,Laclede,130,11660,29105
2021-04-09,MO,Laclede,245,11905,29105
2021-04-10,MO,Laclede,43,11948,29105
2021-04-11,MO,Laclede,13,11961,29105
2021-04-12,MO,Laclede,198,12159,29105
2021-04-13,MO,Laclede,170,12329,29105
2021-04-14,MO,Laclede,106,12435,29105
2021-04-15,MO,Laclede,101,12536,29105
2021-04-16,MO,Laclede,295,12831,29105
2021-04-17,MO,Laclede,39,12870,29105
2021-04-18,MO,Laclede,12,12882,29105
2021-04-19,MO,Laclede,83,12965,29105
2021-04-20,MO,Laclede,101,13066,29105
2021-04-21,MO,Laclede,112,13178,29105
2021-04-22,MO,Laclede,111,13289,29105
2021-04-23,MO,Laclede,68,13357,29105
2021-04-24,MO,Laclede,34,13391,29105
2021-04-25,MO,Laclede,10,13401,29105
2020-12-15,MO,Lafayette,1,1,29107
2020-12-16,MO,Lafayette,2,3,29107
2020-12-17,MO,Lafayette,8,11,29107
2020-12-18,MO,Lafayette,14,25,29107
2020-12-19,MO,Lafayette,4,29,29107
2020-12-20,MO,Lafayette,3,32,29107
2020-12-21,MO,Lafayette,27,59,29107
2020-12-22,MO,Lafayette,35,94,29107
2020-12-23,MO,Lafayette,37,131,29107
2020-12-24,MO,Lafayette,23,154,29107
2020-12-26,MO,Lafayette,2,156,29107
2020-12-27,MO,Lafayette,2,158,29107
2020-12-28,MO,Lafayette,76,234,29107
2020-12-29,MO,Lafayette,141,375,29107
2020-12-30,MO,Lafayette,38,413,29107
2020-12-31,MO,Lafayette,26,439,29107
2021-01-02,MO,Lafayette,5,444,29107
2021-01-04,MO,Lafayette,11,455,29107
2021-01-05,MO,Lafayette,70,525,29107
2021-01-06,MO,Lafayette,102,627,29107
2021-01-07,MO,Lafayette,53,680,29107
2021-01-08,MO,Lafayette,41,721,29107
2021-01-09,MO,Lafayette,15,736,29107
2021-01-10,MO,Lafayette,4,740,29107
2021-01-11,MO,Lafayette,92,832,29107
2021-01-12,MO,Lafayette,54,886,29107
2021-01-13,MO,Lafayette,34,920,29107
2021-01-14,MO,Lafayette,34,954,29107
2021-01-15,MO,Lafayette,100,1054,29107
2021-01-16,MO,Lafayette,4,1058,29107
2021-01-18,MO,Lafayette,30,1088,29107
2021-01-19,MO,Lafayette,43,1131,29107
2021-01-20,MO,Lafayette,104,1235,29107
2021-01-21,MO,Lafayette,68,1303,29107
2021-01-22,MO,Lafayette,44,1347,29107
2021-01-23,MO,Lafayette,15,1362,29107
2021-01-24,MO,Lafayette,1,1363,29107
2021-01-25,MO,Lafayette,54,1417,29107
2021-01-26,MO,Lafayette,256,1673,29107
2021-01-27,MO,Lafayette,128,1801,29107
2021-01-28,MO,Lafayette,164,1965,29107
2021-01-29,MO,Lafayette,203,2168,29107
2021-01-30,MO,Lafayette,130,2298,29107
2021-01-31,MO,Lafayette,6,2304,29107
2021-02-01,MO,Lafayette,169,2473,29107
2021-02-02,MO,Lafayette,325,2798,29107
2021-02-03,MO,Lafayette,356,3154,29107
2021-02-04,MO,Lafayette,377,3531,29107
2021-02-05,MO,Lafayette,96,3627,29107
2021-02-06,MO,Lafayette,17,3644,29107
2021-02-07,MO,Lafayette,4,3648,29107
2021-02-08,MO,Lafayette,78,3726,29107
2021-02-09,MO,Lafayette,200,3926,29107
2021-02-10,MO,Lafayette,312,4238,29107
2021-02-11,MO,Lafayette,530,4768,29107
2021-02-12,MO,Lafayette,245,5013,29107
2021-02-13,MO,Lafayette,30,5043,29107
2021-02-14,MO,Lafayette,5,5048,29107
2021-02-15,MO,Lafayette,29,5077,29107
2021-02-16,MO,Lafayette,167,5244,29107
2021-02-17,MO,Lafayette,102,5346,29107
2021-02-18,MO,Lafayette,222,5568,29107
2021-02-19,MO,Lafayette,79,5647,29107
2021-02-20,MO,Lafayette,117,5764,29107
2021-02-21,MO,Lafayette,5,5769,29107
2021-02-22,MO,Lafayette,62,5831,29107
2021-02-23,MO,Lafayette,171,6002,29107
2021-02-24,MO,Lafayette,195,6197,29107
2021-02-25,MO,Lafayette,164,6361,29107
2021-02-26,MO,Lafayette,140,6501,29107
2021-02-27,MO,Lafayette,58,6559,29107
2021-02-28,MO,Lafayette,13,6572,29107
2021-03-01,MO,Lafayette,203,6775,29107
2021-03-02,MO,Lafayette,313,7088,29107
2021-03-03,MO,Lafayette,294,7382,29107
2021-03-04,MO,Lafayette,228,7610,29107
2021-03-05,MO,Lafayette,542,8152,29107
2021-03-06,MO,Lafayette,32,8184,29107
2021-03-07,MO,Lafayette,14,8198,29107
2021-03-08,MO,Lafayette,96,8294,29107
2021-03-09,MO,Lafayette,343,8637,29107
2021-03-10,MO,Lafayette,401,9038,29107
2021-03-11,MO,Lafayette,546,9584,29107
2021-03-12,MO,Lafayette,400,9984,29107
2021-03-13,MO,Lafayette,85,10069,29107
2021-03-14,MO,Lafayette,24,10093,29107
2021-03-15,MO,Lafayette,118,10211,29107
2021-03-16,MO,Lafayette,126,10337,29107
2021-03-17,MO,Lafayette,170,10507,29107
2021-03-18,MO,Lafayette,308,10815,29107
2021-03-19,MO,Lafayette,179,10994,29107
2021-03-20,MO,Lafayette,50,11044,29107
2021-03-21,MO,Lafayette,18,11062,29107
2021-03-22,MO,Lafayette,80,11142,29107
2021-03-23,MO,Lafayette,190,11332,29107
2021-03-24,MO,Lafayette,140,11472,29107
2021-03-25,MO,Lafayette,248,11720,29107
2021-03-26,MO,Lafayette,182,11902,29107
2021-03-27,MO,Lafayette,79,11981,29107
2021-03-28,MO,Lafayette,11,11992,29107
2021-03-29,MO,Lafayette,291,12283,29107
2021-03-30,MO,Lafayette,234,12517,29107
2021-03-31,MO,Lafayette,180,12697,29107
2021-04-01,MO,Lafayette,184,12881,29107
2021-04-02,MO,Lafayette,573,13454,29107
2021-04-03,MO,Lafayette,48,13502,29107
2021-04-04,MO,Lafayette,5,13507,29107
2021-04-05,MO,Lafayette,145,13652,29107
2021-04-06,MO,Lafayette,338,13990,29107
2021-04-07,MO,Lafayette,146,14136,29107
2021-04-08,MO,Lafayette,114,14250,29107
2021-04-09,MO,Lafayette,384,14634,29107
2021-04-10,MO,Lafayette,77,14711,29107
2021-04-11,MO,Lafayette,27,14738,29107
2021-04-12,MO,Lafayette,254,14992,29107
2021-04-13,MO,Lafayette,187,15179,29107
2021-04-14,MO,Lafayette,374,15553,29107
2021-04-15,MO,Lafayette,301,15854,29107
2021-04-16,MO,Lafayette,189,16043,29107
2021-04-17,MO,Lafayette,118,16161,29107
2021-04-18,MO,Lafayette,12,16173,29107
2021-04-19,MO,Lafayette,140,16313,29107
2021-04-20,MO,Lafayette,128,16441,29107
2021-04-21,MO,Lafayette,107,16548,29107
2021-04-22,MO,Lafayette,127,16675,29107
2021-04-23,MO,Lafayette,108,16783,29107
2021-04-24,MO,Lafayette,40,16823,29107
2021-04-25,MO,Lafayette,3,16826,29107
2020-12-15,MO,Lawrence,2,2,29109
2020-12-16,MO,Lawrence,7,9,29109
2020-12-17,MO,Lawrence,11,20,29109
2020-12-18,MO,Lawrence,27,47,29109
2020-12-19,MO,Lawrence,2,49,29109
2020-12-20,MO,Lawrence,2,51,29109
2020-12-21,MO,Lawrence,22,73,29109
2020-12-22,MO,Lawrence,36,109,29109
2020-12-23,MO,Lawrence,36,145,29109
2020-12-24,MO,Lawrence,12,157,29109
2020-12-26,MO,Lawrence,5,162,29109
2020-12-27,MO,Lawrence,3,165,29109
2020-12-28,MO,Lawrence,24,189,29109
2020-12-29,MO,Lawrence,39,228,29109
2020-12-30,MO,Lawrence,31,259,29109
2020-12-31,MO,Lawrence,25,284,29109
2021-01-02,MO,Lawrence,1,285,29109
2021-01-03,MO,Lawrence,1,286,29109
2021-01-04,MO,Lawrence,13,299,29109
2021-01-05,MO,Lawrence,45,344,29109
2021-01-06,MO,Lawrence,15,359,29109
2021-01-07,MO,Lawrence,7,366,29109
2021-01-08,MO,Lawrence,34,400,29109
2021-01-09,MO,Lawrence,4,404,29109
2021-01-10,MO,Lawrence,7,411,29109
2021-01-11,MO,Lawrence,55,466,29109
2021-01-12,MO,Lawrence,20,486,29109
2021-01-13,MO,Lawrence,78,564,29109
2021-01-14,MO,Lawrence,39,603,29109
2021-01-15,MO,Lawrence,140,743,29109
2021-01-16,MO,Lawrence,10,753,29109
2021-01-17,MO,Lawrence,5,758,29109
2021-01-18,MO,Lawrence,22,780,29109
2021-01-19,MO,Lawrence,96,876,29109
2021-01-20,MO,Lawrence,83,959,29109
2021-01-21,MO,Lawrence,57,1016,29109
2021-01-22,MO,Lawrence,24,1040,29109
2021-01-23,MO,Lawrence,17,1057,29109
2021-01-24,MO,Lawrence,6,1063,29109
2021-01-25,MO,Lawrence,61,1124,29109
2021-01-26,MO,Lawrence,47,1171,29109
2021-01-27,MO,Lawrence,88,1259,29109
2021-01-28,MO,Lawrence,48,1307,29109
2021-01-29,MO,Lawrence,167,1474,29109
2021-01-30,MO,Lawrence,10,1484,29109
2021-01-31,MO,Lawrence,1,1485,29109
2021-02-01,MO,Lawrence,77,1562,29109
2021-02-02,MO,Lawrence,142,1704,29109
2021-02-03,MO,Lawrence,91,1795,29109
2021-02-04,MO,Lawrence,35,1830,29109
2021-02-05,MO,Lawrence,354,2184,29109
2021-02-06,MO,Lawrence,35,2219,29109
2021-02-07,MO,Lawrence,5,2224,29109
2021-02-08,MO,Lawrence,54,2278,29109
2021-02-09,MO,Lawrence,39,2317,29109
2021-02-10,MO,Lawrence,66,2383,29109
2021-02-11,MO,Lawrence,54,2437,29109
2021-02-12,MO,Lawrence,329,2766,29109
2021-02-13,MO,Lawrence,55,2821,29109
2021-02-14,MO,Lawrence,25,2846,29109
2021-02-15,MO,Lawrence,44,2890,29109
2021-02-16,MO,Lawrence,137,3027,29109
2021-02-17,MO,Lawrence,92,3119,29109
2021-02-18,MO,Lawrence,217,3336,29109
2021-02-19,MO,Lawrence,244,3580,29109
2021-02-20,MO,Lawrence,12,3592,29109
2021-02-21,MO,Lawrence,3,3595,29109
2021-02-22,MO,Lawrence,15,3610,29109
2021-02-23,MO,Lawrence,51,3661,29109
2021-02-24,MO,Lawrence,85,3746,29109
2021-02-25,MO,Lawrence,62,3808,29109
2021-02-26,MO,Lawrence,188,3996,29109
2021-02-27,MO,Lawrence,46,4042,29109
2021-02-28,MO,Lawrence,7,4049,29109
2021-03-01,MO,Lawrence,192,4241,29109
2021-03-02,MO,Lawrence,309,4550,29109
2021-03-03,MO,Lawrence,105,4655,29109
2021-03-04,MO,Lawrence,192,4847,29109
2021-03-05,MO,Lawrence,475,5322,29109
2021-03-06,MO,Lawrence,65,5387,29109
2021-03-07,MO,Lawrence,16,5403,29109
2021-03-08,MO,Lawrence,195,5598,29109
2021-03-09,MO,Lawrence,134,5732,29109
2021-03-10,MO,Lawrence,390,6122,29109
2021-03-11,MO,Lawrence,186,6308,29109
2021-03-12,MO,Lawrence,350,6658,29109
2021-03-13,MO,Lawrence,50,6708,29109
2021-03-14,MO,Lawrence,21,6729,29109
2021-03-15,MO,Lawrence,219,6948,29109
2021-03-16,MO,Lawrence,271,7219,29109
2021-03-17,MO,Lawrence,115,7334,29109
2021-03-18,MO,Lawrence,355,7689,29109
2021-03-19,MO,Lawrence,477,8166,29109
2021-03-20,MO,Lawrence,74,8240,29109
2021-03-21,MO,Lawrence,40,8280,29109
2021-03-22,MO,Lawrence,136,8416,29109
2021-03-23,MO,Lawrence,363,8779,29109
2021-03-24,MO,Lawrence,147,8926,29109
2021-03-25,MO,Lawrence,213,9139,29109
2021-03-26,MO,Lawrence,330,9469,29109
2021-03-27,MO,Lawrence,57,9526,29109
2021-03-28,MO,Lawrence,19,9545,29109
2021-03-29,MO,Lawrence,195,9740,29109
2021-03-30,MO,Lawrence,277,10017,29109
2021-03-31,MO,Lawrence,310,10327,29109
2021-04-01,MO,Lawrence,332,10659,29109
2021-04-02,MO,Lawrence,237,10896,29109
2021-04-03,MO,Lawrence,50,10946,29109
2021-04-04,MO,Lawrence,11,10957,29109
2021-04-05,MO,Lawrence,340,11297,29109
2021-04-06,MO,Lawrence,345,11642,29109
2021-04-07,MO,Lawrence,171,11813,29109
2021-04-08,MO,Lawrence,216,12029,29109
2021-04-09,MO,Lawrence,473,12502,29109
2021-04-10,MO,Lawrence,94,12596,29109
2021-04-11,MO,Lawrence,39,12635,29109
2021-04-12,MO,Lawrence,196,12831,29109
2021-04-13,MO,Lawrence,300,13131,29109
2021-04-14,MO,Lawrence,125,13256,29109
2021-04-15,MO,Lawrence,170,13426,29109
2021-04-16,MO,Lawrence,173,13599,29109
2021-04-17,MO,Lawrence,49,13648,29109
2021-04-18,MO,Lawrence,22,13670,29109
2021-04-19,MO,Lawrence,106,13776,29109
2021-04-20,MO,Lawrence,145,13921,29109
2021-04-21,MO,Lawrence,123,14044,29109
2021-04-22,MO,Lawrence,229,14273,29109
2021-04-23,MO,Lawrence,253,14526,29109
2021-04-24,MO,Lawrence,44,14570,29109
2021-04-25,MO,Lawrence,14,14584,29109
2020-12-14,MO,Lewis,1,1,29111
2020-12-16,MO,Lewis,1,2,29111
2020-12-18,MO,Lewis,1,3,29111
2020-12-19,MO,Lewis,1,4,29111
2020-12-21,MO,Lewis,2,6,29111
2020-12-22,MO,Lewis,2,8,29111
2020-12-23,MO,Lewis,7,15,29111
2020-12-28,MO,Lewis,8,23,29111
2020-12-29,MO,Lewis,12,35,29111
2020-12-30,MO,Lewis,7,42,29111
2020-12-31,MO,Lewis,1,43,29111
2021-01-05,MO,Lewis,8,51,29111
2021-01-06,MO,Lewis,38,89,29111
2021-01-07,MO,Lewis,2,91,29111
2021-01-08,MO,Lewis,1,92,29111
2021-01-09,MO,Lewis,1,93,29111
2021-01-11,MO,Lewis,1,94,29111
2021-01-12,MO,Lewis,7,101,29111
2021-01-13,MO,Lewis,5,106,29111
2021-01-14,MO,Lewis,5,111,29111
2021-01-15,MO,Lewis,2,113,29111
2021-01-16,MO,Lewis,1,114,29111
2021-01-17,MO,Lewis,1,115,29111
2021-01-18,MO,Lewis,37,152,29111
2021-01-19,MO,Lewis,52,204,29111
2021-01-20,MO,Lewis,247,451,29111
2021-01-21,MO,Lewis,81,532,29111
2021-01-22,MO,Lewis,101,633,29111
2021-01-24,MO,Lewis,1,634,29111
2021-01-26,MO,Lewis,2,636,29111
2021-01-27,MO,Lewis,5,641,29111
2021-01-28,MO,Lewis,4,645,29111
2021-01-29,MO,Lewis,136,781,29111
2021-02-01,MO,Lewis,5,786,29111
2021-02-02,MO,Lewis,11,797,29111
2021-02-03,MO,Lewis,53,850,29111
2021-02-04,MO,Lewis,50,900,29111
2021-02-05,MO,Lewis,25,925,29111
2021-02-06,MO,Lewis,2,927,29111
2021-02-08,MO,Lewis,54,981,29111
2021-02-09,MO,Lewis,49,1030,29111
2021-02-10,MO,Lewis,15,1045,29111
2021-02-11,MO,Lewis,40,1085,29111
2021-02-12,MO,Lewis,408,1493,29111
2021-02-13,MO,Lewis,1,1494,29111
2021-02-15,MO,Lewis,160,1654,29111
2021-02-16,MO,Lewis,149,1803,29111
2021-02-17,MO,Lewis,102,1905,29111
2021-02-18,MO,Lewis,9,1914,29111
2021-02-19,MO,Lewis,24,1938,29111
2021-02-21,MO,Lewis,1,1939,29111
2021-02-22,MO,Lewis,6,1945,29111
2021-02-23,MO,Lewis,80,2025,29111
2021-02-24,MO,Lewis,10,2035,29111
2021-02-25,MO,Lewis,21,2056,29111
2021-02-26,MO,Lewis,12,2068,29111
2021-02-27,MO,Lewis,1,2069,29111
2021-03-01,MO,Lewis,12,2081,29111
2021-03-02,MO,Lewis,64,2145,29111
2021-03-03,MO,Lewis,5,2150,29111
2021-03-04,MO,Lewis,60,2210,29111
2021-03-05,MO,Lewis,19,2229,29111
2021-03-06,MO,Lewis,3,2232,29111
2021-03-07,MO,Lewis,1,2233,29111
2021-03-08,MO,Lewis,4,2237,29111
2021-03-09,MO,Lewis,10,2247,29111
2021-03-10,MO,Lewis,22,2269,29111
2021-03-11,MO,Lewis,12,2281,29111
2021-03-12,MO,Lewis,291,2572,29111
2021-03-14,MO,Lewis,1,2573,29111
2021-03-15,MO,Lewis,144,2717,29111
2021-03-16,MO,Lewis,41,2758,29111
2021-03-17,MO,Lewis,8,2766,29111
2021-03-18,MO,Lewis,63,2829,29111
2021-03-19,MO,Lewis,18,2847,29111
2021-03-22,MO,Lewis,9,2856,29111
2021-03-23,MO,Lewis,20,2876,29111
2021-03-24,MO,Lewis,14,2890,29111
2021-03-25,MO,Lewis,18,2908,29111
2021-03-26,MO,Lewis,7,2915,29111
2021-03-27,MO,Lewis,1,2916,29111
2021-03-28,MO,Lewis,2,2918,29111
2021-03-29,MO,Lewis,26,2944,29111
2021-03-30,MO,Lewis,21,2965,29111
2021-03-31,MO,Lewis,6,2971,29111
2021-04-01,MO,Lewis,45,3016,29111
2021-04-02,MO,Lewis,12,3028,29111
2021-04-05,MO,Lewis,6,3034,29111
2021-04-06,MO,Lewis,6,3040,29111
2021-04-07,MO,Lewis,25,3065,29111
2021-04-08,MO,Lewis,24,3089,29111
2021-04-09,MO,Lewis,37,3126,29111
2021-04-10,MO,Lewis,3,3129,29111
2021-04-11,MO,Lewis,1,3130,29111
2021-04-12,MO,Lewis,181,3311,29111
2021-04-13,MO,Lewis,26,3337,29111
2021-04-14,MO,Lewis,26,3363,29111
2021-04-15,MO,Lewis,44,3407,29111
2021-04-16,MO,Lewis,19,3426,29111
2021-04-17,MO,Lewis,1,3427,29111
2021-04-18,MO,Lewis,2,3429,29111
2021-04-19,MO,Lewis,2,3431,29111
2021-04-20,MO,Lewis,14,3445,29111
2021-04-21,MO,Lewis,4,3449,29111
2021-04-22,MO,Lewis,18,3467,29111
2021-04-23,MO,Lewis,5,3472,29111
2020-12-16,MO,Lincoln,8,8,29113
2020-12-17,MO,Lincoln,70,78,29113
2020-12-18,MO,Lincoln,54,132,29113
2020-12-19,MO,Lincoln,11,143,29113
2020-12-21,MO,Lincoln,32,175,29113
2020-12-22,MO,Lincoln,66,241,29113
2020-12-23,MO,Lincoln,37,278,29113
2020-12-24,MO,Lincoln,12,290,29113
2020-12-26,MO,Lincoln,10,300,29113
2020-12-27,MO,Lincoln,10,310,29113
2020-12-28,MO,Lincoln,49,359,29113
2020-12-29,MO,Lincoln,34,393,29113
2020-12-30,MO,Lincoln,41,434,29113
2020-12-31,MO,Lincoln,13,447,29113
2021-01-01,MO,Lincoln,2,449,29113
2021-01-02,MO,Lincoln,1,450,29113
2021-01-03,MO,Lincoln,10,460,29113
2021-01-04,MO,Lincoln,29,489,29113
2021-01-05,MO,Lincoln,43,532,29113
2021-01-06,MO,Lincoln,60,592,29113
2021-01-07,MO,Lincoln,84,676,29113
2021-01-08,MO,Lincoln,79,755,29113
2021-01-09,MO,Lincoln,20,775,29113
2021-01-10,MO,Lincoln,4,779,29113
2021-01-11,MO,Lincoln,107,886,29113
2021-01-12,MO,Lincoln,49,935,29113
2021-01-13,MO,Lincoln,37,972,29113
2021-01-14,MO,Lincoln,41,1013,29113
2021-01-15,MO,Lincoln,155,1168,29113
2021-01-16,MO,Lincoln,48,1216,29113
2021-01-17,MO,Lincoln,4,1220,29113
2021-01-18,MO,Lincoln,117,1337,29113
2021-01-19,MO,Lincoln,74,1411,29113
2021-01-20,MO,Lincoln,139,1550,29113
2021-01-21,MO,Lincoln,188,1738,29113
2021-01-22,MO,Lincoln,168,1906,29113
2021-01-23,MO,Lincoln,25,1931,29113
2021-01-24,MO,Lincoln,5,1936,29113
2021-01-25,MO,Lincoln,103,2039,29113
2021-01-26,MO,Lincoln,182,2221,29113
2021-01-27,MO,Lincoln,101,2322,29113
2021-01-28,MO,Lincoln,98,2420,29113
2021-01-29,MO,Lincoln,229,2649,29113
2021-01-30,MO,Lincoln,34,2683,29113
2021-01-31,MO,Lincoln,10,2693,29113
2021-02-01,MO,Lincoln,100,2793,29113
2021-02-02,MO,Lincoln,102,2895,29113
2021-02-03,MO,Lincoln,77,2972,29113
2021-02-04,MO,Lincoln,108,3080,29113
2021-02-05,MO,Lincoln,90,3170,29113
2021-02-06,MO,Lincoln,36,3206,29113
2021-02-07,MO,Lincoln,5,3211,29113
2021-02-08,MO,Lincoln,150,3361,29113
2021-02-09,MO,Lincoln,124,3485,29113
2021-02-10,MO,Lincoln,75,3560,29113
2021-02-11,MO,Lincoln,79,3639,29113
2021-02-12,MO,Lincoln,254,3893,29113
2021-02-13,MO,Lincoln,74,3967,29113
2021-02-14,MO,Lincoln,16,3983,29113
2021-02-15,MO,Lincoln,89,4072,29113
2021-02-16,MO,Lincoln,86,4158,29113
2021-02-17,MO,Lincoln,231,4389,29113
2021-02-18,MO,Lincoln,208,4597,29113
2021-02-19,MO,Lincoln,196,4793,29113
2021-02-20,MO,Lincoln,71,4864,29113
2021-02-21,MO,Lincoln,16,4880,29113
2021-02-22,MO,Lincoln,208,5088,29113
2021-02-23,MO,Lincoln,265,5353,29113
2021-02-24,MO,Lincoln,127,5480,29113
2021-02-25,MO,Lincoln,374,5854,29113
2021-02-26,MO,Lincoln,403,6257,29113
2021-02-27,MO,Lincoln,72,6329,29113
2021-02-28,MO,Lincoln,30,6359,29113
2021-03-01,MO,Lincoln,219,6578,29113
2021-03-02,MO,Lincoln,176,6754,29113
2021-03-03,MO,Lincoln,74,6828,29113
2021-03-04,MO,Lincoln,125,6953,29113
2021-03-05,MO,Lincoln,439,7392,29113
2021-03-06,MO,Lincoln,57,7449,29113
2021-03-07,MO,Lincoln,24,7473,29113
2021-03-08,MO,Lincoln,201,7674,29113
2021-03-09,MO,Lincoln,166,7840,29113
2021-03-10,MO,Lincoln,410,8250,29113
2021-03-11,MO,Lincoln,167,8417,29113
2021-03-12,MO,Lincoln,163,8580,29113
2021-03-13,MO,Lincoln,80,8660,29113
2021-03-14,MO,Lincoln,25,8685,29113
2021-03-15,MO,Lincoln,195,8880,29113
2021-03-16,MO,Lincoln,148,9028,29113
2021-03-17,MO,Lincoln,612,9640,29113
2021-03-18,MO,Lincoln,318,9958,29113
2021-03-19,MO,Lincoln,404,10362,29113
2021-03-20,MO,Lincoln,119,10481,29113
2021-03-21,MO,Lincoln,47,10528,29113
2021-03-22,MO,Lincoln,203,10731,29113
2021-03-23,MO,Lincoln,207,10938,29113
2021-03-24,MO,Lincoln,379,11317,29113
2021-03-25,MO,Lincoln,441,11758,29113
2021-03-26,MO,Lincoln,496,12254,29113
2021-03-27,MO,Lincoln,105,12359,29113
2021-03-28,MO,Lincoln,42,12401,29113
2021-03-29,MO,Lincoln,242,12643,29113
2021-03-30,MO,Lincoln,226,12869,29113
2021-03-31,MO,Lincoln,515,13384,29113
2021-04-01,MO,Lincoln,310,13694,29113
2021-04-02,MO,Lincoln,477,14171,29113
2021-04-03,MO,Lincoln,97,14268,29113
2021-04-04,MO,Lincoln,16,14284,29113
2021-04-05,MO,Lincoln,281,14565,29113
2021-04-06,MO,Lincoln,227,14792,29113
2021-04-07,MO,Lincoln,525,15317,29113
2021-04-08,MO,Lincoln,541,15858,29113
2021-04-09,MO,Lincoln,477,16335,29113
2021-04-10,MO,Lincoln,149,16484,29113
2021-04-11,MO,Lincoln,43,16527,29113
2021-04-12,MO,Lincoln,382,16909,29113
2021-04-13,MO,Lincoln,204,17113,29113
2021-04-14,MO,Lincoln,771,17884,29113
2021-04-15,MO,Lincoln,262,18146,29113
2021-04-16,MO,Lincoln,830,18976,29113
2021-04-17,MO,Lincoln,172,19148,29113
2021-04-18,MO,Lincoln,59,19207,29113
2021-04-19,MO,Lincoln,305,19512,29113
2021-04-20,MO,Lincoln,255,19767,29113
2021-04-21,MO,Lincoln,179,19946,29113
2021-04-22,MO,Lincoln,239,20185,29113
2021-04-23,MO,Lincoln,177,20362,29113
2021-04-24,MO,Lincoln,125,20487,29113
2021-04-25,MO,Lincoln,16,20503,29113
2020-12-15,MO,Linn,1,1,29115
2020-12-18,MO,Linn,2,3,29115
2020-12-19,MO,Linn,3,6,29115
2020-12-20,MO,Linn,1,7,29115
2020-12-21,MO,Linn,5,12,29115
2020-12-22,MO,Linn,3,15,29115
2020-12-23,MO,Linn,4,19,29115
2020-12-27,MO,Linn,1,20,29115
2020-12-28,MO,Linn,9,29,29115
2020-12-29,MO,Linn,4,33,29115
2020-12-30,MO,Linn,10,43,29115
2020-12-31,MO,Linn,4,47,29115
2021-01-02,MO,Linn,1,48,29115
2021-01-04,MO,Linn,6,54,29115
2021-01-05,MO,Linn,94,148,29115
2021-01-06,MO,Linn,45,193,29115
2021-01-07,MO,Linn,3,196,29115
2021-01-08,MO,Linn,6,202,29115
2021-01-09,MO,Linn,2,204,29115
2021-01-10,MO,Linn,2,206,29115
2021-01-11,MO,Linn,8,214,29115
2021-01-12,MO,Linn,38,252,29115
2021-01-13,MO,Linn,9,261,29115
2021-01-14,MO,Linn,5,266,29115
2021-01-15,MO,Linn,16,282,29115
2021-01-16,MO,Linn,1,283,29115
2021-01-18,MO,Linn,21,304,29115
2021-01-19,MO,Linn,2,306,29115
2021-01-20,MO,Linn,23,329,29115
2021-01-21,MO,Linn,133,462,29115
2021-01-22,MO,Linn,30,492,29115
2021-01-23,MO,Linn,1,493,29115
2021-01-25,MO,Linn,10,503,29115
2021-01-26,MO,Linn,7,510,29115
2021-01-27,MO,Linn,48,558,29115
2021-01-28,MO,Linn,16,574,29115
2021-01-29,MO,Linn,162,736,29115
2021-01-30,MO,Linn,478,1214,29115
2021-01-31,MO,Linn,4,1218,29115
2021-02-01,MO,Linn,173,1391,29115
2021-02-02,MO,Linn,233,1624,29115
2021-02-03,MO,Linn,128,1752,29115
2021-02-04,MO,Linn,77,1829,29115
2021-02-05,MO,Linn,35,1864,29115
2021-02-06,MO,Linn,10,1874,29115
2021-02-08,MO,Linn,4,1878,29115
2021-02-09,MO,Linn,144,2022,29115
2021-02-10,MO,Linn,92,2114,29115
2021-02-11,MO,Linn,155,2269,29115
2021-02-12,MO,Linn,95,2364,29115
2021-02-13,MO,Linn,23,2387,29115
2021-02-14,MO,Linn,4,2391,29115
2021-02-15,MO,Linn,29,2420,29115
2021-02-16,MO,Linn,42,2462,29115
2021-02-17,MO,Linn,20,2482,29115
2021-02-18,MO,Linn,32,2514,29115
2021-02-19,MO,Linn,157,2671,29115
2021-02-20,MO,Linn,484,3155,29115
2021-02-22,MO,Linn,151,3306,29115
2021-02-23,MO,Linn,172,3478,29115
2021-02-24,MO,Linn,136,3614,29115
2021-02-25,MO,Linn,47,3661,29115
2021-02-26,MO,Linn,37,3698,29115
2021-02-27,MO,Linn,20,3718,29115
2021-02-28,MO,Linn,1,3719,29115
2021-03-01,MO,Linn,56,3775,29115
2021-03-02,MO,Linn,87,3862,29115
2021-03-03,MO,Linn,59,3921,29115
2021-03-04,MO,Linn,50,3971,29115
2021-03-05,MO,Linn,24,3995,29115
2021-03-06,MO,Linn,9,4004,29115
2021-03-07,MO,Linn,1,4005,29115
2021-03-08,MO,Linn,18,4023,29115
2021-03-09,MO,Linn,174,4197,29115
2021-03-10,MO,Linn,50,4247,29115
2021-03-11,MO,Linn,116,4363,29115
2021-03-12,MO,Linn,185,4548,29115
2021-03-13,MO,Linn,12,4560,29115
2021-03-14,MO,Linn,3,4563,29115
2021-03-15,MO,Linn,31,4594,29115
2021-03-16,MO,Linn,92,4686,29115
2021-03-17,MO,Linn,94,4780,29115
2021-03-18,MO,Linn,74,4854,29115
2021-03-19,MO,Linn,88,4942,29115
2021-03-20,MO,Linn,22,4964,29115
2021-03-21,MO,Linn,4,4968,29115
2021-03-22,MO,Linn,21,4989,29115
2021-03-23,MO,Linn,57,5046,29115
2021-03-24,MO,Linn,65,5111,29115
2021-03-25,MO,Linn,61,5172,29115
2021-03-26,MO,Linn,61,5233,29115
2021-03-27,MO,Linn,13,5246,29115
2021-03-28,MO,Linn,3,5249,29115
2021-03-29,MO,Linn,114,5363,29115
2021-03-30,MO,Linn,59,5422,29115
2021-03-31,MO,Linn,77,5499,29115
2021-04-01,MO,Linn,30,5529,29115
2021-04-02,MO,Linn,50,5579,29115
2021-04-03,MO,Linn,13,5592,29115
2021-04-04,MO,Linn,1,5593,29115
2021-04-05,MO,Linn,22,5615,29115
2021-04-06,MO,Linn,73,5688,29115
2021-04-07,MO,Linn,68,5756,29115
2021-04-08,MO,Linn,35,5791,29115
2021-04-09,MO,Linn,157,5948,29115
2021-04-10,MO,Linn,14,5962,29115
2021-04-11,MO,Linn,9,5971,29115
2021-04-12,MO,Linn,62,6033,29115
2021-04-13,MO,Linn,41,6074,29115
2021-04-14,MO,Linn,89,6163,29115
2021-04-15,MO,Linn,95,6258,29115
2021-04-16,MO,Linn,65,6323,29115
2021-04-17,MO,Linn,8,6331,29115
2021-04-18,MO,Linn,6,6337,29115
2021-04-19,MO,Linn,19,6356,29115
2021-04-20,MO,Linn,22,6378,29115
2021-04-21,MO,Linn,82,6460,29115
2021-04-22,MO,Linn,19,6479,29115
2021-04-23,MO,Linn,20,6499,29115
2021-04-24,MO,Linn,12,6511,29115
2020-12-17,MO,Livingston,4,4,29117
2020-12-18,MO,Livingston,5,9,29117
2020-12-22,MO,Livingston,2,11,29117
2020-12-23,MO,Livingston,4,15,29117
2020-12-28,MO,Livingston,24,39,29117
2020-12-29,MO,Livingston,16,55,29117
2020-12-30,MO,Livingston,29,84,29117
2020-12-31,MO,Livingston,25,109,29117
2021-01-02,MO,Livingston,3,112,29117
2021-01-03,MO,Livingston,2,114,29117
2021-01-04,MO,Livingston,13,127,29117
2021-01-05,MO,Livingston,6,133,29117
2021-01-06,MO,Livingston,23,156,29117
2021-01-07,MO,Livingston,3,159,29117
2021-01-08,MO,Livingston,53,212,29117
2021-01-09,MO,Livingston,57,269,29117
2021-01-10,MO,Livingston,1,270,29117
2021-01-11,MO,Livingston,23,293,29117
2021-01-12,MO,Livingston,25,318,29117
2021-01-13,MO,Livingston,85,403,29117
2021-01-14,MO,Livingston,12,415,29117
2021-01-15,MO,Livingston,97,512,29117
2021-01-16,MO,Livingston,7,519,29117
2021-01-18,MO,Livingston,48,567,29117
2021-01-19,MO,Livingston,38,605,29117
2021-01-20,MO,Livingston,56,661,29117
2021-01-21,MO,Livingston,13,674,29117
2021-01-22,MO,Livingston,52,726,29117
2021-01-25,MO,Livingston,40,766,29117
2021-01-26,MO,Livingston,7,773,29117
2021-01-27,MO,Livingston,37,810,29117
2021-01-28,MO,Livingston,28,838,29117
2021-01-29,MO,Livingston,70,908,29117
2021-01-30,MO,Livingston,5,913,29117
2021-01-31,MO,Livingston,6,919,29117
2021-02-01,MO,Livingston,86,1005,29117
2021-02-02,MO,Livingston,263,1268,29117
2021-02-03,MO,Livingston,50,1318,29117
2021-02-04,MO,Livingston,329,1647,29117
2021-02-05,MO,Livingston,239,1886,29117
2021-02-06,MO,Livingston,2,1888,29117
2021-02-07,MO,Livingston,1,1889,29117
2021-02-08,MO,Livingston,111,2000,29117
2021-02-09,MO,Livingston,146,2146,29117
2021-02-10,MO,Livingston,28,2174,29117
2021-02-11,MO,Livingston,75,2249,29117
2021-02-12,MO,Livingston,120,2369,29117
2021-02-13,MO,Livingston,94,2463,29117
2021-02-14,MO,Livingston,9,2472,29117
2021-02-15,MO,Livingston,11,2483,29117
2021-02-16,MO,Livingston,19,2502,29117
2021-02-17,MO,Livingston,66,2568,29117
2021-02-18,MO,Livingston,223,2791,29117
2021-02-19,MO,Livingston,30,2821,29117
2021-02-20,MO,Livingston,7,2828,29117
2021-02-21,MO,Livingston,5,2833,29117
2021-02-22,MO,Livingston,67,2900,29117
2021-02-23,MO,Livingston,255,3155,29117
2021-02-24,MO,Livingston,107,3262,29117
2021-02-25,MO,Livingston,363,3625,29117
2021-02-26,MO,Livingston,274,3899,29117
2021-02-27,MO,Livingston,31,3930,29117
2021-02-28,MO,Livingston,1,3931,29117
2021-03-01,MO,Livingston,33,3964,29117
2021-03-02,MO,Livingston,134,4098,29117
2021-03-03,MO,Livingston,198,4296,29117
2021-03-04,MO,Livingston,116,4412,29117
2021-03-05,MO,Livingston,165,4577,29117
2021-03-06,MO,Livingston,27,4604,29117
2021-03-07,MO,Livingston,2,4606,29117
2021-03-08,MO,Livingston,92,4698,29117
2021-03-09,MO,Livingston,207,4905,29117
2021-03-10,MO,Livingston,26,4931,29117
2021-03-11,MO,Livingston,56,4987,29117
2021-03-12,MO,Livingston,124,5111,29117
2021-03-13,MO,Livingston,15,5126,29117
2021-03-14,MO,Livingston,6,5132,29117
2021-03-15,MO,Livingston,62,5194,29117
2021-03-16,MO,Livingston,155,5349,29117
2021-03-17,MO,Livingston,107,5456,29117
2021-03-18,MO,Livingston,274,5730,29117
2021-03-19,MO,Livingston,141,5871,29117
2021-03-20,MO,Livingston,26,5897,29117
2021-03-21,MO,Livingston,3,5900,29117
2021-03-22,MO,Livingston,55,5955,29117
2021-03-23,MO,Livingston,101,6056,29117
2021-03-24,MO,Livingston,164,6220,29117
2021-03-25,MO,Livingston,92,6312,29117
2021-03-26,MO,Livingston,90,6402,29117
2021-03-27,MO,Livingston,35,6437,29117
2021-03-28,MO,Livingston,4,6441,29117
2021-03-29,MO,Livingston,54,6495,29117
2021-03-30,MO,Livingston,236,6731,29117
2021-03-31,MO,Livingston,30,6761,29117
2021-04-01,MO,Livingston,52,6813,29117
2021-04-02,MO,Livingston,62,6875,29117
2021-04-03,MO,Livingston,14,6889,29117
2021-04-04,MO,Livingston,3,6892,29117
2021-04-05,MO,Livingston,79,6971,29117
2021-04-06,MO,Livingston,73,7044,29117
2021-04-07,MO,Livingston,40,7084,29117
2021-04-08,MO,Livingston,34,7118,29117
2021-04-09,MO,Livingston,137,7255,29117
2021-04-10,MO,Livingston,7,7262,29117
2021-04-11,MO,Livingston,3,7265,29117
2021-04-12,MO,Livingston,96,7361,29117
2021-04-13,MO,Livingston,46,7407,29117
2021-04-14,MO,Livingston,30,7437,29117
2021-04-15,MO,Livingston,56,7493,29117
2021-04-16,MO,Livingston,79,7572,29117
2021-04-17,MO,Livingston,11,7583,29117
2021-04-18,MO,Livingston,1,7584,29117
2021-04-19,MO,Livingston,24,7608,29117
2021-04-20,MO,Livingston,98,7706,29117
2021-04-21,MO,Livingston,19,7725,29117
2021-04-22,MO,Livingston,315,8040,29117
2021-04-23,MO,Livingston,68,8108,29117
2021-04-24,MO,Livingston,26,8134,29117
2021-04-25,MO,Livingston,1,8135,29117
2020-12-18,MO,Macon,5,5,29121
2020-12-19,MO,Macon,1,6,29121
2020-12-21,MO,Macon,29,35,29121
2020-12-22,MO,Macon,5,40,29121
2020-12-23,MO,Macon,25,65,29121
2020-12-28,MO,Macon,5,70,29121
2020-12-29,MO,Macon,8,78,29121
2020-12-30,MO,Macon,7,85,29121
2020-12-31,MO,Macon,1,86,29121
2021-01-02,MO,Macon,1,87,29121
2021-01-03,MO,Macon,1,88,29121
2021-01-04,MO,Macon,44,132,29121
2021-01-05,MO,Macon,11,143,29121
2021-01-06,MO,Macon,7,150,29121
2021-01-07,MO,Macon,2,152,29121
2021-01-08,MO,Macon,46,198,29121
2021-01-09,MO,Macon,28,226,29121
2021-01-10,MO,Macon,5,231,29121
2021-01-11,MO,Macon,43,274,29121
2021-01-12,MO,Macon,9,283,29121
2021-01-13,MO,Macon,26,309,29121
2021-01-14,MO,Macon,19,328,29121
2021-01-15,MO,Macon,8,336,29121
2021-01-16,MO,Macon,1,337,29121
2021-01-18,MO,Macon,105,442,29121
2021-01-19,MO,Macon,12,454,29121
2021-01-20,MO,Macon,28,482,29121
2021-01-21,MO,Macon,49,531,29121
2021-01-22,MO,Macon,18,549,29121
2021-01-23,MO,Macon,4,553,29121
2021-01-24,MO,Macon,1,554,29121
2021-01-25,MO,Macon,106,660,29121
2021-01-26,MO,Macon,14,674,29121
2021-01-27,MO,Macon,45,719,29121
2021-01-28,MO,Macon,128,847,29121
2021-01-29,MO,Macon,45,892,29121
2021-01-30,MO,Macon,2,894,29121
2021-02-01,MO,Macon,33,927,29121
2021-02-02,MO,Macon,103,1030,29121
2021-02-03,MO,Macon,12,1042,29121
2021-02-04,MO,Macon,373,1415,29121
2021-02-05,MO,Macon,70,1485,29121
2021-02-06,MO,Macon,39,1524,29121
2021-02-08,MO,Macon,22,1546,29121
2021-02-09,MO,Macon,126,1672,29121
2021-02-10,MO,Macon,43,1715,29121
2021-02-11,MO,Macon,111,1826,29121
2021-02-12,MO,Macon,83,1909,29121
2021-02-13,MO,Macon,21,1930,29121
2021-02-14,MO,Macon,7,1937,29121
2021-02-15,MO,Macon,129,2066,29121
2021-02-16,MO,Macon,49,2115,29121
2021-02-17,MO,Macon,20,2135,29121
2021-02-18,MO,Macon,133,2268,29121
2021-02-19,MO,Macon,32,2300,29121
2021-02-20,MO,Macon,4,2304,29121
2021-02-22,MO,Macon,101,2405,29121
2021-02-23,MO,Macon,18,2423,29121
2021-02-24,MO,Macon,312,2735,29121
2021-02-25,MO,Macon,510,3245,29121
2021-02-26,MO,Macon,22,3267,29121
2021-02-27,MO,Macon,8,3275,29121
2021-02-28,MO,Macon,2,3277,29121
2021-03-01,MO,Macon,33,3310,29121
2021-03-02,MO,Macon,128,3438,29121
2021-03-03,MO,Macon,96,3534,29121
2021-03-04,MO,Macon,271,3805,29121
2021-03-05,MO,Macon,34,3839,29121
2021-03-06,MO,Macon,19,3858,29121
2021-03-07,MO,Macon,1,3859,29121
2021-03-08,MO,Macon,27,3886,29121
2021-03-09,MO,Macon,140,4026,29121
2021-03-10,MO,Macon,47,4073,29121
2021-03-11,MO,Macon,164,4237,29121
2021-03-12,MO,Macon,56,4293,29121
2021-03-13,MO,Macon,19,4312,29121
2021-03-14,MO,Macon,7,4319,29121
2021-03-15,MO,Macon,54,4373,29121
2021-03-16,MO,Macon,83,4456,29121
2021-03-17,MO,Macon,84,4540,29121
2021-03-18,MO,Macon,189,4729,29121
2021-03-19,MO,Macon,53,4782,29121
2021-03-20,MO,Macon,12,4794,29121
2021-03-21,MO,Macon,4,4798,29121
2021-03-22,MO,Macon,15,4813,29121
2021-03-23,MO,Macon,25,4838,29121
2021-03-24,MO,Macon,42,4880,29121
2021-03-25,MO,Macon,447,5327,29121
2021-03-26,MO,Macon,38,5365,29121
2021-03-27,MO,Macon,11,5376,29121
2021-03-28,MO,Macon,2,5378,29121
2021-03-29,MO,Macon,40,5418,29121
2021-03-30,MO,Macon,54,5472,29121
2021-03-31,MO,Macon,139,5611,29121
2021-04-01,MO,Macon,303,5914,29121
2021-04-02,MO,Macon,47,5961,29121
2021-04-03,MO,Macon,8,5969,29121
2021-04-04,MO,Macon,2,5971,29121
2021-04-05,MO,Macon,39,6010,29121
2021-04-06,MO,Macon,80,6090,29121
2021-04-07,MO,Macon,76,6166,29121
2021-04-08,MO,Macon,144,6310,29121
2021-04-09,MO,Macon,89,6399,29121
2021-04-10,MO,Macon,16,6415,29121
2021-04-11,MO,Macon,6,6421,29121
2021-04-12,MO,Macon,31,6452,29121
2021-04-13,MO,Macon,50,6502,29121
2021-04-14,MO,Macon,103,6605,29121
2021-04-15,MO,Macon,146,6751,29121
2021-04-16,MO,Macon,48,6799,29121
2021-04-17,MO,Macon,13,6812,29121
2021-04-18,MO,Macon,3,6815,29121
2021-04-19,MO,Macon,14,6829,29121
2021-04-20,MO,Macon,36,6865,29121
2021-04-21,MO,Macon,37,6902,29121
2021-04-22,MO,Macon,61,6963,29121
2021-04-23,MO,Macon,34,6997,29121
2021-04-24,MO,Macon,7,7004,29121
2020-12-15,MO,Madison,1,1,29123
2020-12-17,MO,Madison,3,4,29123
2020-12-18,MO,Madison,5,9,29123
2020-12-19,MO,Madison,2,11,29123
2020-12-20,MO,Madison,1,12,29123
2020-12-21,MO,Madison,6,18,29123
2020-12-22,MO,Madison,7,25,29123
2020-12-23,MO,Madison,52,77,29123
2020-12-28,MO,Madison,4,81,29123
2020-12-29,MO,Madison,4,85,29123
2020-12-30,MO,Madison,17,102,29123
2020-12-31,MO,Madison,49,151,29123
2021-01-02,MO,Madison,3,154,29123
2021-01-04,MO,Madison,16,170,29123
2021-01-05,MO,Madison,6,176,29123
2021-01-06,MO,Madison,10,186,29123
2021-01-07,MO,Madison,8,194,29123
2021-01-08,MO,Madison,9,203,29123
2021-01-09,MO,Madison,7,210,29123
2021-01-11,MO,Madison,11,221,29123
2021-01-12,MO,Madison,8,229,29123
2021-01-13,MO,Madison,144,373,29123
2021-01-14,MO,Madison,15,388,29123
2021-01-15,MO,Madison,9,397,29123
2021-01-16,MO,Madison,1,398,29123
2021-01-17,MO,Madison,1,399,29123
2021-01-18,MO,Madison,11,410,29123
2021-01-19,MO,Madison,41,451,29123
2021-01-20,MO,Madison,74,525,29123
2021-01-21,MO,Madison,46,571,29123
2021-01-22,MO,Madison,50,621,29123
2021-01-23,MO,Madison,7,628,29123
2021-01-24,MO,Madison,1,629,29123
2021-01-25,MO,Madison,41,670,29123
2021-01-26,MO,Madison,20,690,29123
2021-01-27,MO,Madison,11,701,29123
2021-01-28,MO,Madison,86,787,29123
2021-01-29,MO,Madison,100,887,29123
2021-01-30,MO,Madison,12,899,29123
2021-02-01,MO,Madison,25,924,29123
2021-02-02,MO,Madison,39,963,29123
2021-02-03,MO,Madison,96,1059,29123
2021-02-04,MO,Madison,120,1179,29123
2021-02-05,MO,Madison,47,1226,29123
2021-02-06,MO,Madison,8,1234,29123
2021-02-08,MO,Madison,59,1293,29123
2021-02-09,MO,Madison,49,1342,29123
2021-02-10,MO,Madison,164,1506,29123
2021-02-11,MO,Madison,20,1526,29123
2021-02-12,MO,Madison,52,1578,29123
2021-02-13,MO,Madison,16,1594,29123
2021-02-14,MO,Madison,7,1601,29123
2021-02-15,MO,Madison,11,1612,29123
2021-02-16,MO,Madison,14,1626,29123
2021-02-17,MO,Madison,34,1660,29123
2021-02-18,MO,Madison,19,1679,29123
2021-02-19,MO,Madison,111,1790,29123
2021-02-20,MO,Madison,9,1799,29123
2021-02-21,MO,Madison,1,1800,29123
2021-02-22,MO,Madison,33,1833,29123
2021-02-23,MO,Madison,22,1855,29123
2021-02-24,MO,Madison,89,1944,29123
2021-02-25,MO,Madison,74,2018,29123
2021-02-26,MO,Madison,99,2117,29123
2021-02-27,MO,Madison,27,2144,29123
2021-02-28,MO,Madison,3,2147,29123
2021-03-01,MO,Madison,21,2168,29123
2021-03-02,MO,Madison,45,2213,29123
2021-03-03,MO,Madison,107,2320,29123
2021-03-04,MO,Madison,138,2458,29123
2021-03-05,MO,Madison,214,2672,29123
2021-03-06,MO,Madison,4,2676,29123
2021-03-08,MO,Madison,15,2691,29123
2021-03-09,MO,Madison,62,2753,29123
2021-03-10,MO,Madison,87,2840,29123
2021-03-11,MO,Madison,34,2874,29123
2021-03-12,MO,Madison,51,2925,29123
2021-03-13,MO,Madison,23,2948,29123
2021-03-14,MO,Madison,11,2959,29123
2021-03-15,MO,Madison,32,2991,29123
2021-03-16,MO,Madison,55,3046,29123
2021-03-17,MO,Madison,129,3175,29123
2021-03-18,MO,Madison,73,3248,29123
2021-03-19,MO,Madison,38,3286,29123
2021-03-20,MO,Madison,8,3294,29123
2021-03-21,MO,Madison,1,3295,29123
2021-03-22,MO,Madison,34,3329,29123
2021-03-23,MO,Madison,27,3356,29123
2021-03-24,MO,Madison,58,3414,29123
2021-03-25,MO,Madison,65,3479,29123
2021-03-26,MO,Madison,34,3513,29123
2021-03-27,MO,Madison,19,3532,29123
2021-03-28,MO,Madison,2,3534,29123
2021-03-29,MO,Madison,23,3557,29123
2021-03-30,MO,Madison,49,3606,29123
2021-03-31,MO,Madison,67,3673,29123
2021-04-01,MO,Madison,96,3769,29123
2021-04-02,MO,Madison,184,3953,29123
2021-04-03,MO,Madison,5,3958,29123
2021-04-05,MO,Madison,22,3980,29123
2021-04-06,MO,Madison,53,4033,29123
2021-04-07,MO,Madison,66,4099,29123
2021-04-08,MO,Madison,59,4158,29123
2021-04-09,MO,Madison,53,4211,29123
2021-04-10,MO,Madison,28,4239,29123
2021-04-11,MO,Madison,3,4242,29123
2021-04-12,MO,Madison,15,4257,29123
2021-04-13,MO,Madison,41,4298,29123
2021-04-14,MO,Madison,109,4407,29123
2021-04-15,MO,Madison,51,4458,29123
2021-04-16,MO,Madison,64,4522,29123
2021-04-17,MO,Madison,15,4537,29123
2021-04-18,MO,Madison,5,4542,29123
2021-04-19,MO,Madison,36,4578,29123
2021-04-20,MO,Madison,17,4595,29123
2021-04-21,MO,Madison,62,4657,29123
2021-04-22,MO,Madison,57,4714,29123
2021-04-23,MO,Madison,51,4765,29123
2021-04-24,MO,Madison,14,4779,29123
2020-12-15,MO,Maries,2,2,29125
2020-12-16,MO,Maries,3,5,29125
2020-12-17,MO,Maries,3,8,29125
2020-12-18,MO,Maries,8,16,29125
2020-12-19,MO,Maries,1,17,29125
2020-12-20,MO,Maries,2,19,29125
2020-12-21,MO,Maries,4,23,29125
2020-12-22,MO,Maries,2,25,29125
2020-12-23,MO,Maries,2,27,29125
2020-12-26,MO,Maries,1,28,29125
2020-12-28,MO,Maries,2,30,29125
2020-12-29,MO,Maries,3,33,29125
2020-12-30,MO,Maries,10,43,29125
2020-12-31,MO,Maries,5,48,29125
2021-01-01,MO,Maries,3,51,29125
2021-01-02,MO,Maries,2,53,29125
2021-01-03,MO,Maries,1,54,29125
2021-01-04,MO,Maries,6,60,29125
2021-01-05,MO,Maries,6,66,29125
2021-01-06,MO,Maries,11,77,29125
2021-01-07,MO,Maries,17,94,29125
2021-01-08,MO,Maries,20,114,29125
2021-01-09,MO,Maries,1,115,29125
2021-01-10,MO,Maries,2,117,29125
2021-01-11,MO,Maries,12,129,29125
2021-01-12,MO,Maries,19,148,29125
2021-01-13,MO,Maries,20,168,29125
2021-01-14,MO,Maries,12,180,29125
2021-01-15,MO,Maries,9,189,29125
2021-01-16,MO,Maries,4,193,29125
2021-01-18,MO,Maries,60,253,29125
2021-01-19,MO,Maries,10,263,29125
2021-01-20,MO,Maries,11,274,29125
2021-01-21,MO,Maries,17,291,29125
2021-01-22,MO,Maries,40,331,29125
2021-01-23,MO,Maries,40,371,29125
2021-01-24,MO,Maries,3,374,29125
2021-01-25,MO,Maries,24,398,29125
2021-01-26,MO,Maries,24,422,29125
2021-01-27,MO,Maries,21,443,29125
2021-01-28,MO,Maries,20,463,29125
2021-01-29,MO,Maries,91,554,29125
2021-01-30,MO,Maries,131,685,29125
2021-01-31,MO,Maries,2,687,29125
2021-02-01,MO,Maries,21,708,29125
2021-02-02,MO,Maries,14,722,29125
2021-02-03,MO,Maries,23,745,29125
2021-02-04,MO,Maries,62,807,29125
2021-02-05,MO,Maries,45,852,29125
2021-02-06,MO,Maries,25,877,29125
2021-02-08,MO,Maries,170,1047,29125
2021-02-09,MO,Maries,25,1072,29125
2021-02-10,MO,Maries,48,1120,29125
2021-02-11,MO,Maries,37,1157,29125
2021-02-12,MO,Maries,63,1220,29125
2021-02-13,MO,Maries,52,1272,29125
2021-02-15,MO,Maries,25,1297,29125
2021-02-16,MO,Maries,18,1315,29125
2021-02-17,MO,Maries,55,1370,29125
2021-02-18,MO,Maries,30,1400,29125
2021-02-19,MO,Maries,54,1454,29125
2021-02-20,MO,Maries,7,1461,29125
2021-02-22,MO,Maries,33,1494,29125
2021-02-23,MO,Maries,13,1507,29125
2021-02-24,MO,Maries,20,1527,29125
2021-02-25,MO,Maries,25,1552,29125
2021-02-26,MO,Maries,101,1653,29125
2021-02-27,MO,Maries,129,1782,29125
2021-02-28,MO,Maries,6,1788,29125
2021-03-01,MO,Maries,52,1840,29125
2021-03-02,MO,Maries,22,1862,29125
2021-03-03,MO,Maries,36,1898,29125
2021-03-04,MO,Maries,144,2042,29125
2021-03-05,MO,Maries,124,2166,29125
2021-03-06,MO,Maries,22,2188,29125
2021-03-07,MO,Maries,1,2189,29125
2021-03-08,MO,Maries,30,2219,29125
2021-03-09,MO,Maries,28,2247,29125
2021-03-10,MO,Maries,48,2295,29125
2021-03-11,MO,Maries,26,2321,29125
2021-03-12,MO,Maries,60,2381,29125
2021-03-13,MO,Maries,1,2382,29125
2021-03-14,MO,Maries,2,2384,29125
2021-03-15,MO,Maries,26,2410,29125
2021-03-16,MO,Maries,41,2451,29125
2021-03-17,MO,Maries,19,2470,29125
2021-03-18,MO,Maries,11,2481,29125
2021-03-19,MO,Maries,81,2562,29125
2021-03-20,MO,Maries,6,2568,29125
2021-03-22,MO,Maries,32,2600,29125
2021-03-23,MO,Maries,13,2613,29125
2021-03-24,MO,Maries,19,2632,29125
2021-03-25,MO,Maries,32,2664,29125
2021-03-26,MO,Maries,24,2688,29125
2021-03-27,MO,Maries,131,2819,29125
2021-03-29,MO,Maries,46,2865,29125
2021-03-30,MO,Maries,27,2892,29125
2021-03-31,MO,Maries,22,2914,29125
2021-04-01,MO,Maries,58,2972,29125
2021-04-02,MO,Maries,127,3099,29125
2021-04-03,MO,Maries,7,3106,29125
2021-04-04,MO,Maries,2,3108,29125
2021-04-05,MO,Maries,36,3144,29125
2021-04-06,MO,Maries,23,3167,29125
2021-04-07,MO,Maries,30,3197,29125
2021-04-08,MO,Maries,26,3223,29125
2021-04-09,MO,Maries,157,3380,29125
2021-04-10,MO,Maries,10,3390,29125
2021-04-11,MO,Maries,1,3391,29125
2021-04-12,MO,Maries,28,3419,29125
2021-04-13,MO,Maries,42,3461,29125
2021-04-14,MO,Maries,25,3486,29125
2021-04-15,MO,Maries,33,3519,29125
2021-04-16,MO,Maries,23,3542,29125
2021-04-17,MO,Maries,45,3587,29125
2021-04-19,MO,Maries,28,3615,29125
2021-04-20,MO,Maries,22,3637,29125
2021-04-21,MO,Maries,10,3647,29125
2021-04-22,MO,Maries,13,3660,29125
2021-04-23,MO,Maries,11,3671,29125
2021-04-24,MO,Maries,8,3679,29125
2020-12-14,MO,Marion,1,1,29127
2020-12-15,MO,Marion,1,2,29127
2020-12-16,MO,Marion,2,4,29127
2020-12-18,MO,Marion,3,7,29127
2020-12-19,MO,Marion,2,9,29127
2020-12-20,MO,Marion,1,10,29127
2020-12-21,MO,Marion,13,23,29127
2020-12-22,MO,Marion,5,28,29127
2020-12-23,MO,Marion,99,127,29127
2020-12-24,MO,Marion,1,128,29127
2020-12-27,MO,Marion,1,129,29127
2020-12-28,MO,Marion,120,249,29127
2020-12-29,MO,Marion,76,325,29127
2020-12-30,MO,Marion,97,422,29127
2020-12-31,MO,Marion,5,427,29127
2021-01-01,MO,Marion,3,430,29127
2021-01-02,MO,Marion,2,432,29127
2021-01-04,MO,Marion,4,436,29127
2021-01-05,MO,Marion,133,569,29127
2021-01-06,MO,Marion,14,583,29127
2021-01-07,MO,Marion,50,633,29127
2021-01-08,MO,Marion,73,706,29127
2021-01-09,MO,Marion,5,711,29127
2021-01-10,MO,Marion,2,713,29127
2021-01-11,MO,Marion,10,723,29127
2021-01-12,MO,Marion,101,824,29127
2021-01-13,MO,Marion,117,941,29127
2021-01-14,MO,Marion,118,1059,29127
2021-01-15,MO,Marion,3,1062,29127
2021-01-16,MO,Marion,2,1064,29127
2021-01-18,MO,Marion,548,1612,29127
2021-01-19,MO,Marion,420,2032,29127
2021-01-20,MO,Marion,817,2849,29127
2021-01-21,MO,Marion,406,3255,29127
2021-01-22,MO,Marion,295,3550,29127
2021-01-23,MO,Marion,4,3554,29127
2021-01-24,MO,Marion,1,3555,29127
2021-01-25,MO,Marion,5,3560,29127
2021-01-26,MO,Marion,53,3613,29127
2021-01-27,MO,Marion,11,3624,29127
2021-01-28,MO,Marion,9,3633,29127
2021-01-29,MO,Marion,82,3715,29127
2021-01-30,MO,Marion,4,3719,29127
2021-02-01,MO,Marion,10,3729,29127
2021-02-02,MO,Marion,328,4057,29127
2021-02-03,MO,Marion,11,4068,29127
2021-02-04,MO,Marion,388,4456,29127
2021-02-05,MO,Marion,155,4611,29127
2021-02-06,MO,Marion,6,4617,29127
2021-02-07,MO,Marion,2,4619,29127
2021-02-08,MO,Marion,446,5065,29127
2021-02-09,MO,Marion,416,5481,29127
2021-02-10,MO,Marion,13,5494,29127
2021-02-11,MO,Marion,337,5831,29127
2021-02-12,MO,Marion,536,6367,29127
2021-02-13,MO,Marion,4,6371,29127
2021-02-14,MO,Marion,5,6376,29127
2021-02-15,MO,Marion,389,6765,29127
2021-02-16,MO,Marion,445,7210,29127
2021-02-17,MO,Marion,89,7299,29127
2021-02-18,MO,Marion,70,7369,29127
2021-02-19,MO,Marion,90,7459,29127
2021-02-20,MO,Marion,3,7462,29127
2021-02-21,MO,Marion,3,7465,29127
2021-02-22,MO,Marion,181,7646,29127
2021-02-23,MO,Marion,20,7666,29127
2021-02-24,MO,Marion,6,7672,29127
2021-02-25,MO,Marion,263,7935,29127
2021-02-26,MO,Marion,139,8074,29127
2021-02-27,MO,Marion,4,8078,29127
2021-02-28,MO,Marion,5,8083,29127
2021-03-01,MO,Marion,18,8101,29127
2021-03-02,MO,Marion,347,8448,29127
2021-03-03,MO,Marion,8,8456,29127
2021-03-04,MO,Marion,426,8882,29127
2021-03-05,MO,Marion,257,9139,29127
2021-03-06,MO,Marion,5,9144,29127
2021-03-07,MO,Marion,11,9155,29127
2021-03-08,MO,Marion,46,9201,29127
2021-03-09,MO,Marion,57,9258,29127
2021-03-10,MO,Marion,22,9280,29127
2021-03-11,MO,Marion,46,9326,29127
2021-03-12,MO,Marion,70,9396,29127
2021-03-13,MO,Marion,6,9402,29127
2021-03-14,MO,Marion,1,9403,29127
2021-03-15,MO,Marion,331,9734,29127
2021-03-16,MO,Marion,550,10284,29127
2021-03-17,MO,Marion,61,10345,29127
2021-03-18,MO,Marion,447,10792,29127
2021-03-19,MO,Marion,61,10853,29127
2021-03-20,MO,Marion,8,10861,29127
2021-03-21,MO,Marion,3,10864,29127
2021-03-22,MO,Marion,218,11082,29127
2021-03-23,MO,Marion,35,11117,29127
2021-03-24,MO,Marion,229,11346,29127
2021-03-25,MO,Marion,250,11596,29127
2021-03-26,MO,Marion,47,11643,29127
2021-03-27,MO,Marion,7,11650,29127
2021-03-28,MO,Marion,10,11660,29127
2021-03-29,MO,Marion,38,11698,29127
2021-03-30,MO,Marion,258,11956,29127
2021-03-31,MO,Marion,33,11989,29127
2021-04-01,MO,Marion,297,12286,29127
2021-04-02,MO,Marion,266,12552,29127
2021-04-03,MO,Marion,4,12556,29127
2021-04-04,MO,Marion,4,12560,29127
2021-04-05,MO,Marion,14,12574,29127
2021-04-06,MO,Marion,44,12618,29127
2021-04-07,MO,Marion,125,12743,29127
2021-04-08,MO,Marion,425,13168,29127
2021-04-09,MO,Marion,376,13544,29127
2021-04-10,MO,Marion,10,13554,29127
2021-04-11,MO,Marion,3,13557,29127
2021-04-12,MO,Marion,78,13635,29127
2021-04-13,MO,Marion,525,14160,29127
2021-04-14,MO,Marion,257,14417,29127
2021-04-15,MO,Marion,37,14454,29127
2021-04-16,MO,Marion,60,14514,29127
2021-04-17,MO,Marion,6,14520,29127
2021-04-19,MO,Marion,10,14530,29127
2021-04-20,MO,Marion,114,14644,29127
2021-04-21,MO,Marion,17,14661,29127
2021-04-22,MO,Marion,32,14693,29127
2021-04-23,MO,Marion,33,14726,29127
2021-04-24,MO,Marion,3,14729,29127
2021-04-25,MO,Marion,1,14730,29127
2020-12-17,MO,McDonald,5,5,29119
2020-12-18,MO,McDonald,2,7,29119
2020-12-19,MO,McDonald,1,8,29119
2020-12-21,MO,McDonald,1,9,29119
2020-12-22,MO,McDonald,9,18,29119
2020-12-23,MO,McDonald,24,42,29119
2020-12-24,MO,McDonald,1,43,29119
2020-12-29,MO,McDonald,4,47,29119
2020-12-30,MO,McDonald,34,81,29119
2020-12-31,MO,McDonald,2,83,29119
2021-01-02,MO,McDonald,1,84,29119
2021-01-04,MO,McDonald,2,86,29119
2021-01-05,MO,McDonald,2,88,29119
2021-01-06,MO,McDonald,8,96,29119
2021-01-07,MO,McDonald,26,122,29119
2021-01-08,MO,McDonald,3,125,29119
2021-01-09,MO,McDonald,1,126,29119
2021-01-10,MO,McDonald,3,129,29119
2021-01-11,MO,McDonald,6,135,29119
2021-01-12,MO,McDonald,35,170,29119
2021-01-13,MO,McDonald,9,179,29119
2021-01-14,MO,McDonald,17,196,29119
2021-01-15,MO,McDonald,11,207,29119
2021-01-16,MO,McDonald,3,210,29119
2021-01-18,MO,McDonald,102,312,29119
2021-01-19,MO,McDonald,89,401,29119
2021-01-20,MO,McDonald,93,494,29119
2021-01-21,MO,McDonald,144,638,29119
2021-01-22,MO,McDonald,113,751,29119
2021-01-23,MO,McDonald,2,753,29119
2021-01-25,MO,McDonald,64,817,29119
2021-01-26,MO,McDonald,9,826,29119
2021-01-27,MO,McDonald,24,850,29119
2021-01-28,MO,McDonald,153,1003,29119
2021-01-29,MO,McDonald,32,1035,29119
2021-01-30,MO,McDonald,2,1037,29119
2021-02-01,MO,McDonald,9,1046,29119
2021-02-02,MO,McDonald,29,1075,29119
2021-02-03,MO,McDonald,14,1089,29119
2021-02-04,MO,McDonald,48,1137,29119
2021-02-05,MO,McDonald,31,1168,29119
2021-02-07,MO,McDonald,2,1170,29119
2021-02-08,MO,McDonald,122,1292,29119
2021-02-09,MO,McDonald,94,1386,29119
2021-02-10,MO,McDonald,8,1394,29119
2021-02-11,MO,McDonald,127,1521,29119
2021-02-12,MO,McDonald,159,1680,29119
2021-02-13,MO,McDonald,4,1684,29119
2021-02-14,MO,McDonald,1,1685,29119
2021-02-15,MO,McDonald,8,1693,29119
2021-02-16,MO,McDonald,8,1701,29119
2021-02-17,MO,McDonald,65,1766,29119
2021-02-18,MO,McDonald,79,1845,29119
2021-02-19,MO,McDonald,61,1906,29119
2021-02-22,MO,McDonald,2,1908,29119
2021-02-23,MO,McDonald,68,1976,29119
2021-02-24,MO,McDonald,33,2009,29119
2021-02-25,MO,McDonald,175,2184,29119
2021-02-26,MO,McDonald,39,2223,29119
2021-02-27,MO,McDonald,13,2236,29119
2021-02-28,MO,McDonald,1,2237,29119
2021-03-01,MO,McDonald,13,2250,29119
2021-03-02,MO,McDonald,31,2281,29119
2021-03-03,MO,McDonald,133,2414,29119
2021-03-04,MO,McDonald,64,2478,29119
2021-03-05,MO,McDonald,15,2493,29119
2021-03-06,MO,McDonald,1,2494,29119
2021-03-07,MO,McDonald,5,2499,29119
2021-03-08,MO,McDonald,37,2536,29119
2021-03-09,MO,McDonald,101,2637,29119
2021-03-10,MO,McDonald,6,2643,29119
2021-03-11,MO,McDonald,21,2664,29119
2021-03-12,MO,McDonald,49,2713,29119
2021-03-13,MO,McDonald,2,2715,29119
2021-03-15,MO,McDonald,108,2823,29119
2021-03-16,MO,McDonald,31,2854,29119
2021-03-17,MO,McDonald,35,2889,29119
2021-03-18,MO,McDonald,39,2928,29119
2021-03-19,MO,McDonald,136,3064,29119
2021-03-20,MO,McDonald,12,3076,29119
2021-03-21,MO,McDonald,3,3079,29119
2021-03-22,MO,McDonald,38,3117,29119
2021-03-23,MO,McDonald,170,3287,29119
2021-03-24,MO,McDonald,133,3420,29119
2021-03-25,MO,McDonald,60,3480,29119
2021-03-26,MO,McDonald,75,3555,29119
2021-03-27,MO,McDonald,16,3571,29119
2021-03-28,MO,McDonald,3,3574,29119
2021-03-29,MO,McDonald,38,3612,29119
2021-03-30,MO,McDonald,83,3695,29119
2021-03-31,MO,McDonald,22,3717,29119
2021-04-01,MO,McDonald,105,3822,29119
2021-04-02,MO,McDonald,46,3868,29119
2021-04-03,MO,McDonald,1,3869,29119
2021-04-04,MO,McDonald,5,3874,29119
2021-04-05,MO,McDonald,42,3916,29119
2021-04-06,MO,McDonald,48,3964,29119
2021-04-07,MO,McDonald,15,3979,29119
2021-04-08,MO,McDonald,23,4002,29119
2021-04-09,MO,McDonald,166,4168,29119
2021-04-10,MO,McDonald,117,4285,29119
2021-04-11,MO,McDonald,8,4293,29119
2021-04-12,MO,McDonald,97,4390,29119
2021-04-13,MO,McDonald,36,4426,29119
2021-04-14,MO,McDonald,25,4451,29119
2021-04-15,MO,McDonald,37,4488,29119
2021-04-16,MO,McDonald,48,4536,29119
2021-04-17,MO,McDonald,21,4557,29119
2021-04-18,MO,McDonald,2,4559,29119
2021-04-19,MO,McDonald,25,4584,29119
2021-04-20,MO,McDonald,30,4614,29119
2021-04-21,MO,McDonald,22,4636,29119
2021-04-22,MO,McDonald,17,4653,29119
2021-04-23,MO,McDonald,122,4775,29119
2021-04-24,MO,McDonald,12,4787,29119
2021-04-25,MO,McDonald,2,4789,29119
2020-12-20,MO,Mercer,1,1,29129
2020-12-23,MO,Mercer,2,3,29129
2020-12-29,MO,Mercer,3,6,29129
2020-12-30,MO,Mercer,7,13,29129
2021-01-04,MO,Mercer,1,14,29129
2021-01-05,MO,Mercer,1,15,29129
2021-01-06,MO,Mercer,2,17,29129
2021-01-07,MO,Mercer,1,18,29129
2021-01-08,MO,Mercer,1,19,29129
2021-01-10,MO,Mercer,1,20,29129
2021-01-11,MO,Mercer,1,21,29129
2021-01-12,MO,Mercer,50,71,29129
2021-01-13,MO,Mercer,3,74,29129
2021-01-14,MO,Mercer,4,78,29129
2021-01-15,MO,Mercer,8,86,29129
2021-01-18,MO,Mercer,2,88,29129
2021-01-19,MO,Mercer,2,90,29129
2021-01-20,MO,Mercer,3,93,29129
2021-01-21,MO,Mercer,1,94,29129
2021-01-22,MO,Mercer,5,99,29129
2021-01-26,MO,Mercer,3,102,29129
2021-01-27,MO,Mercer,8,110,29129
2021-01-28,MO,Mercer,3,113,29129
2021-01-29,MO,Mercer,1,114,29129
2021-02-01,MO,Mercer,1,115,29129
2021-02-02,MO,Mercer,73,188,29129
2021-02-03,MO,Mercer,8,196,29129
2021-02-04,MO,Mercer,67,263,29129
2021-02-05,MO,Mercer,6,269,29129
2021-02-06,MO,Mercer,1,270,29129
2021-02-08,MO,Mercer,2,272,29129
2021-02-09,MO,Mercer,93,365,29129
2021-02-10,MO,Mercer,23,388,29129
2021-02-11,MO,Mercer,9,397,29129
2021-02-12,MO,Mercer,8,405,29129
2021-02-13,MO,Mercer,3,408,29129
2021-02-15,MO,Mercer,3,411,29129
2021-02-16,MO,Mercer,39,450,29129
2021-02-17,MO,Mercer,3,453,29129
2021-02-18,MO,Mercer,36,489,29129
2021-02-19,MO,Mercer,4,493,29129
2021-02-20,MO,Mercer,1,494,29129
2021-02-22,MO,Mercer,2,496,29129
2021-02-23,MO,Mercer,2,498,29129
2021-02-24,MO,Mercer,9,507,29129
2021-02-25,MO,Mercer,4,511,29129
2021-02-26,MO,Mercer,9,520,29129
2021-02-27,MO,Mercer,35,555,29129
2021-03-02,MO,Mercer,71,626,29129
2021-03-03,MO,Mercer,7,633,29129
2021-03-04,MO,Mercer,64,697,29129
2021-03-05,MO,Mercer,10,707,29129
2021-03-06,MO,Mercer,13,720,29129
2021-03-07,MO,Mercer,1,721,29129
2021-03-08,MO,Mercer,3,724,29129
2021-03-09,MO,Mercer,36,760,29129
2021-03-10,MO,Mercer,18,778,29129
2021-03-11,MO,Mercer,17,795,29129
2021-03-12,MO,Mercer,3,798,29129
2021-03-15,MO,Mercer,6,804,29129
2021-03-16,MO,Mercer,79,883,29129
2021-03-17,MO,Mercer,9,892,29129
2021-03-18,MO,Mercer,14,906,29129
2021-03-19,MO,Mercer,20,926,29129
2021-03-20,MO,Mercer,8,934,29129
2021-03-21,MO,Mercer,1,935,29129
2021-03-22,MO,Mercer,1,936,29129
2021-03-23,MO,Mercer,19,955,29129
2021-03-24,MO,Mercer,8,963,29129
2021-03-25,MO,Mercer,69,1032,29129
2021-03-26,MO,Mercer,13,1045,29129
2021-03-27,MO,Mercer,2,1047,29129
2021-03-29,MO,Mercer,6,1053,29129
2021-03-30,MO,Mercer,3,1056,29129
2021-03-31,MO,Mercer,7,1063,29129
2021-04-01,MO,Mercer,2,1065,29129
2021-04-03,MO,Mercer,1,1066,29129
2021-04-05,MO,Mercer,7,1073,29129
2021-04-06,MO,Mercer,2,1075,29129
2021-04-07,MO,Mercer,12,1087,29129
2021-04-08,MO,Mercer,16,1103,29129
2021-04-09,MO,Mercer,14,1117,29129
2021-04-10,MO,Mercer,2,1119,29129
2021-04-12,MO,Mercer,1,1120,29129
2021-04-14,MO,Mercer,4,1124,29129
2021-04-15,MO,Mercer,7,1131,29129
2021-04-16,MO,Mercer,9,1140,29129
2021-04-17,MO,Mercer,2,1142,29129
2021-04-19,MO,Mercer,2,1144,29129
2021-04-20,MO,Mercer,33,1177,29129
2021-04-21,MO,Mercer,3,1180,29129
2021-04-22,MO,Mercer,31,1211,29129
2021-04-23,MO,Mercer,4,1215,29129
2021-04-24,MO,Mercer,1,1216,29129
2020-12-15,MO,Miller,1,1,29131
2020-12-16,MO,Miller,5,6,29131
2020-12-17,MO,Miller,10,16,29131
2020-12-18,MO,Miller,21,37,29131
2020-12-19,MO,Miller,1,38,29131
2020-12-20,MO,Miller,3,41,29131
2020-12-21,MO,Miller,31,72,29131
2020-12-22,MO,Miller,29,101,29131
2020-12-23,MO,Miller,42,143,29131
2020-12-24,MO,Miller,8,151,29131
2020-12-27,MO,Miller,1,152,29131
2020-12-28,MO,Miller,48,200,29131
2020-12-29,MO,Miller,22,222,29131
2020-12-30,MO,Miller,36,258,29131
2020-12-31,MO,Miller,6,264,29131
2021-01-01,MO,Miller,1,265,29131
2021-01-02,MO,Miller,2,267,29131
2021-01-03,MO,Miller,2,269,29131
2021-01-04,MO,Miller,23,292,29131
2021-01-05,MO,Miller,15,307,29131
2021-01-06,MO,Miller,17,324,29131
2021-01-07,MO,Miller,46,370,29131
2021-01-08,MO,Miller,19,389,29131
2021-01-09,MO,Miller,2,391,29131
2021-01-10,MO,Miller,4,395,29131
2021-01-11,MO,Miller,61,456,29131
2021-01-12,MO,Miller,27,483,29131
2021-01-13,MO,Miller,42,525,29131
2021-01-14,MO,Miller,24,549,29131
2021-01-15,MO,Miller,8,557,29131
2021-01-16,MO,Miller,19,576,29131
2021-01-18,MO,Miller,49,625,29131
2021-01-19,MO,Miller,60,685,29131
2021-01-20,MO,Miller,134,819,29131
2021-01-21,MO,Miller,58,877,29131
2021-01-22,MO,Miller,123,1000,29131
2021-01-23,MO,Miller,53,1053,29131
2021-01-24,MO,Miller,2,1055,29131
2021-01-25,MO,Miller,65,1120,29131
2021-01-26,MO,Miller,75,1195,29131
2021-01-27,MO,Miller,73,1268,29131
2021-01-28,MO,Miller,41,1309,29131
2021-01-29,MO,Miller,168,1477,29131
2021-01-30,MO,Miller,63,1540,29131
2021-01-31,MO,Miller,2,1542,29131
2021-02-01,MO,Miller,52,1594,29131
2021-02-02,MO,Miller,43,1637,29131
2021-02-03,MO,Miller,43,1680,29131
2021-02-04,MO,Miller,117,1797,29131
2021-02-05,MO,Miller,100,1897,29131
2021-02-06,MO,Miller,24,1921,29131
2021-02-08,MO,Miller,42,1963,29131
2021-02-09,MO,Miller,32,1995,29131
2021-02-10,MO,Miller,62,2057,29131
2021-02-11,MO,Miller,302,2359,29131
2021-02-12,MO,Miller,230,2589,29131
2021-02-13,MO,Miller,63,2652,29131
2021-02-14,MO,Miller,4,2656,29131
2021-02-15,MO,Miller,8,2664,29131
2021-02-16,MO,Miller,55,2719,29131
2021-02-17,MO,Miller,17,2736,29131
2021-02-18,MO,Miller,85,2821,29131
2021-02-19,MO,Miller,197,3018,29131
2021-02-20,MO,Miller,57,3075,29131
2021-02-21,MO,Miller,3,3078,29131
2021-02-22,MO,Miller,88,3166,29131
2021-02-23,MO,Miller,77,3243,29131
2021-02-24,MO,Miller,24,3267,29131
2021-02-25,MO,Miller,173,3440,29131
2021-02-26,MO,Miller,172,3612,29131
2021-02-27,MO,Miller,40,3652,29131
2021-02-28,MO,Miller,2,3654,29131
2021-03-01,MO,Miller,58,3712,29131
2021-03-02,MO,Miller,55,3767,29131
2021-03-03,MO,Miller,161,3928,29131
2021-03-04,MO,Miller,218,4146,29131
2021-03-05,MO,Miller,165,4311,29131
2021-03-06,MO,Miller,26,4337,29131
2021-03-07,MO,Miller,230,4567,29131
2021-03-08,MO,Miller,55,4622,29131
2021-03-09,MO,Miller,32,4654,29131
2021-03-10,MO,Miller,105,4759,29131
2021-03-11,MO,Miller,337,5096,29131
2021-03-12,MO,Miller,310,5406,29131
2021-03-13,MO,Miller,6,5412,29131
2021-03-14,MO,Miller,8,5420,29131
2021-03-15,MO,Miller,43,5463,29131
2021-03-16,MO,Miller,59,5522,29131
2021-03-17,MO,Miller,94,5616,29131
2021-03-18,MO,Miller,90,5706,29131
2021-03-19,MO,Miller,146,5852,29131
2021-03-20,MO,Miller,27,5879,29131
2021-03-21,MO,Miller,9,5888,29131
2021-03-22,MO,Miller,111,5999,29131
2021-03-23,MO,Miller,61,6060,29131
2021-03-24,MO,Miller,76,6136,29131
2021-03-25,MO,Miller,226,6362,29131
2021-03-26,MO,Miller,138,6500,29131
2021-03-27,MO,Miller,25,6525,29131
2021-03-28,MO,Miller,6,6531,29131
2021-03-29,MO,Miller,68,6599,29131
2021-03-30,MO,Miller,87,6686,29131
2021-03-31,MO,Miller,90,6776,29131
2021-04-01,MO,Miller,126,6902,29131
2021-04-02,MO,Miller,142,7044,29131
2021-04-03,MO,Miller,30,7074,29131
2021-04-04,MO,Miller,6,7080,29131
2021-04-05,MO,Miller,52,7132,29131
2021-04-06,MO,Miller,52,7184,29131
2021-04-07,MO,Miller,88,7272,29131
2021-04-08,MO,Miller,123,7395,29131
2021-04-09,MO,Miller,218,7613,29131
2021-04-10,MO,Miller,29,7642,29131
2021-04-11,MO,Miller,14,7656,29131
2021-04-12,MO,Miller,71,7727,29131
2021-04-13,MO,Miller,58,7785,29131
2021-04-14,MO,Miller,73,7858,29131
2021-04-15,MO,Miller,77,7935,29131
2021-04-16,MO,Miller,96,8031,29131
2021-04-17,MO,Miller,18,8049,29131
2021-04-18,MO,Miller,14,8063,29131
2021-04-19,MO,Miller,63,8126,29131
2021-04-20,MO,Miller,60,8186,29131
2021-04-21,MO,Miller,41,8227,29131
2021-04-22,MO,Miller,64,8291,29131
2021-04-23,MO,Miller,38,8329,29131
2021-04-24,MO,Miller,17,8346,29131
2021-04-25,MO,Miller,8,8354,29131
2020-12-17,MO,Mississippi,2,2,29133
2020-12-19,MO,Mississippi,1,3,29133
2020-12-20,MO,Mississippi,1,4,29133
2020-12-21,MO,Mississippi,8,12,29133
2020-12-22,MO,Mississippi,29,41,29133
2020-12-23,MO,Mississippi,36,77,29133
2020-12-28,MO,Mississippi,1,78,29133
2020-12-29,MO,Mississippi,4,82,29133
2020-12-30,MO,Mississippi,1,83,29133
2021-01-01,MO,Mississippi,2,85,29133
2021-01-03,MO,Mississippi,1,86,29133
2021-01-04,MO,Mississippi,2,88,29133
2021-01-05,MO,Mississippi,5,93,29133
2021-01-06,MO,Mississippi,29,122,29133
2021-01-07,MO,Mississippi,20,142,29133
2021-01-08,MO,Mississippi,10,152,29133
2021-01-09,MO,Mississippi,1,153,29133
2021-01-10,MO,Mississippi,3,156,29133
2021-01-11,MO,Mississippi,12,168,29133
2021-01-12,MO,Mississippi,45,213,29133
2021-01-13,MO,Mississippi,16,229,29133
2021-01-14,MO,Mississippi,18,247,29133
2021-01-15,MO,Mississippi,17,264,29133
2021-01-16,MO,Mississippi,5,269,29133
2021-01-18,MO,Mississippi,111,380,29133
2021-01-19,MO,Mississippi,96,476,29133
2021-01-20,MO,Mississippi,109,585,29133
2021-01-21,MO,Mississippi,55,640,29133
2021-01-22,MO,Mississippi,83,723,29133
2021-01-23,MO,Mississippi,3,726,29133
2021-01-25,MO,Mississippi,46,772,29133
2021-01-26,MO,Mississippi,36,808,29133
2021-01-27,MO,Mississippi,8,816,29133
2021-01-28,MO,Mississippi,83,899,29133
2021-01-29,MO,Mississippi,94,993,29133
2021-01-30,MO,Mississippi,1,994,29133
2021-02-01,MO,Mississippi,182,1176,29133
2021-02-02,MO,Mississippi,52,1228,29133
2021-02-03,MO,Mississippi,13,1241,29133
2021-02-04,MO,Mississippi,223,1464,29133
2021-02-05,MO,Mississippi,83,1547,29133
2021-02-06,MO,Mississippi,289,1836,29133
2021-02-07,MO,Mississippi,4,1840,29133
2021-02-08,MO,Mississippi,85,1925,29133
2021-02-09,MO,Mississippi,114,2039,29133
2021-02-10,MO,Mississippi,123,2162,29133
2021-02-11,MO,Mississippi,32,2194,29133
2021-02-12,MO,Mississippi,131,2325,29133
2021-02-13,MO,Mississippi,21,2346,29133
2021-02-14,MO,Mississippi,1,2347,29133
2021-02-15,MO,Mississippi,32,2379,29133
2021-02-16,MO,Mississippi,24,2403,29133
2021-02-17,MO,Mississippi,2,2405,29133
2021-02-18,MO,Mississippi,4,2409,29133
2021-02-19,MO,Mississippi,47,2456,29133
2021-02-20,MO,Mississippi,7,2463,29133
2021-02-21,MO,Mississippi,1,2464,29133
2021-02-22,MO,Mississippi,10,2474,29133
2021-02-23,MO,Mississippi,122,2596,29133
2021-02-24,MO,Mississippi,76,2672,29133
2021-02-25,MO,Mississippi,121,2793,29133
2021-02-26,MO,Mississippi,90,2883,29133
2021-02-27,MO,Mississippi,18,2901,29133
2021-03-01,MO,Mississippi,198,3099,29133
2021-03-02,MO,Mississippi,28,3127,29133
2021-03-03,MO,Mississippi,330,3457,29133
2021-03-04,MO,Mississippi,30,3487,29133
2021-03-05,MO,Mississippi,62,3549,29133
2021-03-06,MO,Mississippi,285,3834,29133
2021-03-07,MO,Mississippi,2,3836,29133
2021-03-08,MO,Mississippi,62,3898,29133
2021-03-09,MO,Mississippi,64,3962,29133
2021-03-10,MO,Mississippi,122,4084,29133
2021-03-11,MO,Mississippi,29,4113,29133
2021-03-12,MO,Mississippi,381,4494,29133
2021-03-13,MO,Mississippi,17,4511,29133
2021-03-14,MO,Mississippi,18,4529,29133
2021-03-15,MO,Mississippi,82,4611,29133
2021-03-16,MO,Mississippi,153,4764,29133
2021-03-17,MO,Mississippi,70,4834,29133
2021-03-18,MO,Mississippi,52,4886,29133
2021-03-19,MO,Mississippi,37,4923,29133
2021-03-20,MO,Mississippi,27,4950,29133
2021-03-21,MO,Mississippi,2,4952,29133
2021-03-22,MO,Mississippi,15,4967,29133
2021-03-23,MO,Mississippi,5,4972,29133
2021-03-24,MO,Mississippi,33,5005,29133
2021-03-25,MO,Mississippi,100,5105,29133
2021-03-26,MO,Mississippi,25,5130,29133
2021-03-28,MO,Mississippi,18,5148,29133
2021-03-29,MO,Mississippi,24,5172,29133
2021-03-30,MO,Mississippi,318,5490,29133
2021-03-31,MO,Mississippi,79,5569,29133
2021-04-01,MO,Mississippi,49,5618,29133
2021-04-02,MO,Mississippi,24,5642,29133
2021-04-03,MO,Mississippi,5,5647,29133
2021-04-04,MO,Mississippi,2,5649,29133
2021-04-05,MO,Mississippi,31,5680,29133
2021-04-06,MO,Mississippi,68,5748,29133
2021-04-07,MO,Mississippi,42,5790,29133
2021-04-08,MO,Mississippi,64,5854,29133
2021-04-09,MO,Mississippi,376,6230,29133
2021-04-10,MO,Mississippi,22,6252,29133
2021-04-11,MO,Mississippi,5,6257,29133
2021-04-12,MO,Mississippi,78,6335,29133
2021-04-13,MO,Mississippi,29,6364,29133
2021-04-14,MO,Mississippi,60,6424,29133
2021-04-15,MO,Mississippi,48,6472,29133
2021-04-16,MO,Mississippi,33,6505,29133
2021-04-17,MO,Mississippi,21,6526,29133
2021-04-18,MO,Mississippi,19,6545,29133
2021-04-19,MO,Mississippi,14,6559,29133
2021-04-20,MO,Mississippi,329,6888,29133
2021-04-21,MO,Mississippi,26,6914,29133
2021-04-22,MO,Mississippi,24,6938,29133
2021-04-23,MO,Mississippi,83,7021,29133
2021-04-24,MO,Mississippi,1,7022,29133
2021-04-25,MO,Mississippi,1,7023,29133
2020-12-15,MO,Moniteau,1,1,29135
2020-12-16,MO,Moniteau,7,8,29135
2020-12-17,MO,Moniteau,18,26,29135
2020-12-18,MO,Moniteau,22,48,29135
2020-12-19,MO,Moniteau,1,49,29135
2020-12-20,MO,Moniteau,3,52,29135
2020-12-21,MO,Moniteau,5,57,29135
2020-12-22,MO,Moniteau,8,65,29135
2020-12-23,MO,Moniteau,16,81,29135
2020-12-24,MO,Moniteau,3,84,29135
2020-12-28,MO,Moniteau,3,87,29135
2020-12-29,MO,Moniteau,8,95,29135
2020-12-30,MO,Moniteau,44,139,29135
2020-12-31,MO,Moniteau,8,147,29135
2021-01-03,MO,Moniteau,1,148,29135
2021-01-04,MO,Moniteau,9,157,29135
2021-01-05,MO,Moniteau,31,188,29135
2021-01-06,MO,Moniteau,16,204,29135
2021-01-07,MO,Moniteau,21,225,29135
2021-01-08,MO,Moniteau,18,243,29135
2021-01-09,MO,Moniteau,3,246,29135
2021-01-10,MO,Moniteau,4,250,29135
2021-01-11,MO,Moniteau,34,284,29135
2021-01-12,MO,Moniteau,4,288,29135
2021-01-13,MO,Moniteau,90,378,29135
2021-01-14,MO,Moniteau,23,401,29135
2021-01-15,MO,Moniteau,15,416,29135
2021-01-16,MO,Moniteau,3,419,29135
2021-01-18,MO,Moniteau,10,429,29135
2021-01-19,MO,Moniteau,30,459,29135
2021-01-20,MO,Moniteau,40,499,29135
2021-01-21,MO,Moniteau,83,582,29135
2021-01-22,MO,Moniteau,110,692,29135
2021-01-23,MO,Moniteau,71,763,29135
2021-01-24,MO,Moniteau,2,765,29135
2021-01-25,MO,Moniteau,101,866,29135
2021-01-26,MO,Moniteau,108,974,29135
2021-01-27,MO,Moniteau,143,1117,29135
2021-01-28,MO,Moniteau,40,1157,29135
2021-01-29,MO,Moniteau,137,1294,29135
2021-01-30,MO,Moniteau,24,1318,29135
2021-01-31,MO,Moniteau,3,1321,29135
2021-02-01,MO,Moniteau,59,1380,29135
2021-02-02,MO,Moniteau,17,1397,29135
2021-02-03,MO,Moniteau,90,1487,29135
2021-02-04,MO,Moniteau,108,1595,29135
2021-02-05,MO,Moniteau,103,1698,29135
2021-02-06,MO,Moniteau,29,1727,29135
2021-02-08,MO,Moniteau,32,1759,29135
2021-02-09,MO,Moniteau,101,1860,29135
2021-02-10,MO,Moniteau,127,1987,29135
2021-02-11,MO,Moniteau,115,2102,29135
2021-02-12,MO,Moniteau,208,2310,29135
2021-02-13,MO,Moniteau,82,2392,29135
2021-02-14,MO,Moniteau,2,2394,29135
2021-02-15,MO,Moniteau,5,2399,29135
2021-02-16,MO,Moniteau,22,2421,29135
2021-02-17,MO,Moniteau,51,2472,29135
2021-02-18,MO,Moniteau,66,2538,29135
2021-02-19,MO,Moniteau,91,2629,29135
2021-02-20,MO,Moniteau,25,2654,29135
2021-02-21,MO,Moniteau,1,2655,29135
2021-02-22,MO,Moniteau,93,2748,29135
2021-02-23,MO,Moniteau,110,2858,29135
2021-02-24,MO,Moniteau,113,2971,29135
2021-02-25,MO,Moniteau,59,3030,29135
2021-02-26,MO,Moniteau,142,3172,29135
2021-02-27,MO,Moniteau,16,3188,29135
2021-02-28,MO,Moniteau,2,3190,29135
2021-03-01,MO,Moniteau,139,3329,29135
2021-03-02,MO,Moniteau,100,3429,29135
2021-03-03,MO,Moniteau,121,3550,29135
2021-03-04,MO,Moniteau,79,3629,29135
2021-03-05,MO,Moniteau,110,3739,29135
2021-03-06,MO,Moniteau,13,3752,29135
2021-03-07,MO,Moniteau,7,3759,29135
2021-03-08,MO,Moniteau,9,3768,29135
2021-03-09,MO,Moniteau,89,3857,29135
2021-03-10,MO,Moniteau,147,4004,29135
2021-03-11,MO,Moniteau,83,4087,29135
2021-03-12,MO,Moniteau,127,4214,29135
2021-03-13,MO,Moniteau,4,4218,29135
2021-03-14,MO,Moniteau,3,4221,29135
2021-03-15,MO,Moniteau,97,4318,29135
2021-03-16,MO,Moniteau,134,4452,29135
2021-03-17,MO,Moniteau,70,4522,29135
2021-03-18,MO,Moniteau,102,4624,29135
2021-03-19,MO,Moniteau,93,4717,29135
2021-03-20,MO,Moniteau,7,4724,29135
2021-03-21,MO,Moniteau,7,4731,29135
2021-03-22,MO,Moniteau,47,4778,29135
2021-03-23,MO,Moniteau,31,4809,29135
2021-03-24,MO,Moniteau,84,4893,29135
2021-03-25,MO,Moniteau,90,4983,29135
2021-03-26,MO,Moniteau,115,5098,29135
2021-03-27,MO,Moniteau,9,5107,29135
2021-03-28,MO,Moniteau,5,5112,29135
2021-03-29,MO,Moniteau,119,5231,29135
2021-03-30,MO,Moniteau,215,5446,29135
2021-03-31,MO,Moniteau,155,5601,29135
2021-04-01,MO,Moniteau,48,5649,29135
2021-04-02,MO,Moniteau,37,5686,29135
2021-04-03,MO,Moniteau,5,5691,29135
2021-04-04,MO,Moniteau,2,5693,29135
2021-04-05,MO,Moniteau,38,5731,29135
2021-04-06,MO,Moniteau,74,5805,29135
2021-04-07,MO,Moniteau,44,5849,29135
2021-04-08,MO,Moniteau,46,5895,29135
2021-04-09,MO,Moniteau,73,5968,29135
2021-04-10,MO,Moniteau,6,5974,29135
2021-04-11,MO,Moniteau,4,5978,29135
2021-04-12,MO,Moniteau,93,6071,29135
2021-04-13,MO,Moniteau,137,6208,29135
2021-04-14,MO,Moniteau,75,6283,29135
2021-04-15,MO,Moniteau,93,6376,29135
2021-04-16,MO,Moniteau,40,6416,29135
2021-04-17,MO,Moniteau,5,6421,29135
2021-04-18,MO,Moniteau,1,6422,29135
2021-04-19,MO,Moniteau,13,6435,29135
2021-04-20,MO,Moniteau,254,6689,29135
2021-04-21,MO,Moniteau,27,6716,29135
2021-04-22,MO,Moniteau,85,6801,29135
2021-04-23,MO,Moniteau,116,6917,29135
2021-04-24,MO,Moniteau,3,6920,29135
2020-12-16,MO,Monroe,1,1,29137
2020-12-17,MO,Monroe,4,5,29137
2020-12-18,MO,Monroe,1,6,29137
2020-12-19,MO,Monroe,4,10,29137
2020-12-20,MO,Monroe,1,11,29137
2020-12-21,MO,Monroe,4,15,29137
2020-12-22,MO,Monroe,6,21,29137
2020-12-23,MO,Monroe,15,36,29137
2020-12-28,MO,Monroe,30,66,29137
2020-12-29,MO,Monroe,16,82,29137
2020-12-30,MO,Monroe,13,95,29137
2020-12-31,MO,Monroe,4,99,29137
2021-01-02,MO,Monroe,1,100,29137
2021-01-03,MO,Monroe,1,101,29137
2021-01-04,MO,Monroe,1,102,29137
2021-01-05,MO,Monroe,6,108,29137
2021-01-06,MO,Monroe,5,113,29137
2021-01-07,MO,Monroe,6,119,29137
2021-01-08,MO,Monroe,10,129,29137
2021-01-09,MO,Monroe,62,191,29137
2021-01-10,MO,Monroe,4,195,29137
2021-01-11,MO,Monroe,10,205,29137
2021-01-12,MO,Monroe,16,221,29137
2021-01-13,MO,Monroe,18,239,29137
2021-01-14,MO,Monroe,9,248,29137
2021-01-15,MO,Monroe,7,255,29137
2021-01-16,MO,Monroe,2,257,29137
2021-01-18,MO,Monroe,87,344,29137
2021-01-19,MO,Monroe,62,406,29137
2021-01-20,MO,Monroe,162,568,29137
2021-01-21,MO,Monroe,179,747,29137
2021-01-22,MO,Monroe,111,858,29137
2021-01-23,MO,Monroe,1,859,29137
2021-01-24,MO,Monroe,16,875,29137
2021-01-25,MO,Monroe,5,880,29137
2021-01-26,MO,Monroe,9,889,29137
2021-01-27,MO,Monroe,28,917,29137
2021-01-28,MO,Monroe,43,960,29137
2021-01-29,MO,Monroe,119,1079,29137
2021-01-31,MO,Monroe,1,1080,29137
2021-02-01,MO,Monroe,2,1082,29137
2021-02-02,MO,Monroe,38,1120,29137
2021-02-03,MO,Monroe,9,1129,29137
2021-02-04,MO,Monroe,138,1267,29137
2021-02-05,MO,Monroe,88,1355,29137
2021-02-06,MO,Monroe,81,1436,29137
2021-02-07,MO,Monroe,1,1437,29137
2021-02-08,MO,Monroe,90,1527,29137
2021-02-09,MO,Monroe,130,1657,29137
2021-02-10,MO,Monroe,41,1698,29137
2021-02-11,MO,Monroe,112,1810,29137
2021-02-12,MO,Monroe,158,1968,29137
2021-02-13,MO,Monroe,5,1973,29137
2021-02-15,MO,Monroe,37,2010,29137
2021-02-16,MO,Monroe,96,2106,29137
2021-02-17,MO,Monroe,11,2117,29137
2021-02-18,MO,Monroe,112,2229,29137
2021-02-19,MO,Monroe,73,2302,29137
2021-02-21,MO,Monroe,16,2318,29137
2021-02-22,MO,Monroe,28,2346,29137
2021-02-23,MO,Monroe,9,2355,29137
2021-02-24,MO,Monroe,38,2393,29137
2021-02-25,MO,Monroe,94,2487,29137
2021-02-26,MO,Monroe,88,2575,29137
2021-02-27,MO,Monroe,1,2576,29137
2021-03-01,MO,Monroe,3,2579,29137
2021-03-02,MO,Monroe,70,2649,29137
2021-03-03,MO,Monroe,15,2664,29137
2021-03-04,MO,Monroe,131,2795,29137
2021-03-05,MO,Monroe,118,2913,29137
2021-03-06,MO,Monroe,23,2936,29137
2021-03-07,MO,Monroe,1,2937,29137
2021-03-08,MO,Monroe,20,2957,29137
2021-03-09,MO,Monroe,30,2987,29137
2021-03-10,MO,Monroe,16,3003,29137
2021-03-11,MO,Monroe,90,3093,29137
2021-03-12,MO,Monroe,54,3147,29137
2021-03-13,MO,Monroe,2,3149,29137
2021-03-14,MO,Monroe,2,3151,29137
2021-03-15,MO,Monroe,43,3194,29137
2021-03-16,MO,Monroe,114,3308,29137
2021-03-17,MO,Monroe,16,3324,29137
2021-03-18,MO,Monroe,74,3398,29137
2021-03-19,MO,Monroe,95,3493,29137
2021-03-20,MO,Monroe,2,3495,29137
2021-03-21,MO,Monroe,1,3496,29137
2021-03-22,MO,Monroe,34,3530,29137
2021-03-23,MO,Monroe,18,3548,29137
2021-03-24,MO,Monroe,116,3664,29137
2021-03-25,MO,Monroe,88,3752,29137
2021-03-26,MO,Monroe,22,3774,29137
2021-03-27,MO,Monroe,2,3776,29137
2021-03-28,MO,Monroe,1,3777,29137
2021-03-29,MO,Monroe,4,3781,29137
2021-03-30,MO,Monroe,54,3835,29137
2021-03-31,MO,Monroe,31,3866,29137
2021-04-01,MO,Monroe,117,3983,29137
2021-04-02,MO,Monroe,53,4036,29137
2021-04-03,MO,Monroe,1,4037,29137
2021-04-05,MO,Monroe,11,4048,29137
2021-04-06,MO,Monroe,30,4078,29137
2021-04-07,MO,Monroe,29,4107,29137
2021-04-08,MO,Monroe,78,4185,29137
2021-04-09,MO,Monroe,60,4245,29137
2021-04-10,MO,Monroe,6,4251,29137
2021-04-11,MO,Monroe,1,4252,29137
2021-04-12,MO,Monroe,10,4262,29137
2021-04-13,MO,Monroe,105,4367,29137
2021-04-14,MO,Monroe,60,4427,29137
2021-04-15,MO,Monroe,75,4502,29137
2021-04-16,MO,Monroe,20,4522,29137
2021-04-17,MO,Monroe,6,4528,29137
2021-04-18,MO,Monroe,5,4533,29137
2021-04-19,MO,Monroe,5,4538,29137
2021-04-20,MO,Monroe,46,4584,29137
2021-04-21,MO,Monroe,9,4593,29137
2021-04-22,MO,Monroe,12,4605,29137
2021-04-23,MO,Monroe,16,4621,29137
2021-04-24,MO,Monroe,4,4625,29137
2020-12-16,MO,Montgomery,2,2,29139
2020-12-17,MO,Montgomery,10,12,29139
2020-12-18,MO,Montgomery,15,27,29139
2020-12-19,MO,Montgomery,1,28,29139
2020-12-20,MO,Montgomery,2,30,29139
2020-12-21,MO,Montgomery,5,35,29139
2020-12-22,MO,Montgomery,13,48,29139
2020-12-23,MO,Montgomery,4,52,29139
2020-12-24,MO,Montgomery,19,71,29139
2020-12-26,MO,Montgomery,3,74,29139
2020-12-28,MO,Montgomery,12,86,29139
2020-12-29,MO,Montgomery,11,97,29139
2020-12-30,MO,Montgomery,18,115,29139
2020-12-31,MO,Montgomery,6,121,29139
2021-01-02,MO,Montgomery,2,123,29139
2021-01-03,MO,Montgomery,1,124,29139
2021-01-04,MO,Montgomery,5,129,29139
2021-01-05,MO,Montgomery,21,150,29139
2021-01-06,MO,Montgomery,33,183,29139
2021-01-07,MO,Montgomery,8,191,29139
2021-01-08,MO,Montgomery,11,202,29139
2021-01-09,MO,Montgomery,5,207,29139
2021-01-10,MO,Montgomery,3,210,29139
2021-01-11,MO,Montgomery,45,255,29139
2021-01-12,MO,Montgomery,28,283,29139
2021-01-13,MO,Montgomery,6,289,29139
2021-01-14,MO,Montgomery,12,301,29139
2021-01-15,MO,Montgomery,38,339,29139
2021-01-16,MO,Montgomery,3,342,29139
2021-01-17,MO,Montgomery,2,344,29139
2021-01-18,MO,Montgomery,11,355,29139
2021-01-19,MO,Montgomery,21,376,29139
2021-01-20,MO,Montgomery,17,393,29139
2021-01-21,MO,Montgomery,24,417,29139
2021-01-22,MO,Montgomery,41,458,29139
2021-01-23,MO,Montgomery,7,465,29139
2021-01-25,MO,Montgomery,63,528,29139
2021-01-26,MO,Montgomery,82,610,29139
2021-01-27,MO,Montgomery,18,628,29139
2021-01-28,MO,Montgomery,78,706,29139
2021-01-29,MO,Montgomery,60,766,29139
2021-01-30,MO,Montgomery,279,1045,29139
2021-01-31,MO,Montgomery,55,1100,29139
2021-02-01,MO,Montgomery,10,1110,29139
2021-02-02,MO,Montgomery,34,1144,29139
2021-02-03,MO,Montgomery,42,1186,29139
2021-02-04,MO,Montgomery,395,1581,29139
2021-02-05,MO,Montgomery,42,1623,29139
2021-02-06,MO,Montgomery,5,1628,29139
2021-02-08,MO,Montgomery,59,1687,29139
2021-02-09,MO,Montgomery,57,1744,29139
2021-02-10,MO,Montgomery,32,1776,29139
2021-02-11,MO,Montgomery,43,1819,29139
2021-02-12,MO,Montgomery,224,2043,29139
2021-02-13,MO,Montgomery,7,2050,29139
2021-02-14,MO,Montgomery,1,2051,29139
2021-02-15,MO,Montgomery,5,2056,29139
2021-02-16,MO,Montgomery,18,2074,29139
2021-02-17,MO,Montgomery,19,2093,29139
2021-02-18,MO,Montgomery,21,2114,29139
2021-02-19,MO,Montgomery,58,2172,29139
2021-02-20,MO,Montgomery,144,2316,29139
2021-02-22,MO,Montgomery,21,2337,29139
2021-02-23,MO,Montgomery,43,2380,29139
2021-02-24,MO,Montgomery,43,2423,29139
2021-02-25,MO,Montgomery,68,2491,29139
2021-02-26,MO,Montgomery,44,2535,29139
2021-02-27,MO,Montgomery,340,2875,29139
2021-02-28,MO,Montgomery,1,2876,29139
2021-03-01,MO,Montgomery,29,2905,29139
2021-03-02,MO,Montgomery,25,2930,29139
2021-03-03,MO,Montgomery,91,3021,29139
2021-03-04,MO,Montgomery,393,3414,29139
2021-03-05,MO,Montgomery,29,3443,29139
2021-03-06,MO,Montgomery,20,3463,29139
2021-03-07,MO,Montgomery,11,3474,29139
2021-03-08,MO,Montgomery,40,3514,29139
2021-03-09,MO,Montgomery,40,3554,29139
2021-03-10,MO,Montgomery,39,3593,29139
2021-03-11,MO,Montgomery,52,3645,29139
2021-03-12,MO,Montgomery,97,3742,29139
2021-03-13,MO,Montgomery,176,3918,29139
2021-03-14,MO,Montgomery,2,3920,29139
2021-03-15,MO,Montgomery,54,3974,29139
2021-03-16,MO,Montgomery,67,4041,29139
2021-03-17,MO,Montgomery,74,4115,29139
2021-03-18,MO,Montgomery,57,4172,29139
2021-03-19,MO,Montgomery,102,4274,29139
2021-03-20,MO,Montgomery,10,4284,29139
2021-03-21,MO,Montgomery,8,4292,29139
2021-03-22,MO,Montgomery,33,4325,29139
2021-03-23,MO,Montgomery,43,4368,29139
2021-03-24,MO,Montgomery,119,4487,29139
2021-03-25,MO,Montgomery,69,4556,29139
2021-03-26,MO,Montgomery,87,4643,29139
2021-03-27,MO,Montgomery,9,4652,29139
2021-03-28,MO,Montgomery,11,4663,29139
2021-03-29,MO,Montgomery,24,4687,29139
2021-03-30,MO,Montgomery,80,4767,29139
2021-03-31,MO,Montgomery,46,4813,29139
2021-04-01,MO,Montgomery,148,4961,29139
2021-04-02,MO,Montgomery,30,4991,29139
2021-04-03,MO,Montgomery,15,5006,29139
2021-04-04,MO,Montgomery,3,5009,29139
2021-04-05,MO,Montgomery,43,5052,29139
2021-04-06,MO,Montgomery,45,5097,29139
2021-04-07,MO,Montgomery,95,5192,29139
2021-04-08,MO,Montgomery,215,5407,29139
2021-04-09,MO,Montgomery,50,5457,29139
2021-04-10,MO,Montgomery,72,5529,29139
2021-04-11,MO,Montgomery,6,5535,29139
2021-04-12,MO,Montgomery,81,5616,29139
2021-04-13,MO,Montgomery,38,5654,29139
2021-04-14,MO,Montgomery,105,5759,29139
2021-04-15,MO,Montgomery,60,5819,29139
2021-04-16,MO,Montgomery,80,5899,29139
2021-04-17,MO,Montgomery,17,5916,29139
2021-04-18,MO,Montgomery,11,5927,29139
2021-04-19,MO,Montgomery,41,5968,29139
2021-04-20,MO,Montgomery,42,6010,29139
2021-04-21,MO,Montgomery,33,6043,29139
2021-04-22,MO,Montgomery,45,6088,29139
2021-04-23,MO,Montgomery,23,6111,29139
2021-04-24,MO,Montgomery,18,6129,29139
2020-12-15,MO,Morgan,3,3,29141
2020-12-16,MO,Morgan,2,5,29141
2020-12-17,MO,Morgan,4,9,29141
2020-12-18,MO,Morgan,8,17,29141
2020-12-21,MO,Morgan,19,36,29141
2020-12-22,MO,Morgan,15,51,29141
2020-12-23,MO,Morgan,12,63,29141
2020-12-24,MO,Morgan,3,66,29141
2020-12-27,MO,Morgan,1,67,29141
2020-12-28,MO,Morgan,14,81,29141
2020-12-29,MO,Morgan,24,105,29141
2020-12-30,MO,Morgan,20,125,29141
2020-12-31,MO,Morgan,6,131,29141
2021-01-02,MO,Morgan,1,132,29141
2021-01-03,MO,Morgan,1,133,29141
2021-01-04,MO,Morgan,96,229,29141
2021-01-05,MO,Morgan,12,241,29141
2021-01-06,MO,Morgan,6,247,29141
2021-01-07,MO,Morgan,10,257,29141
2021-01-08,MO,Morgan,14,271,29141
2021-01-10,MO,Morgan,1,272,29141
2021-01-11,MO,Morgan,25,297,29141
2021-01-12,MO,Morgan,16,313,29141
2021-01-13,MO,Morgan,25,338,29141
2021-01-14,MO,Morgan,53,391,29141
2021-01-15,MO,Morgan,19,410,29141
2021-01-16,MO,Morgan,5,415,29141
2021-01-18,MO,Morgan,17,432,29141
2021-01-19,MO,Morgan,28,460,29141
2021-01-20,MO,Morgan,23,483,29141
2021-01-21,MO,Morgan,18,501,29141
2021-01-22,MO,Morgan,39,540,29141
2021-01-23,MO,Morgan,90,630,29141
2021-01-25,MO,Morgan,96,726,29141
2021-01-26,MO,Morgan,49,775,29141
2021-01-27,MO,Morgan,122,897,29141
2021-01-28,MO,Morgan,88,985,29141
2021-01-29,MO,Morgan,273,1258,29141
2021-01-30,MO,Morgan,23,1281,29141
2021-01-31,MO,Morgan,1,1282,29141
2021-02-01,MO,Morgan,130,1412,29141
2021-02-02,MO,Morgan,56,1468,29141
2021-02-03,MO,Morgan,125,1593,29141
2021-02-04,MO,Morgan,107,1700,29141
2021-02-05,MO,Morgan,142,1842,29141
2021-02-06,MO,Morgan,61,1903,29141
2021-02-08,MO,Morgan,13,1916,29141
2021-02-09,MO,Morgan,124,2040,29141
2021-02-10,MO,Morgan,117,2157,29141
2021-02-11,MO,Morgan,243,2400,29141
2021-02-12,MO,Morgan,223,2623,29141
2021-02-13,MO,Morgan,132,2755,29141
2021-02-14,MO,Morgan,3,2758,29141
2021-02-15,MO,Morgan,4,2762,29141
2021-02-16,MO,Morgan,22,2784,29141
2021-02-17,MO,Morgan,21,2805,29141
2021-02-18,MO,Morgan,100,2905,29141
2021-02-19,MO,Morgan,275,3180,29141
2021-02-20,MO,Morgan,10,3190,29141
2021-02-22,MO,Morgan,130,3320,29141
2021-02-23,MO,Morgan,73,3393,29141
2021-02-24,MO,Morgan,191,3584,29141
2021-02-25,MO,Morgan,260,3844,29141
2021-02-26,MO,Morgan,266,4110,29141
2021-02-27,MO,Morgan,42,4152,29141
2021-02-28,MO,Morgan,7,4159,29141
2021-03-01,MO,Morgan,74,4233,29141
2021-03-02,MO,Morgan,95,4328,29141
2021-03-03,MO,Morgan,184,4512,29141
2021-03-04,MO,Morgan,176,4688,29141
2021-03-05,MO,Morgan,130,4818,29141
2021-03-06,MO,Morgan,62,4880,29141
2021-03-07,MO,Morgan,156,5036,29141
2021-03-08,MO,Morgan,74,5110,29141
2021-03-09,MO,Morgan,154,5264,29141
2021-03-10,MO,Morgan,133,5397,29141
2021-03-11,MO,Morgan,291,5688,29141
2021-03-12,MO,Morgan,228,5916,29141
2021-03-13,MO,Morgan,31,5947,29141
2021-03-14,MO,Morgan,4,5951,29141
2021-03-15,MO,Morgan,85,6036,29141
2021-03-16,MO,Morgan,92,6128,29141
2021-03-17,MO,Morgan,84,6212,29141
2021-03-18,MO,Morgan,113,6325,29141
2021-03-19,MO,Morgan,153,6478,29141
2021-03-20,MO,Morgan,39,6517,29141
2021-03-21,MO,Morgan,35,6552,29141
2021-03-22,MO,Morgan,129,6681,29141
2021-03-23,MO,Morgan,96,6777,29141
2021-03-24,MO,Morgan,133,6910,29141
2021-03-25,MO,Morgan,204,7114,29141
2021-03-26,MO,Morgan,153,7267,29141
2021-03-27,MO,Morgan,33,7300,29141
2021-03-28,MO,Morgan,4,7304,29141
2021-03-29,MO,Morgan,65,7369,29141
2021-03-30,MO,Morgan,121,7490,29141
2021-03-31,MO,Morgan,150,7640,29141
2021-04-01,MO,Morgan,106,7746,29141
2021-04-02,MO,Morgan,78,7824,29141
2021-04-03,MO,Morgan,23,7847,29141
2021-04-04,MO,Morgan,6,7853,29141
2021-04-05,MO,Morgan,91,7944,29141
2021-04-06,MO,Morgan,113,8057,29141
2021-04-07,MO,Morgan,58,8115,29141
2021-04-08,MO,Morgan,94,8209,29141
2021-04-09,MO,Morgan,147,8356,29141
2021-04-10,MO,Morgan,18,8374,29141
2021-04-11,MO,Morgan,12,8386,29141
2021-04-12,MO,Morgan,50,8436,29141
2021-04-13,MO,Morgan,98,8534,29141
2021-04-14,MO,Morgan,110,8644,29141
2021-04-15,MO,Morgan,63,8707,29141
2021-04-16,MO,Morgan,118,8825,29141
2021-04-17,MO,Morgan,11,8836,29141
2021-04-18,MO,Morgan,7,8843,29141
2021-04-19,MO,Morgan,39,8882,29141
2021-04-20,MO,Morgan,94,8976,29141
2021-04-21,MO,Morgan,46,9022,29141
2021-04-22,MO,Morgan,51,9073,29141
2021-04-23,MO,Morgan,44,9117,29141
2021-04-24,MO,Morgan,13,9130,29141
2021-04-25,MO,Morgan,2,9132,29141
2020-12-16,MO,New Madrid,1,1,29143
2020-12-17,MO,New Madrid,1,2,29143
2020-12-18,MO,New Madrid,4,6,29143
2020-12-19,MO,New Madrid,1,7,29143
2020-12-21,MO,New Madrid,5,12,29143
2020-12-22,MO,New Madrid,13,25,29143
2020-12-23,MO,New Madrid,23,48,29143
2020-12-28,MO,New Madrid,2,50,29143
2020-12-29,MO,New Madrid,11,61,29143
2020-12-30,MO,New Madrid,61,122,29143
2021-01-02,MO,New Madrid,5,127,29143
2021-01-03,MO,New Madrid,5,132,29143
2021-01-04,MO,New Madrid,3,135,29143
2021-01-05,MO,New Madrid,7,142,29143
2021-01-06,MO,New Madrid,38,180,29143
2021-01-07,MO,New Madrid,8,188,29143
2021-01-08,MO,New Madrid,10,198,29143
2021-01-10,MO,New Madrid,91,289,29143
2021-01-11,MO,New Madrid,8,297,29143
2021-01-12,MO,New Madrid,35,332,29143
2021-01-13,MO,New Madrid,6,338,29143
2021-01-14,MO,New Madrid,42,380,29143
2021-01-15,MO,New Madrid,22,402,29143
2021-01-16,MO,New Madrid,2,404,29143
2021-01-18,MO,New Madrid,36,440,29143
2021-01-19,MO,New Madrid,53,493,29143
2021-01-20,MO,New Madrid,101,594,29143
2021-01-21,MO,New Madrid,67,661,29143
2021-01-22,MO,New Madrid,97,758,29143
2021-01-23,MO,New Madrid,6,764,29143
2021-01-24,MO,New Madrid,2,766,29143
2021-01-25,MO,New Madrid,41,807,29143
2021-01-26,MO,New Madrid,56,863,29143
2021-01-27,MO,New Madrid,141,1004,29143
2021-01-28,MO,New Madrid,137,1141,29143
2021-01-29,MO,New Madrid,100,1241,29143
2021-01-30,MO,New Madrid,1,1242,29143
2021-02-01,MO,New Madrid,114,1356,29143
2021-02-02,MO,New Madrid,26,1382,29143
2021-02-03,MO,New Madrid,185,1567,29143
2021-02-04,MO,New Madrid,129,1696,29143
2021-02-05,MO,New Madrid,109,1805,29143
2021-02-06,MO,New Madrid,2,1807,29143
2021-02-07,MO,New Madrid,100,1907,29143
2021-02-08,MO,New Madrid,119,2026,29143
2021-02-09,MO,New Madrid,172,2198,29143
2021-02-10,MO,New Madrid,30,2228,29143
2021-02-11,MO,New Madrid,35,2263,29143
2021-02-12,MO,New Madrid,89,2352,29143
2021-02-13,MO,New Madrid,10,2362,29143
2021-02-14,MO,New Madrid,1,2363,29143
2021-02-15,MO,New Madrid,11,2374,29143
2021-02-16,MO,New Madrid,15,2389,29143
2021-02-17,MO,New Madrid,9,2398,29143
2021-02-18,MO,New Madrid,11,2409,29143
2021-02-19,MO,New Madrid,54,2463,29143
2021-02-20,MO,New Madrid,14,2477,29143
2021-02-21,MO,New Madrid,2,2479,29143
2021-02-22,MO,New Madrid,66,2545,29143
2021-02-23,MO,New Madrid,95,2640,29143
2021-02-24,MO,New Madrid,158,2798,29143
2021-02-25,MO,New Madrid,212,3010,29143
2021-02-26,MO,New Madrid,159,3169,29143
2021-02-27,MO,New Madrid,26,3195,29143
2021-03-01,MO,New Madrid,127,3322,29143
2021-03-02,MO,New Madrid,149,3471,29143
2021-03-03,MO,New Madrid,149,3620,29143
2021-03-04,MO,New Madrid,159,3779,29143
2021-03-05,MO,New Madrid,124,3903,29143
2021-03-06,MO,New Madrid,12,3915,29143
2021-03-08,MO,New Madrid,135,4050,29143
2021-03-09,MO,New Madrid,95,4145,29143
2021-03-10,MO,New Madrid,35,4180,29143
2021-03-11,MO,New Madrid,61,4241,29143
2021-03-12,MO,New Madrid,32,4273,29143
2021-03-13,MO,New Madrid,6,4279,29143
2021-03-14,MO,New Madrid,27,4306,29143
2021-03-15,MO,New Madrid,37,4343,29143
2021-03-16,MO,New Madrid,52,4395,29143
2021-03-17,MO,New Madrid,49,4444,29143
2021-03-18,MO,New Madrid,92,4536,29143
2021-03-19,MO,New Madrid,37,4573,29143
2021-03-20,MO,New Madrid,8,4581,29143
2021-03-21,MO,New Madrid,7,4588,29143
2021-03-22,MO,New Madrid,54,4642,29143
2021-03-23,MO,New Madrid,22,4664,29143
2021-03-24,MO,New Madrid,291,4955,29143
2021-03-25,MO,New Madrid,122,5077,29143
2021-03-26,MO,New Madrid,61,5138,29143
2021-03-27,MO,New Madrid,6,5144,29143
2021-03-28,MO,New Madrid,16,5160,29143
2021-03-29,MO,New Madrid,99,5259,29143
2021-03-30,MO,New Madrid,112,5371,29143
2021-03-31,MO,New Madrid,75,5446,29143
2021-04-01,MO,New Madrid,67,5513,29143
2021-04-02,MO,New Madrid,13,5526,29143
2021-04-03,MO,New Madrid,8,5534,29143
2021-04-04,MO,New Madrid,1,5535,29143
2021-04-05,MO,New Madrid,35,5570,29143
2021-04-06,MO,New Madrid,46,5616,29143
2021-04-07,MO,New Madrid,27,5643,29143
2021-04-08,MO,New Madrid,100,5743,29143
2021-04-09,MO,New Madrid,66,5809,29143
2021-04-10,MO,New Madrid,7,5816,29143
2021-04-11,MO,New Madrid,8,5824,29143
2021-04-12,MO,New Madrid,28,5852,29143
2021-04-13,MO,New Madrid,22,5874,29143
2021-04-14,MO,New Madrid,206,6080,29143
2021-04-15,MO,New Madrid,58,6138,29143
2021-04-16,MO,New Madrid,104,6242,29143
2021-04-17,MO,New Madrid,8,6250,29143
2021-04-18,MO,New Madrid,15,6265,29143
2021-04-19,MO,New Madrid,88,6353,29143
2021-04-20,MO,New Madrid,22,6375,29143
2021-04-21,MO,New Madrid,20,6395,29143
2021-04-22,MO,New Madrid,67,6462,29143
2021-04-23,MO,New Madrid,18,6480,29143
2021-04-24,MO,New Madrid,4,6484,29143
2021-04-25,MO,New Madrid,1,6485,29143
2020-12-16,MO,Newton,8,8,29145
2020-12-17,MO,Newton,20,28,29145
2020-12-18,MO,Newton,21,49,29145
2020-12-19,MO,Newton,6,55,29145
2020-12-20,MO,Newton,2,57,29145
2020-12-21,MO,Newton,11,68,29145
2020-12-22,MO,Newton,21,89,29145
2020-12-23,MO,Newton,28,117,29145
2020-12-24,MO,Newton,2,119,29145
2020-12-28,MO,Newton,20,139,29145
2020-12-29,MO,Newton,11,150,29145
2020-12-30,MO,Newton,208,358,29145
2020-12-31,MO,Newton,60,418,29145
2021-01-02,MO,Newton,3,421,29145
2021-01-04,MO,Newton,7,428,29145
2021-01-05,MO,Newton,8,436,29145
2021-01-06,MO,Newton,35,471,29145
2021-01-07,MO,Newton,57,528,29145
2021-01-08,MO,Newton,44,572,29145
2021-01-09,MO,Newton,14,586,29145
2021-01-10,MO,Newton,3,589,29145
2021-01-11,MO,Newton,28,617,29145
2021-01-12,MO,Newton,71,688,29145
2021-01-13,MO,Newton,110,798,29145
2021-01-14,MO,Newton,61,859,29145
2021-01-15,MO,Newton,25,884,29145
2021-01-16,MO,Newton,11,895,29145
2021-01-18,MO,Newton,80,975,29145
2021-01-19,MO,Newton,43,1018,29145
2021-01-20,MO,Newton,124,1142,29145
2021-01-21,MO,Newton,119,1261,29145
2021-01-22,MO,Newton,45,1306,29145
2021-01-23,MO,Newton,11,1317,29145
2021-01-24,MO,Newton,1,1318,29145
2021-01-25,MO,Newton,36,1354,29145
2021-01-26,MO,Newton,83,1437,29145
2021-01-27,MO,Newton,224,1661,29145
2021-01-28,MO,Newton,39,1700,29145
2021-01-29,MO,Newton,156,1856,29145
2021-01-30,MO,Newton,4,1860,29145
2021-02-01,MO,Newton,58,1918,29145
2021-02-02,MO,Newton,149,2067,29145
2021-02-03,MO,Newton,126,2193,29145
2021-02-04,MO,Newton,173,2366,29145
2021-02-05,MO,Newton,216,2582,29145
2021-02-06,MO,Newton,3,2585,29145
2021-02-07,MO,Newton,1,2586,29145
2021-02-08,MO,Newton,100,2686,29145
2021-02-09,MO,Newton,105,2791,29145
2021-02-10,MO,Newton,143,2934,29145
2021-02-11,MO,Newton,198,3132,29145
2021-02-12,MO,Newton,263,3395,29145
2021-02-13,MO,Newton,72,3467,29145
2021-02-14,MO,Newton,3,3470,29145
2021-02-15,MO,Newton,62,3532,29145
2021-02-16,MO,Newton,31,3563,29145
2021-02-17,MO,Newton,51,3614,29145
2021-02-18,MO,Newton,75,3689,29145
2021-02-19,MO,Newton,230,3919,29145
2021-02-20,MO,Newton,16,3935,29145
2021-02-21,MO,Newton,1,3936,29145
2021-02-22,MO,Newton,12,3948,29145
2021-02-23,MO,Newton,245,4193,29145
2021-02-24,MO,Newton,164,4357,29145
2021-02-25,MO,Newton,575,4932,29145
2021-02-26,MO,Newton,319,5251,29145
2021-02-27,MO,Newton,117,5368,29145
2021-02-28,MO,Newton,1,5369,29145
2021-03-01,MO,Newton,89,5458,29145
2021-03-02,MO,Newton,320,5778,29145
2021-03-03,MO,Newton,199,5977,29145
2021-03-04,MO,Newton,136,6113,29145
2021-03-05,MO,Newton,141,6254,29145
2021-03-06,MO,Newton,39,6293,29145
2021-03-07,MO,Newton,12,6305,29145
2021-03-08,MO,Newton,119,6424,29145
2021-03-09,MO,Newton,311,6735,29145
2021-03-10,MO,Newton,95,6830,29145
2021-03-11,MO,Newton,259,7089,29145
2021-03-12,MO,Newton,457,7546,29145
2021-03-13,MO,Newton,76,7622,29145
2021-03-14,MO,Newton,13,7635,29145
2021-03-15,MO,Newton,166,7801,29145
2021-03-16,MO,Newton,169,7970,29145
2021-03-17,MO,Newton,101,8071,29145
2021-03-18,MO,Newton,525,8596,29145
2021-03-19,MO,Newton,414,9010,29145
2021-03-20,MO,Newton,41,9051,29145
2021-03-21,MO,Newton,14,9065,29145
2021-03-22,MO,Newton,54,9119,29145
2021-03-23,MO,Newton,490,9609,29145
2021-03-24,MO,Newton,201,9810,29145
2021-03-25,MO,Newton,177,9987,29145
2021-03-26,MO,Newton,333,10320,29145
2021-03-27,MO,Newton,249,10569,29145
2021-03-28,MO,Newton,14,10583,29145
2021-03-29,MO,Newton,178,10761,29145
2021-03-30,MO,Newton,216,10977,29145
2021-03-31,MO,Newton,110,11087,29145
2021-04-01,MO,Newton,311,11398,29145
2021-04-02,MO,Newton,344,11742,29145
2021-04-03,MO,Newton,38,11780,29145
2021-04-04,MO,Newton,8,11788,29145
2021-04-05,MO,Newton,174,11962,29145
2021-04-06,MO,Newton,274,12236,29145
2021-04-07,MO,Newton,119,12355,29145
2021-04-08,MO,Newton,114,12469,29145
2021-04-09,MO,Newton,465,12934,29145
2021-04-10,MO,Newton,46,12980,29145
2021-04-11,MO,Newton,12,12992,29145
2021-04-12,MO,Newton,171,13163,29145
2021-04-13,MO,Newton,187,13350,29145
2021-04-14,MO,Newton,90,13440,29145
2021-04-15,MO,Newton,147,13587,29145
2021-04-16,MO,Newton,110,13697,29145
2021-04-17,MO,Newton,202,13899,29145
2021-04-18,MO,Newton,10,13909,29145
2021-04-19,MO,Newton,129,14038,29145
2021-04-20,MO,Newton,157,14195,29145
2021-04-21,MO,Newton,87,14282,29145
2021-04-22,MO,Newton,131,14413,29145
2021-04-23,MO,Newton,192,14605,29145
2021-04-24,MO,Newton,30,14635,29145
2021-04-25,MO,Newton,7,14642,29145
2020-12-18,MO,Nodaway,1,1,29147
2020-12-20,MO,Nodaway,1,2,29147
2020-12-21,MO,Nodaway,2,4,29147
2020-12-22,MO,Nodaway,7,11,29147
2020-12-23,MO,Nodaway,35,46,29147
2020-12-27,MO,Nodaway,19,65,29147
2020-12-28,MO,Nodaway,166,231,29147
2020-12-29,MO,Nodaway,25,256,29147
2020-12-30,MO,Nodaway,79,335,29147
2020-12-31,MO,Nodaway,19,354,29147
2021-01-02,MO,Nodaway,26,380,29147
2021-01-03,MO,Nodaway,11,391,29147
2021-01-04,MO,Nodaway,22,413,29147
2021-01-05,MO,Nodaway,46,459,29147
2021-01-06,MO,Nodaway,8,467,29147
2021-01-07,MO,Nodaway,3,470,29147
2021-01-08,MO,Nodaway,2,472,29147
2021-01-10,MO,Nodaway,2,474,29147
2021-01-11,MO,Nodaway,7,481,29147
2021-01-12,MO,Nodaway,70,551,29147
2021-01-13,MO,Nodaway,78,629,29147
2021-01-14,MO,Nodaway,10,639,29147
2021-01-15,MO,Nodaway,26,665,29147
2021-01-16,MO,Nodaway,3,668,29147
2021-01-17,MO,Nodaway,1,669,29147
2021-01-18,MO,Nodaway,5,674,29147
2021-01-19,MO,Nodaway,17,691,29147
2021-01-20,MO,Nodaway,103,794,29147
2021-01-21,MO,Nodaway,9,803,29147
2021-01-22,MO,Nodaway,103,906,29147
2021-01-23,MO,Nodaway,4,910,29147
2021-01-25,MO,Nodaway,40,950,29147
2021-01-26,MO,Nodaway,672,1622,29147
2021-01-27,MO,Nodaway,95,1717,29147
2021-01-28,MO,Nodaway,127,1844,29147
2021-01-29,MO,Nodaway,47,1891,29147
2021-01-30,MO,Nodaway,30,1921,29147
2021-01-31,MO,Nodaway,6,1927,29147
2021-02-01,MO,Nodaway,21,1948,29147
2021-02-02,MO,Nodaway,129,2077,29147
2021-02-03,MO,Nodaway,149,2226,29147
2021-02-04,MO,Nodaway,1020,3246,29147
2021-02-05,MO,Nodaway,31,3277,29147
2021-02-06,MO,Nodaway,2,3279,29147
2021-02-07,MO,Nodaway,2,3281,29147
2021-02-08,MO,Nodaway,41,3322,29147
2021-02-09,MO,Nodaway,77,3399,29147
2021-02-10,MO,Nodaway,73,3472,29147
2021-02-11,MO,Nodaway,384,3856,29147
2021-02-12,MO,Nodaway,128,3984,29147
2021-02-13,MO,Nodaway,14,3998,29147
2021-02-14,MO,Nodaway,7,4005,29147
2021-02-15,MO,Nodaway,10,4015,29147
2021-02-16,MO,Nodaway,32,4047,29147
2021-02-17,MO,Nodaway,712,4759,29147
2021-02-18,MO,Nodaway,18,4777,29147
2021-02-19,MO,Nodaway,61,4838,29147
2021-02-20,MO,Nodaway,4,4842,29147
2021-02-22,MO,Nodaway,43,4885,29147
2021-02-23,MO,Nodaway,37,4922,29147
2021-02-24,MO,Nodaway,60,4982,29147
2021-02-25,MO,Nodaway,121,5103,29147
2021-02-26,MO,Nodaway,1063,6166,29147
2021-02-27,MO,Nodaway,17,6183,29147
2021-02-28,MO,Nodaway,4,6187,29147
2021-03-01,MO,Nodaway,98,6285,29147
2021-03-02,MO,Nodaway,100,6385,29147
2021-03-03,MO,Nodaway,106,6491,29147
2021-03-04,MO,Nodaway,157,6648,29147
2021-03-05,MO,Nodaway,68,6716,29147
2021-03-06,MO,Nodaway,14,6730,29147
2021-03-07,MO,Nodaway,7,6737,29147
2021-03-08,MO,Nodaway,34,6771,29147
2021-03-09,MO,Nodaway,66,6837,29147
2021-03-10,MO,Nodaway,538,7375,29147
2021-03-11,MO,Nodaway,90,7465,29147
2021-03-12,MO,Nodaway,65,7530,29147
2021-03-13,MO,Nodaway,4,7534,29147
2021-03-14,MO,Nodaway,3,7537,29147
2021-03-15,MO,Nodaway,525,8062,29147
2021-03-16,MO,Nodaway,44,8106,29147
2021-03-17,MO,Nodaway,78,8184,29147
2021-03-18,MO,Nodaway,185,8369,29147
2021-03-19,MO,Nodaway,104,8473,29147
2021-03-20,MO,Nodaway,27,8500,29147
2021-03-21,MO,Nodaway,10,8510,29147
2021-03-22,MO,Nodaway,39,8549,29147
2021-03-23,MO,Nodaway,58,8607,29147
2021-03-24,MO,Nodaway,381,8988,29147
2021-03-25,MO,Nodaway,119,9107,29147
2021-03-26,MO,Nodaway,49,9156,29147
2021-03-27,MO,Nodaway,24,9180,29147
2021-03-28,MO,Nodaway,17,9197,29147
2021-03-29,MO,Nodaway,78,9275,29147
2021-03-30,MO,Nodaway,83,9358,29147
2021-03-31,MO,Nodaway,446,9804,29147
2021-04-01,MO,Nodaway,119,9923,29147
2021-04-02,MO,Nodaway,67,9990,29147
2021-04-03,MO,Nodaway,17,10007,29147
2021-04-04,MO,Nodaway,4,10011,29147
2021-04-05,MO,Nodaway,42,10053,29147
2021-04-06,MO,Nodaway,154,10207,29147
2021-04-07,MO,Nodaway,821,11028,29147
2021-04-08,MO,Nodaway,190,11218,29147
2021-04-09,MO,Nodaway,97,11315,29147
2021-04-10,MO,Nodaway,27,11342,29147
2021-04-11,MO,Nodaway,14,11356,29147
2021-04-12,MO,Nodaway,46,11402,29147
2021-04-13,MO,Nodaway,78,11480,29147
2021-04-14,MO,Nodaway,477,11957,29147
2021-04-15,MO,Nodaway,117,12074,29147
2021-04-16,MO,Nodaway,77,12151,29147
2021-04-17,MO,Nodaway,14,12165,29147
2021-04-18,MO,Nodaway,16,12181,29147
2021-04-19,MO,Nodaway,41,12222,29147
2021-04-20,MO,Nodaway,77,12299,29147
2021-04-21,MO,Nodaway,177,12476,29147
2021-04-22,MO,Nodaway,61,12537,29147
2021-04-23,MO,Nodaway,50,12587,29147
2021-04-24,MO,Nodaway,25,12612,29147
2020-12-16,MO,Oregon,2,2,29149
2020-12-19,MO,Oregon,1,3,29149
2020-12-22,MO,Oregon,9,12,29149
2020-12-23,MO,Oregon,21,33,29149
2020-12-24,MO,Oregon,3,36,29149
2020-12-26,MO,Oregon,1,37,29149
2020-12-28,MO,Oregon,12,49,29149
2020-12-29,MO,Oregon,10,59,29149
2020-12-30,MO,Oregon,12,71,29149
2020-12-31,MO,Oregon,2,73,29149
2021-01-04,MO,Oregon,1,74,29149
2021-01-05,MO,Oregon,50,124,29149
2021-01-06,MO,Oregon,8,132,29149
2021-01-07,MO,Oregon,5,137,29149
2021-01-09,MO,Oregon,5,142,29149
2021-01-11,MO,Oregon,21,163,29149
2021-01-12,MO,Oregon,18,181,29149
2021-01-13,MO,Oregon,2,183,29149
2021-01-14,MO,Oregon,5,188,29149
2021-01-15,MO,Oregon,1,189,29149
2021-01-18,MO,Oregon,3,192,29149
2021-01-19,MO,Oregon,4,196,29149
2021-01-20,MO,Oregon,9,205,29149
2021-01-21,MO,Oregon,1,206,29149
2021-01-22,MO,Oregon,7,213,29149
2021-01-23,MO,Oregon,1,214,29149
2021-01-25,MO,Oregon,26,240,29149
2021-01-26,MO,Oregon,20,260,29149
2021-01-27,MO,Oregon,21,281,29149
2021-01-28,MO,Oregon,41,322,29149
2021-01-29,MO,Oregon,138,460,29149
2021-01-30,MO,Oregon,3,463,29149
2021-02-01,MO,Oregon,19,482,29149
2021-02-02,MO,Oregon,85,567,29149
2021-02-03,MO,Oregon,29,596,29149
2021-02-04,MO,Oregon,3,599,29149
2021-02-05,MO,Oregon,126,725,29149
2021-02-06,MO,Oregon,6,731,29149
2021-02-08,MO,Oregon,46,777,29149
2021-02-09,MO,Oregon,13,790,29149
2021-02-10,MO,Oregon,26,816,29149
2021-02-11,MO,Oregon,7,823,29149
2021-02-12,MO,Oregon,25,848,29149
2021-02-13,MO,Oregon,14,862,29149
2021-02-14,MO,Oregon,7,869,29149
2021-02-15,MO,Oregon,14,883,29149
2021-02-16,MO,Oregon,16,899,29149
2021-02-17,MO,Oregon,7,906,29149
2021-02-18,MO,Oregon,18,924,29149
2021-02-19,MO,Oregon,22,946,29149
2021-02-20,MO,Oregon,10,956,29149
2021-02-21,MO,Oregon,7,963,29149
2021-02-22,MO,Oregon,14,977,29149
2021-02-23,MO,Oregon,33,1010,29149
2021-02-24,MO,Oregon,7,1017,29149
2021-02-25,MO,Oregon,15,1032,29149
2021-02-26,MO,Oregon,285,1317,29149
2021-02-27,MO,Oregon,2,1319,29149
2021-02-28,MO,Oregon,10,1329,29149
2021-03-01,MO,Oregon,36,1365,29149
2021-03-02,MO,Oregon,96,1461,29149
2021-03-03,MO,Oregon,15,1476,29149
2021-03-04,MO,Oregon,14,1490,29149
2021-03-05,MO,Oregon,186,1676,29149
2021-03-06,MO,Oregon,3,1679,29149
2021-03-08,MO,Oregon,24,1703,29149
2021-03-09,MO,Oregon,70,1773,29149
2021-03-10,MO,Oregon,36,1809,29149
2021-03-11,MO,Oregon,17,1826,29149
2021-03-12,MO,Oregon,24,1850,29149
2021-03-13,MO,Oregon,2,1852,29149
2021-03-14,MO,Oregon,13,1865,29149
2021-03-15,MO,Oregon,46,1911,29149
2021-03-16,MO,Oregon,65,1976,29149
2021-03-17,MO,Oregon,14,1990,29149
2021-03-18,MO,Oregon,69,2059,29149
2021-03-19,MO,Oregon,40,2099,29149
2021-03-20,MO,Oregon,24,2123,29149
2021-03-21,MO,Oregon,1,2124,29149
2021-03-22,MO,Oregon,19,2143,29149
2021-03-23,MO,Oregon,59,2202,29149
2021-03-24,MO,Oregon,17,2219,29149
2021-03-25,MO,Oregon,18,2237,29149
2021-03-26,MO,Oregon,172,2409,29149
2021-03-27,MO,Oregon,4,2413,29149
2021-03-29,MO,Oregon,15,2428,29149
2021-03-30,MO,Oregon,89,2517,29149
2021-03-31,MO,Oregon,31,2548,29149
2021-04-01,MO,Oregon,41,2589,29149
2021-04-02,MO,Oregon,5,2594,29149
2021-04-04,MO,Oregon,1,2595,29149
2021-04-05,MO,Oregon,19,2614,29149
2021-04-06,MO,Oregon,90,2704,29149
2021-04-07,MO,Oregon,39,2743,29149
2021-04-08,MO,Oregon,39,2782,29149
2021-04-09,MO,Oregon,59,2841,29149
2021-04-10,MO,Oregon,9,2850,29149
2021-04-11,MO,Oregon,10,2860,29149
2021-04-12,MO,Oregon,19,2879,29149
2021-04-13,MO,Oregon,59,2938,29149
2021-04-14,MO,Oregon,22,2960,29149
2021-04-15,MO,Oregon,51,3011,29149
2021-04-16,MO,Oregon,39,3050,29149
2021-04-17,MO,Oregon,17,3067,29149
2021-04-19,MO,Oregon,33,3100,29149
2021-04-20,MO,Oregon,16,3116,29149
2021-04-21,MO,Oregon,31,3147,29149
2021-04-22,MO,Oregon,22,3169,29149
2021-04-23,MO,Oregon,38,3207,29149
2021-04-24,MO,Oregon,2,3209,29149
2020-12-15,MO,Osage,1,1,29151
2020-12-16,MO,Osage,10,11,29151
2020-12-17,MO,Osage,21,32,29151
2020-12-18,MO,Osage,28,60,29151
2020-12-19,MO,Osage,2,62,29151
2020-12-20,MO,Osage,1,63,29151
2020-12-21,MO,Osage,18,81,29151
2020-12-22,MO,Osage,5,86,29151
2020-12-23,MO,Osage,3,89,29151
2020-12-24,MO,Osage,1,90,29151
2020-12-28,MO,Osage,3,93,29151
2020-12-30,MO,Osage,3,96,29151
2020-12-31,MO,Osage,3,99,29151
2021-01-01,MO,Osage,1,100,29151
2021-01-04,MO,Osage,5,105,29151
2021-01-05,MO,Osage,5,110,29151
2021-01-06,MO,Osage,20,130,29151
2021-01-07,MO,Osage,36,166,29151
2021-01-08,MO,Osage,25,191,29151
2021-01-09,MO,Osage,1,192,29151
2021-01-11,MO,Osage,21,213,29151
2021-01-12,MO,Osage,7,220,29151
2021-01-13,MO,Osage,65,285,29151
2021-01-14,MO,Osage,12,297,29151
2021-01-15,MO,Osage,17,314,29151
2021-01-16,MO,Osage,3,317,29151
2021-01-18,MO,Osage,34,351,29151
2021-01-19,MO,Osage,15,366,29151
2021-01-20,MO,Osage,14,380,29151
2021-01-21,MO,Osage,26,406,29151
2021-01-22,MO,Osage,73,479,29151
2021-01-23,MO,Osage,54,533,29151
2021-01-25,MO,Osage,80,613,29151
2021-01-26,MO,Osage,32,645,29151
2021-01-27,MO,Osage,45,690,29151
2021-01-28,MO,Osage,32,722,29151
2021-01-29,MO,Osage,138,860,29151
2021-01-30,MO,Osage,68,928,29151
2021-01-31,MO,Osage,6,934,29151
2021-02-01,MO,Osage,194,1128,29151
2021-02-02,MO,Osage,10,1138,29151
2021-02-03,MO,Osage,17,1155,29151
2021-02-04,MO,Osage,70,1225,29151
2021-02-05,MO,Osage,67,1292,29151
2021-02-06,MO,Osage,22,1314,29151
2021-02-08,MO,Osage,108,1422,29151
2021-02-09,MO,Osage,23,1445,29151
2021-02-10,MO,Osage,87,1532,29151
2021-02-11,MO,Osage,75,1607,29151
2021-02-12,MO,Osage,72,1679,29151
2021-02-13,MO,Osage,65,1744,29151
2021-02-14,MO,Osage,2,1746,29151
2021-02-15,MO,Osage,14,1760,29151
2021-02-16,MO,Osage,22,1782,29151
2021-02-17,MO,Osage,21,1803,29151
2021-02-18,MO,Osage,55,1858,29151
2021-02-19,MO,Osage,170,2028,29151
2021-02-20,MO,Osage,68,2096,29151
2021-02-22,MO,Osage,294,2390,29151
2021-02-23,MO,Osage,18,2408,29151
2021-02-24,MO,Osage,36,2444,29151
2021-02-25,MO,Osage,31,2475,29151
2021-02-26,MO,Osage,119,2594,29151
2021-02-27,MO,Osage,32,2626,29151
2021-02-28,MO,Osage,2,2628,29151
2021-03-01,MO,Osage,265,2893,29151
2021-03-02,MO,Osage,19,2912,29151
2021-03-03,MO,Osage,42,2954,29151
2021-03-04,MO,Osage,67,3021,29151
2021-03-05,MO,Osage,54,3075,29151
2021-03-06,MO,Osage,4,3079,29151
2021-03-07,MO,Osage,8,3087,29151
2021-03-08,MO,Osage,215,3302,29151
2021-03-09,MO,Osage,14,3316,29151
2021-03-10,MO,Osage,98,3414,29151
2021-03-11,MO,Osage,83,3497,29151
2021-03-12,MO,Osage,42,3539,29151
2021-03-13,MO,Osage,6,3545,29151
2021-03-15,MO,Osage,146,3691,29151
2021-03-16,MO,Osage,122,3813,29151
2021-03-17,MO,Osage,36,3849,29151
2021-03-18,MO,Osage,32,3881,29151
2021-03-19,MO,Osage,53,3934,29151
2021-03-20,MO,Osage,8,3942,29151
2021-03-21,MO,Osage,15,3957,29151
2021-03-22,MO,Osage,258,4215,29151
2021-03-23,MO,Osage,27,4242,29151
2021-03-24,MO,Osage,45,4287,29151
2021-03-25,MO,Osage,70,4357,29151
2021-03-26,MO,Osage,61,4418,29151
2021-03-27,MO,Osage,27,4445,29151
2021-03-28,MO,Osage,4,4449,29151
2021-03-29,MO,Osage,214,4663,29151
2021-03-30,MO,Osage,31,4694,29151
2021-03-31,MO,Osage,43,4737,29151
2021-04-01,MO,Osage,100,4837,29151
2021-04-02,MO,Osage,84,4921,29151
2021-04-03,MO,Osage,1,4922,29151
2021-04-04,MO,Osage,2,4924,29151
2021-04-05,MO,Osage,276,5200,29151
2021-04-06,MO,Osage,41,5241,29151
2021-04-07,MO,Osage,51,5292,29151
2021-04-08,MO,Osage,55,5347,29151
2021-04-09,MO,Osage,70,5417,29151
2021-04-10,MO,Osage,19,5436,29151
2021-04-11,MO,Osage,1,5437,29151
2021-04-12,MO,Osage,124,5561,29151
2021-04-13,MO,Osage,36,5597,29151
2021-04-14,MO,Osage,47,5644,29151
2021-04-15,MO,Osage,79,5723,29151
2021-04-16,MO,Osage,40,5763,29151
2021-04-17,MO,Osage,15,5778,29151
2021-04-18,MO,Osage,1,5779,29151
2021-04-19,MO,Osage,44,5823,29151
2021-04-20,MO,Osage,21,5844,29151
2021-04-21,MO,Osage,33,5877,29151
2021-04-22,MO,Osage,24,5901,29151
2021-04-23,MO,Osage,35,5936,29151
2021-04-24,MO,Osage,2,5938,29151
2021-04-25,MO,Osage,1,5939,29151
2020-12-22,MO,Ozark,6,6,29153
2020-12-23,MO,Ozark,5,11,29153
2020-12-24,MO,Ozark,1,12,29153
2020-12-28,MO,Ozark,2,14,29153
2020-12-29,MO,Ozark,1,15,29153
2020-12-30,MO,Ozark,10,25,29153
2020-12-31,MO,Ozark,26,51,29153
2021-01-02,MO,Ozark,1,52,29153
2021-01-04,MO,Ozark,2,54,29153
2021-01-05,MO,Ozark,1,55,29153
2021-01-06,MO,Ozark,5,60,29153
2021-01-07,MO,Ozark,2,62,29153
2021-01-09,MO,Ozark,7,69,29153
2021-01-11,MO,Ozark,3,72,29153
2021-01-13,MO,Ozark,1,73,29153
2021-01-15,MO,Ozark,1,74,29153
2021-01-18,MO,Ozark,2,76,29153
2021-01-19,MO,Ozark,5,81,29153
2021-01-20,MO,Ozark,11,92,29153
2021-01-21,MO,Ozark,3,95,29153
2021-01-22,MO,Ozark,10,105,29153
2021-01-23,MO,Ozark,3,108,29153
2021-01-25,MO,Ozark,4,112,29153
2021-01-26,MO,Ozark,6,118,29153
2021-01-27,MO,Ozark,16,134,29153
2021-01-28,MO,Ozark,74,208,29153
2021-01-29,MO,Ozark,125,333,29153
2021-01-30,MO,Ozark,5,338,29153
2021-02-01,MO,Ozark,14,352,29153
2021-02-02,MO,Ozark,79,431,29153
2021-02-03,MO,Ozark,107,538,29153
2021-02-04,MO,Ozark,69,607,29153
2021-02-05,MO,Ozark,20,627,29153
2021-02-06,MO,Ozark,23,650,29153
2021-02-08,MO,Ozark,8,658,29153
2021-02-09,MO,Ozark,66,724,29153
2021-02-10,MO,Ozark,22,746,29153
2021-02-11,MO,Ozark,9,755,29153
2021-02-12,MO,Ozark,16,771,29153
2021-02-13,MO,Ozark,5,776,29153
2021-02-15,MO,Ozark,1,777,29153
2021-02-16,MO,Ozark,4,781,29153
2021-02-17,MO,Ozark,1,782,29153
2021-02-18,MO,Ozark,7,789,29153
2021-02-19,MO,Ozark,8,797,29153
2021-02-20,MO,Ozark,2,799,29153
2021-02-22,MO,Ozark,1,800,29153
2021-02-23,MO,Ozark,182,982,29153
2021-02-24,MO,Ozark,11,993,29153
2021-02-25,MO,Ozark,21,1014,29153
2021-02-26,MO,Ozark,106,1120,29153
2021-02-27,MO,Ozark,28,1148,29153
2021-02-28,MO,Ozark,12,1160,29153
2021-03-01,MO,Ozark,5,1165,29153
2021-03-02,MO,Ozark,38,1203,29153
2021-03-03,MO,Ozark,121,1324,29153
2021-03-04,MO,Ozark,11,1335,29153
2021-03-05,MO,Ozark,16,1351,29153
2021-03-06,MO,Ozark,9,1360,29153
2021-03-08,MO,Ozark,13,1373,29153
2021-03-09,MO,Ozark,69,1442,29153
2021-03-10,MO,Ozark,78,1520,29153
2021-03-11,MO,Ozark,25,1545,29153
2021-03-12,MO,Ozark,43,1588,29153
2021-03-13,MO,Ozark,5,1593,29153
2021-03-15,MO,Ozark,12,1605,29153
2021-03-16,MO,Ozark,6,1611,29153
2021-03-17,MO,Ozark,11,1622,29153
2021-03-18,MO,Ozark,15,1637,29153
2021-03-19,MO,Ozark,4,1641,29153
2021-03-20,MO,Ozark,8,1649,29153
2021-03-21,MO,Ozark,2,1651,29153
2021-03-22,MO,Ozark,10,1661,29153
2021-03-23,MO,Ozark,178,1839,29153
2021-03-24,MO,Ozark,16,1855,29153
2021-03-25,MO,Ozark,10,1865,29153
2021-03-26,MO,Ozark,158,2023,29153
2021-03-27,MO,Ozark,8,2031,29153
2021-03-28,MO,Ozark,1,2032,29153
2021-03-29,MO,Ozark,5,2037,29153
2021-03-30,MO,Ozark,24,2061,29153
2021-03-31,MO,Ozark,19,2080,29153
2021-04-01,MO,Ozark,18,2098,29153
2021-04-02,MO,Ozark,17,2115,29153
2021-04-03,MO,Ozark,2,2117,29153
2021-04-04,MO,Ozark,1,2118,29153
2021-04-05,MO,Ozark,13,2131,29153
2021-04-06,MO,Ozark,113,2244,29153
2021-04-07,MO,Ozark,26,2270,29153
2021-04-08,MO,Ozark,17,2287,29153
2021-04-09,MO,Ozark,37,2324,29153
2021-04-10,MO,Ozark,6,2330,29153
2021-04-11,MO,Ozark,1,2331,29153
2021-04-12,MO,Ozark,19,2350,29153
2021-04-13,MO,Ozark,14,2364,29153
2021-04-14,MO,Ozark,13,2377,29153
2021-04-15,MO,Ozark,11,2388,29153
2021-04-16,MO,Ozark,58,2446,29153
2021-04-17,MO,Ozark,7,2453,29153
2021-04-18,MO,Ozark,4,2457,29153
2021-04-19,MO,Ozark,10,2467,29153
2021-04-20,MO,Ozark,6,2473,29153
2021-04-21,MO,Ozark,12,2485,29153
2021-04-22,MO,Ozark,8,2493,29153
2021-04-23,MO,Ozark,6,2499,29153
2021-04-24,MO,Ozark,7,2506,29153
2020-12-22,MO,Pemiscot,2,2,29155
2020-12-29,MO,Pemiscot,44,46,29155
2020-12-30,MO,Pemiscot,29,75,29155
2020-12-31,MO,Pemiscot,6,81,29155
2021-01-01,MO,Pemiscot,1,82,29155
2021-01-04,MO,Pemiscot,2,84,29155
2021-01-05,MO,Pemiscot,1,85,29155
2021-01-06,MO,Pemiscot,2,87,29155
2021-01-07,MO,Pemiscot,2,89,29155
2021-01-08,MO,Pemiscot,3,92,29155
2021-01-10,MO,Pemiscot,1,93,29155
2021-01-11,MO,Pemiscot,52,145,29155
2021-01-12,MO,Pemiscot,7,152,29155
2021-01-13,MO,Pemiscot,1,153,29155
2021-01-14,MO,Pemiscot,6,159,29155
2021-01-15,MO,Pemiscot,4,163,29155
2021-01-18,MO,Pemiscot,23,186,29155
2021-01-19,MO,Pemiscot,62,248,29155
2021-01-20,MO,Pemiscot,25,273,29155
2021-01-21,MO,Pemiscot,35,308,29155
2021-01-22,MO,Pemiscot,116,424,29155
2021-01-23,MO,Pemiscot,2,426,29155
2021-01-25,MO,Pemiscot,55,481,29155
2021-01-26,MO,Pemiscot,56,537,29155
2021-01-27,MO,Pemiscot,88,625,29155
2021-01-28,MO,Pemiscot,11,636,29155
2021-01-29,MO,Pemiscot,13,649,29155
2021-01-30,MO,Pemiscot,2,651,29155
2021-01-31,MO,Pemiscot,1,652,29155
2021-02-01,MO,Pemiscot,9,661,29155
2021-02-02,MO,Pemiscot,23,684,29155
2021-02-03,MO,Pemiscot,63,747,29155
2021-02-04,MO,Pemiscot,40,787,29155
2021-02-05,MO,Pemiscot,170,957,29155
2021-02-06,MO,Pemiscot,1,958,29155
2021-02-08,MO,Pemiscot,67,1025,29155
2021-02-09,MO,Pemiscot,31,1056,29155
2021-02-10,MO,Pemiscot,3,1059,29155
2021-02-11,MO,Pemiscot,4,1063,29155
2021-02-12,MO,Pemiscot,20,1083,29155
2021-02-13,MO,Pemiscot,1,1084,29155
2021-02-15,MO,Pemiscot,11,1095,29155
2021-02-16,MO,Pemiscot,47,1142,29155
2021-02-17,MO,Pemiscot,19,1161,29155
2021-02-18,MO,Pemiscot,42,1203,29155
2021-02-19,MO,Pemiscot,82,1285,29155
2021-02-20,MO,Pemiscot,107,1392,29155
2021-02-22,MO,Pemiscot,60,1452,29155
2021-02-23,MO,Pemiscot,59,1511,29155
2021-02-24,MO,Pemiscot,61,1572,29155
2021-02-25,MO,Pemiscot,64,1636,29155
2021-02-26,MO,Pemiscot,180,1816,29155
2021-02-27,MO,Pemiscot,229,2045,29155
2021-02-28,MO,Pemiscot,1,2046,29155
2021-03-01,MO,Pemiscot,39,2085,29155
2021-03-02,MO,Pemiscot,74,2159,29155
2021-03-03,MO,Pemiscot,51,2210,29155
2021-03-04,MO,Pemiscot,80,2290,29155
2021-03-05,MO,Pemiscot,58,2348,29155
2021-03-06,MO,Pemiscot,108,2456,29155
2021-03-07,MO,Pemiscot,2,2458,29155
2021-03-08,MO,Pemiscot,16,2474,29155
2021-03-09,MO,Pemiscot,42,2516,29155
2021-03-10,MO,Pemiscot,41,2557,29155
2021-03-11,MO,Pemiscot,19,2576,29155
2021-03-12,MO,Pemiscot,42,2618,29155
2021-03-13,MO,Pemiscot,1,2619,29155
2021-03-15,MO,Pemiscot,194,2813,29155
2021-03-16,MO,Pemiscot,52,2865,29155
2021-03-17,MO,Pemiscot,54,2919,29155
2021-03-18,MO,Pemiscot,49,2968,29155
2021-03-19,MO,Pemiscot,63,3031,29155
2021-03-20,MO,Pemiscot,1,3032,29155
2021-03-22,MO,Pemiscot,53,3085,29155
2021-03-23,MO,Pemiscot,100,3185,29155
2021-03-24,MO,Pemiscot,18,3203,29155
2021-03-25,MO,Pemiscot,119,3322,29155
2021-03-26,MO,Pemiscot,49,3371,29155
2021-03-29,MO,Pemiscot,32,3403,29155
2021-03-30,MO,Pemiscot,70,3473,29155
2021-03-31,MO,Pemiscot,64,3537,29155
2021-04-01,MO,Pemiscot,33,3570,29155
2021-04-02,MO,Pemiscot,27,3597,29155
2021-04-03,MO,Pemiscot,1,3598,29155
2021-04-04,MO,Pemiscot,2,3600,29155
2021-04-05,MO,Pemiscot,11,3611,29155
2021-04-06,MO,Pemiscot,38,3649,29155
2021-04-07,MO,Pemiscot,19,3668,29155
2021-04-08,MO,Pemiscot,25,3693,29155
2021-04-09,MO,Pemiscot,40,3733,29155
2021-04-10,MO,Pemiscot,2,3735,29155
2021-04-11,MO,Pemiscot,1,3736,29155
2021-04-12,MO,Pemiscot,50,3786,29155
2021-04-13,MO,Pemiscot,33,3819,29155
2021-04-14,MO,Pemiscot,34,3853,29155
2021-04-15,MO,Pemiscot,22,3875,29155
2021-04-16,MO,Pemiscot,34,3909,29155
2021-04-17,MO,Pemiscot,1,3910,29155
2021-04-18,MO,Pemiscot,3,3913,29155
2021-04-19,MO,Pemiscot,20,3933,29155
2021-04-20,MO,Pemiscot,30,3963,29155
2021-04-21,MO,Pemiscot,16,3979,29155
2021-04-22,MO,Pemiscot,35,4014,29155
2021-04-23,MO,Pemiscot,25,4039,29155
2021-04-24,MO,Pemiscot,1,4040,29155
2021-04-25,MO,Pemiscot,2,4042,29155
2020-12-16,MO,Perry,1,1,29157
2020-12-17,MO,Perry,5,6,29157
2020-12-18,MO,Perry,7,13,29157
2020-12-19,MO,Perry,1,14,29157
2020-12-20,MO,Perry,1,15,29157
2020-12-21,MO,Perry,24,39,29157
2020-12-22,MO,Perry,28,67,29157
2020-12-23,MO,Perry,76,143,29157
2020-12-24,MO,Perry,5,148,29157
2020-12-26,MO,Perry,1,149,29157
2020-12-27,MO,Perry,2,151,29157
2020-12-28,MO,Perry,4,155,29157
2020-12-29,MO,Perry,12,167,29157
2020-12-30,MO,Perry,41,208,29157
2020-12-31,MO,Perry,7,215,29157
2021-01-02,MO,Perry,2,217,29157
2021-01-05,MO,Perry,6,223,29157
2021-01-06,MO,Perry,10,233,29157
2021-01-07,MO,Perry,13,246,29157
2021-01-08,MO,Perry,25,271,29157
2021-01-09,MO,Perry,9,280,29157
2021-01-10,MO,Perry,1,281,29157
2021-01-11,MO,Perry,126,407,29157
2021-01-12,MO,Perry,28,435,29157
2021-01-13,MO,Perry,143,578,29157
2021-01-14,MO,Perry,10,588,29157
2021-01-15,MO,Perry,38,626,29157
2021-01-16,MO,Perry,3,629,29157
2021-01-17,MO,Perry,1,630,29157
2021-01-18,MO,Perry,131,761,29157
2021-01-19,MO,Perry,66,827,29157
2021-01-20,MO,Perry,86,913,29157
2021-01-21,MO,Perry,57,970,29157
2021-01-22,MO,Perry,206,1176,29157
2021-01-23,MO,Perry,1,1177,29157
2021-01-25,MO,Perry,48,1225,29157
2021-01-26,MO,Perry,53,1278,29157
2021-01-27,MO,Perry,57,1335,29157
2021-01-28,MO,Perry,56,1391,29157
2021-01-29,MO,Perry,773,2164,29157
2021-01-30,MO,Perry,2,2166,29157
2021-01-31,MO,Perry,1,2167,29157
2021-02-01,MO,Perry,10,2177,29157
2021-02-02,MO,Perry,215,2392,29157
2021-02-03,MO,Perry,41,2433,29157
2021-02-04,MO,Perry,17,2450,29157
2021-02-05,MO,Perry,130,2580,29157
2021-02-06,MO,Perry,3,2583,29157
2021-02-07,MO,Perry,1,2584,29157
2021-02-08,MO,Perry,135,2719,29157
2021-02-09,MO,Perry,109,2828,29157
2021-02-10,MO,Perry,107,2935,29157
2021-02-11,MO,Perry,47,2982,29157
2021-02-12,MO,Perry,273,3255,29157
2021-02-13,MO,Perry,3,3258,29157
2021-02-14,MO,Perry,1,3259,29157
2021-02-15,MO,Perry,6,3265,29157
2021-02-16,MO,Perry,14,3279,29157
2021-02-17,MO,Perry,14,3293,29157
2021-02-18,MO,Perry,8,3301,29157
2021-02-19,MO,Perry,716,4017,29157
2021-02-20,MO,Perry,17,4034,29157
2021-02-22,MO,Perry,96,4130,29157
2021-02-23,MO,Perry,120,4250,29157
2021-02-24,MO,Perry,144,4394,29157
2021-02-25,MO,Perry,50,4444,29157
2021-02-26,MO,Perry,242,4686,29157
2021-02-27,MO,Perry,24,4710,29157
2021-03-01,MO,Perry,10,4720,29157
2021-03-02,MO,Perry,127,4847,29157
2021-03-03,MO,Perry,124,4971,29157
2021-03-04,MO,Perry,11,4982,29157
2021-03-05,MO,Perry,116,5098,29157
2021-03-06,MO,Perry,7,5105,29157
2021-03-08,MO,Perry,53,5158,29157
2021-03-09,MO,Perry,47,5205,29157
2021-03-10,MO,Perry,303,5508,29157
2021-03-11,MO,Perry,32,5540,29157
2021-03-12,MO,Perry,164,5704,29157
2021-03-13,MO,Perry,3,5707,29157
2021-03-14,MO,Perry,2,5709,29157
2021-03-15,MO,Perry,39,5748,29157
2021-03-16,MO,Perry,58,5806,29157
2021-03-17,MO,Perry,53,5859,29157
2021-03-18,MO,Perry,13,5872,29157
2021-03-19,MO,Perry,346,6218,29157
2021-03-20,MO,Perry,6,6224,29157
2021-03-21,MO,Perry,2,6226,29157
2021-03-22,MO,Perry,12,6238,29157
2021-03-23,MO,Perry,19,6257,29157
2021-03-24,MO,Perry,91,6348,29157
2021-03-25,MO,Perry,25,6373,29157
2021-03-26,MO,Perry,26,6399,29157
2021-03-27,MO,Perry,6,6405,29157
2021-03-29,MO,Perry,17,6422,29157
2021-03-30,MO,Perry,143,6565,29157
2021-03-31,MO,Perry,125,6690,29157
2021-04-01,MO,Perry,94,6784,29157
2021-04-02,MO,Perry,186,6970,29157
2021-04-03,MO,Perry,17,6987,29157
2021-04-04,MO,Perry,4,6991,29157
2021-04-05,MO,Perry,52,7043,29157
2021-04-06,MO,Perry,64,7107,29157
2021-04-07,MO,Perry,340,7447,29157
2021-04-08,MO,Perry,129,7576,29157
2021-04-09,MO,Perry,105,7681,29157
2021-04-10,MO,Perry,23,7704,29157
2021-04-11,MO,Perry,16,7720,29157
2021-04-12,MO,Perry,85,7805,29157
2021-04-13,MO,Perry,25,7830,29157
2021-04-14,MO,Perry,60,7890,29157
2021-04-15,MO,Perry,51,7941,29157
2021-04-16,MO,Perry,336,8277,29157
2021-04-17,MO,Perry,9,8286,29157
2021-04-18,MO,Perry,1,8287,29157
2021-04-19,MO,Perry,43,8330,29157
2021-04-20,MO,Perry,37,8367,29157
2021-04-21,MO,Perry,80,8447,29157
2021-04-22,MO,Perry,69,8516,29157
2021-04-23,MO,Perry,38,8554,29157
2021-04-24,MO,Perry,9,8563,29157
2021-04-25,MO,Perry,1,8564,29157
2020-12-16,MO,Pettis,9,9,29159
2020-12-17,MO,Pettis,4,13,29159
2020-12-18,MO,Pettis,34,47,29159
2020-12-19,MO,Pettis,5,52,29159
2020-12-20,MO,Pettis,1,53,29159
2020-12-21,MO,Pettis,33,86,29159
2020-12-22,MO,Pettis,65,151,29159
2020-12-23,MO,Pettis,54,205,29159
2020-12-24,MO,Pettis,34,239,29159
2020-12-26,MO,Pettis,1,240,29159
2020-12-27,MO,Pettis,1,241,29159
2020-12-28,MO,Pettis,48,289,29159
2020-12-29,MO,Pettis,98,387,29159
2020-12-30,MO,Pettis,87,474,29159
2020-12-31,MO,Pettis,30,504,29159
2021-01-01,MO,Pettis,2,506,29159
2021-01-02,MO,Pettis,2,508,29159
2021-01-04,MO,Pettis,9,517,29159
2021-01-05,MO,Pettis,18,535,29159
2021-01-06,MO,Pettis,72,607,29159
2021-01-07,MO,Pettis,151,758,29159
2021-01-08,MO,Pettis,45,803,29159
2021-01-09,MO,Pettis,3,806,29159
2021-01-10,MO,Pettis,5,811,29159
2021-01-11,MO,Pettis,57,868,29159
2021-01-12,MO,Pettis,101,969,29159
2021-01-13,MO,Pettis,114,1083,29159
2021-01-14,MO,Pettis,110,1193,29159
2021-01-15,MO,Pettis,115,1308,29159
2021-01-16,MO,Pettis,22,1330,29159
2021-01-17,MO,Pettis,1,1331,29159
2021-01-18,MO,Pettis,71,1402,29159
2021-01-19,MO,Pettis,65,1467,29159
2021-01-20,MO,Pettis,46,1513,29159
2021-01-21,MO,Pettis,54,1567,29159
2021-01-22,MO,Pettis,229,1796,29159
2021-01-23,MO,Pettis,5,1801,29159
2021-01-24,MO,Pettis,3,1804,29159
2021-01-25,MO,Pettis,96,1900,29159
2021-01-26,MO,Pettis,78,1978,29159
2021-01-27,MO,Pettis,131,2109,29159
2021-01-28,MO,Pettis,902,3011,29159
2021-01-29,MO,Pettis,1239,4250,29159
2021-01-30,MO,Pettis,282,4532,29159
2021-01-31,MO,Pettis,15,4547,29159
2021-02-01,MO,Pettis,24,4571,29159
2021-02-02,MO,Pettis,200,4771,29159
2021-02-03,MO,Pettis,422,5193,29159
2021-02-04,MO,Pettis,314,5507,29159
2021-02-05,MO,Pettis,154,5661,29159
2021-02-06,MO,Pettis,6,5667,29159
2021-02-07,MO,Pettis,1,5668,29159
2021-02-08,MO,Pettis,82,5750,29159
2021-02-09,MO,Pettis,303,6053,29159
2021-02-10,MO,Pettis,134,6187,29159
2021-02-11,MO,Pettis,89,6276,29159
2021-02-12,MO,Pettis,288,6564,29159
2021-02-13,MO,Pettis,140,6704,29159
2021-02-14,MO,Pettis,14,6718,29159
2021-02-15,MO,Pettis,52,6770,29159
2021-02-16,MO,Pettis,25,6795,29159
2021-02-17,MO,Pettis,59,6854,29159
2021-02-18,MO,Pettis,209,7063,29159
2021-02-19,MO,Pettis,249,7312,29159
2021-02-20,MO,Pettis,8,7320,29159
2021-02-21,MO,Pettis,5,7325,29159
2021-02-22,MO,Pettis,53,7378,29159
2021-02-23,MO,Pettis,938,8316,29159
2021-02-24,MO,Pettis,524,8840,29159
2021-02-25,MO,Pettis,1184,10024,29159
2021-02-26,MO,Pettis,429,10453,29159
2021-02-27,MO,Pettis,218,10671,29159
2021-02-28,MO,Pettis,17,10688,29159
2021-03-01,MO,Pettis,41,10729,29159
2021-03-02,MO,Pettis,140,10869,29159
2021-03-03,MO,Pettis,207,11076,29159
2021-03-04,MO,Pettis,233,11309,29159
2021-03-05,MO,Pettis,149,11458,29159
2021-03-06,MO,Pettis,4,11462,29159
2021-03-07,MO,Pettis,3,11465,29159
2021-03-08,MO,Pettis,37,11502,29159
2021-03-09,MO,Pettis,348,11850,29159
2021-03-10,MO,Pettis,317,12167,29159
2021-03-11,MO,Pettis,134,12301,29159
2021-03-12,MO,Pettis,301,12602,29159
2021-03-13,MO,Pettis,117,12719,29159
2021-03-14,MO,Pettis,10,12729,29159
2021-03-15,MO,Pettis,247,12976,29159
2021-03-16,MO,Pettis,101,13077,29159
2021-03-17,MO,Pettis,172,13249,29159
2021-03-18,MO,Pettis,213,13462,29159
2021-03-19,MO,Pettis,253,13715,29159
2021-03-20,MO,Pettis,24,13739,29159
2021-03-21,MO,Pettis,6,13745,29159
2021-03-22,MO,Pettis,161,13906,29159
2021-03-23,MO,Pettis,208,14114,29159
2021-03-24,MO,Pettis,375,14489,29159
2021-03-25,MO,Pettis,437,14926,29159
2021-03-26,MO,Pettis,572,15498,29159
2021-03-27,MO,Pettis,256,15754,29159
2021-03-28,MO,Pettis,12,15766,29159
2021-03-29,MO,Pettis,46,15812,29159
2021-03-30,MO,Pettis,165,15977,29159
2021-03-31,MO,Pettis,368,16345,29159
2021-04-01,MO,Pettis,377,16722,29159
2021-04-02,MO,Pettis,118,16840,29159
2021-04-03,MO,Pettis,27,16867,29159
2021-04-04,MO,Pettis,3,16870,29159
2021-04-05,MO,Pettis,124,16994,29159
2021-04-06,MO,Pettis,197,17191,29159
2021-04-07,MO,Pettis,101,17292,29159
2021-04-08,MO,Pettis,142,17434,29159
2021-04-09,MO,Pettis,663,18097,29159
2021-04-10,MO,Pettis,104,18201,29159
2021-04-11,MO,Pettis,13,18214,29159
2021-04-12,MO,Pettis,181,18395,29159
2021-04-13,MO,Pettis,148,18543,29159
2021-04-14,MO,Pettis,198,18741,29159
2021-04-15,MO,Pettis,444,19185,29159
2021-04-16,MO,Pettis,299,19484,29159
2021-04-17,MO,Pettis,35,19519,29159
2021-04-18,MO,Pettis,19,19538,29159
2021-04-19,MO,Pettis,58,19596,29159
2021-04-20,MO,Pettis,144,19740,29159
2021-04-21,MO,Pettis,192,19932,29159
2021-04-22,MO,Pettis,382,20314,29159
2021-04-23,MO,Pettis,425,20739,29159
2021-04-24,MO,Pettis,19,20758,29159
2021-04-25,MO,Pettis,2,20760,29159
2020-12-15,MO,Phelps,2,2,29161
2020-12-16,MO,Phelps,9,11,29161
2020-12-17,MO,Phelps,16,27,29161
2020-12-18,MO,Phelps,21,48,29161
2020-12-19,MO,Phelps,12,60,29161
2020-12-20,MO,Phelps,2,62,29161
2020-12-21,MO,Phelps,24,86,29161
2020-12-22,MO,Phelps,16,102,29161
2020-12-23,MO,Phelps,15,117,29161
2020-12-24,MO,Phelps,1,118,29161
2020-12-26,MO,Phelps,2,120,29161
2020-12-28,MO,Phelps,17,137,29161
2020-12-29,MO,Phelps,42,179,29161
2020-12-30,MO,Phelps,103,282,29161
2020-12-31,MO,Phelps,69,351,29161
2021-01-01,MO,Phelps,58,409,29161
2021-01-02,MO,Phelps,60,469,29161
2021-01-03,MO,Phelps,57,526,29161
2021-01-04,MO,Phelps,134,660,29161
2021-01-05,MO,Phelps,124,784,29161
2021-01-06,MO,Phelps,154,938,29161
2021-01-07,MO,Phelps,155,1093,29161
2021-01-08,MO,Phelps,97,1190,29161
2021-01-09,MO,Phelps,3,1193,29161
2021-01-10,MO,Phelps,1,1194,29161
2021-01-11,MO,Phelps,64,1258,29161
2021-01-12,MO,Phelps,65,1323,29161
2021-01-13,MO,Phelps,126,1449,29161
2021-01-14,MO,Phelps,21,1470,29161
2021-01-15,MO,Phelps,54,1524,29161
2021-01-16,MO,Phelps,73,1597,29161
2021-01-18,MO,Phelps,233,1830,29161
2021-01-19,MO,Phelps,102,1932,29161
2021-01-20,MO,Phelps,152,2084,29161
2021-01-21,MO,Phelps,155,2239,29161
2021-01-22,MO,Phelps,165,2404,29161
2021-01-23,MO,Phelps,453,2857,29161
2021-01-25,MO,Phelps,171,3028,29161
2021-01-26,MO,Phelps,133,3161,29161
2021-01-27,MO,Phelps,152,3313,29161
2021-01-28,MO,Phelps,158,3471,29161
2021-01-29,MO,Phelps,569,4040,29161
2021-01-30,MO,Phelps,293,4333,29161
2021-01-31,MO,Phelps,5,4338,29161
2021-02-01,MO,Phelps,70,4408,29161
2021-02-02,MO,Phelps,63,4471,29161
2021-02-03,MO,Phelps,153,4624,29161
2021-02-04,MO,Phelps,596,5220,29161
2021-02-05,MO,Phelps,552,5772,29161
2021-02-06,MO,Phelps,255,6027,29161
2021-02-07,MO,Phelps,3,6030,29161
2021-02-08,MO,Phelps,442,6472,29161
2021-02-09,MO,Phelps,125,6597,29161
2021-02-10,MO,Phelps,229,6826,29161
2021-02-11,MO,Phelps,190,7016,29161
2021-02-12,MO,Phelps,271,7287,29161
2021-02-13,MO,Phelps,557,7844,29161
2021-02-14,MO,Phelps,5,7849,29161
2021-02-15,MO,Phelps,158,8007,29161
2021-02-16,MO,Phelps,187,8194,29161
2021-02-17,MO,Phelps,116,8310,29161
2021-02-18,MO,Phelps,90,8400,29161
2021-02-19,MO,Phelps,57,8457,29161
2021-02-20,MO,Phelps,19,8476,29161
2021-02-21,MO,Phelps,2,8478,29161
2021-02-22,MO,Phelps,96,8574,29161
2021-02-23,MO,Phelps,85,8659,29161
2021-02-24,MO,Phelps,205,8864,29161
2021-02-25,MO,Phelps,191,9055,29161
2021-02-26,MO,Phelps,1071,10126,29161
2021-02-27,MO,Phelps,575,10701,29161
2021-03-01,MO,Phelps,160,10861,29161
2021-03-02,MO,Phelps,139,11000,29161
2021-03-03,MO,Phelps,141,11141,29161
2021-03-04,MO,Phelps,117,11258,29161
2021-03-05,MO,Phelps,114,11372,29161
2021-03-06,MO,Phelps,264,11636,29161
2021-03-07,MO,Phelps,11,11647,29161
2021-03-08,MO,Phelps,203,11850,29161
2021-03-09,MO,Phelps,207,12057,29161
2021-03-10,MO,Phelps,222,12279,29161
2021-03-11,MO,Phelps,242,12521,29161
2021-03-12,MO,Phelps,478,12999,29161
2021-03-13,MO,Phelps,74,13073,29161
2021-03-14,MO,Phelps,13,13086,29161
2021-03-15,MO,Phelps,212,13298,29161
2021-03-16,MO,Phelps,299,13597,29161
2021-03-17,MO,Phelps,158,13755,29161
2021-03-18,MO,Phelps,158,13913,29161
2021-03-19,MO,Phelps,243,14156,29161
2021-03-20,MO,Phelps,143,14299,29161
2021-03-21,MO,Phelps,19,14318,29161
2021-03-22,MO,Phelps,195,14513,29161
2021-03-23,MO,Phelps,273,14786,29161
2021-03-24,MO,Phelps,179,14965,29161
2021-03-25,MO,Phelps,290,15255,29161
2021-03-26,MO,Phelps,207,15462,29161
2021-03-27,MO,Phelps,38,15500,29161
2021-03-28,MO,Phelps,21,15521,29161
2021-03-29,MO,Phelps,278,15799,29161
2021-03-30,MO,Phelps,335,16134,29161
2021-03-31,MO,Phelps,166,16300,29161
2021-04-01,MO,Phelps,409,16709,29161
2021-04-02,MO,Phelps,291,17000,29161
2021-04-03,MO,Phelps,28,17028,29161
2021-04-04,MO,Phelps,8,17036,29161
2021-04-05,MO,Phelps,271,17307,29161
2021-04-06,MO,Phelps,328,17635,29161
2021-04-07,MO,Phelps,116,17751,29161
2021-04-08,MO,Phelps,263,18014,29161
2021-04-09,MO,Phelps,914,18928,29161
2021-04-10,MO,Phelps,147,19075,29161
2021-04-11,MO,Phelps,18,19093,29161
2021-04-12,MO,Phelps,399,19492,29161
2021-04-13,MO,Phelps,342,19834,29161
2021-04-14,MO,Phelps,178,20012,29161
2021-04-15,MO,Phelps,215,20227,29161
2021-04-16,MO,Phelps,229,20456,29161
2021-04-17,MO,Phelps,58,20514,29161
2021-04-18,MO,Phelps,16,20530,29161
2021-04-19,MO,Phelps,252,20782,29161
2021-04-20,MO,Phelps,343,21125,29161
2021-04-21,MO,Phelps,78,21203,29161
2021-04-22,MO,Phelps,317,21520,29161
2021-04-23,MO,Phelps,207,21727,29161
2021-04-24,MO,Phelps,74,21801,29161
2021-04-25,MO,Phelps,11,21812,29161
2020-12-15,MO,Pike,1,1,29163
2020-12-16,MO,Pike,6,7,29163
2020-12-17,MO,Pike,9,16,29163
2020-12-18,MO,Pike,6,22,29163
2020-12-21,MO,Pike,5,27,29163
2020-12-22,MO,Pike,1,28,29163
2020-12-23,MO,Pike,12,40,29163
2020-12-28,MO,Pike,39,79,29163
2020-12-29,MO,Pike,28,107,29163
2020-12-30,MO,Pike,37,144,29163
2021-01-03,MO,Pike,1,145,29163
2021-01-04,MO,Pike,7,152,29163
2021-01-05,MO,Pike,39,191,29163
2021-01-06,MO,Pike,9,200,29163
2021-01-07,MO,Pike,10,210,29163
2021-01-08,MO,Pike,6,216,29163
2021-01-09,MO,Pike,1,217,29163
2021-01-10,MO,Pike,1,218,29163
2021-01-11,MO,Pike,11,229,29163
2021-01-12,MO,Pike,11,240,29163
2021-01-13,MO,Pike,15,255,29163
2021-01-14,MO,Pike,9,264,29163
2021-01-15,MO,Pike,25,289,29163
2021-01-16,MO,Pike,3,292,29163
2021-01-17,MO,Pike,22,314,29163
2021-01-18,MO,Pike,140,454,29163
2021-01-19,MO,Pike,140,594,29163
2021-01-20,MO,Pike,217,811,29163
2021-01-21,MO,Pike,184,995,29163
2021-01-22,MO,Pike,101,1096,29163
2021-01-23,MO,Pike,3,1099,29163
2021-01-24,MO,Pike,1,1100,29163
2021-01-25,MO,Pike,11,1111,29163
2021-01-26,MO,Pike,17,1128,29163
2021-01-27,MO,Pike,4,1132,29163
2021-01-28,MO,Pike,11,1143,29163
2021-01-29,MO,Pike,18,1161,29163
2021-01-30,MO,Pike,2,1163,29163
2021-02-01,MO,Pike,9,1172,29163
2021-02-02,MO,Pike,130,1302,29163
2021-02-03,MO,Pike,2,1304,29163
2021-02-04,MO,Pike,122,1426,29163
2021-02-05,MO,Pike,63,1489,29163
2021-02-06,MO,Pike,2,1491,29163
2021-02-07,MO,Pike,1,1492,29163
2021-02-08,MO,Pike,124,1616,29163
2021-02-09,MO,Pike,317,1933,29163
2021-02-10,MO,Pike,224,2157,29163
2021-02-11,MO,Pike,139,2296,29163
2021-02-12,MO,Pike,190,2486,29163
2021-02-13,MO,Pike,2,2488,29163
2021-02-14,MO,Pike,30,2518,29163
2021-02-15,MO,Pike,43,2561,29163
2021-02-16,MO,Pike,98,2659,29163
2021-02-17,MO,Pike,172,2831,29163
2021-02-18,MO,Pike,19,2850,29163
2021-02-19,MO,Pike,37,2887,29163
2021-02-20,MO,Pike,2,2889,29163
2021-02-22,MO,Pike,27,2916,29163
2021-02-23,MO,Pike,220,3136,29163
2021-02-24,MO,Pike,69,3205,29163
2021-02-25,MO,Pike,118,3323,29163
2021-02-26,MO,Pike,25,3348,29163
2021-02-27,MO,Pike,11,3359,29163
2021-03-01,MO,Pike,8,3367,29163
2021-03-02,MO,Pike,451,3818,29163
2021-03-03,MO,Pike,19,3837,29163
2021-03-04,MO,Pike,134,3971,29163
2021-03-05,MO,Pike,95,4066,29163
2021-03-06,MO,Pike,3,4069,29163
2021-03-08,MO,Pike,16,4085,29163
2021-03-09,MO,Pike,225,4310,29163
2021-03-10,MO,Pike,235,4545,29163
2021-03-11,MO,Pike,63,4608,29163
2021-03-12,MO,Pike,41,4649,29163
2021-03-13,MO,Pike,6,4655,29163
2021-03-14,MO,Pike,2,4657,29163
2021-03-15,MO,Pike,49,4706,29163
2021-03-16,MO,Pike,75,4781,29163
2021-03-17,MO,Pike,204,4985,29163
2021-03-18,MO,Pike,51,5036,29163
2021-03-19,MO,Pike,112,5148,29163
2021-03-20,MO,Pike,7,5155,29163
2021-03-21,MO,Pike,5,5160,29163
2021-03-22,MO,Pike,30,5190,29163
2021-03-23,MO,Pike,223,5413,29163
2021-03-24,MO,Pike,93,5506,29163
2021-03-25,MO,Pike,121,5627,29163
2021-03-26,MO,Pike,15,5642,29163
2021-03-27,MO,Pike,7,5649,29163
2021-03-28,MO,Pike,1,5650,29163
2021-03-29,MO,Pike,30,5680,29163
2021-03-30,MO,Pike,375,6055,29163
2021-03-31,MO,Pike,180,6235,29163
2021-04-01,MO,Pike,62,6297,29163
2021-04-02,MO,Pike,58,6355,29163
2021-04-03,MO,Pike,5,6360,29163
2021-04-04,MO,Pike,2,6362,29163
2021-04-05,MO,Pike,12,6374,29163
2021-04-06,MO,Pike,120,6494,29163
2021-04-07,MO,Pike,122,6616,29163
2021-04-08,MO,Pike,62,6678,29163
2021-04-09,MO,Pike,54,6732,29163
2021-04-10,MO,Pike,9,6741,29163
2021-04-11,MO,Pike,5,6746,29163
2021-04-12,MO,Pike,25,6771,29163
2021-04-13,MO,Pike,166,6937,29163
2021-04-14,MO,Pike,146,7083,29163
2021-04-15,MO,Pike,26,7109,29163
2021-04-16,MO,Pike,123,7232,29163
2021-04-17,MO,Pike,13,7245,29163
2021-04-18,MO,Pike,3,7248,29163
2021-04-19,MO,Pike,13,7261,29163
2021-04-20,MO,Pike,90,7351,29163
2021-04-21,MO,Pike,308,7659,29163
2021-04-22,MO,Pike,60,7719,29163
2021-04-23,MO,Pike,19,7738,29163
2021-04-24,MO,Pike,2,7740,29163
2020-12-14,MO,Platte,1,1,29165
2020-12-15,MO,Platte,2,3,29165
2020-12-16,MO,Platte,5,8,29165
2020-12-17,MO,Platte,16,24,29165
2020-12-18,MO,Platte,9,33,29165
2020-12-19,MO,Platte,12,45,29165
2020-12-20,MO,Platte,3,48,29165
2020-12-21,MO,Platte,41,89,29165
2020-12-22,MO,Platte,105,194,29165
2020-12-23,MO,Platte,59,253,29165
2020-12-24,MO,Platte,10,263,29165
2020-12-26,MO,Platte,1,264,29165
2020-12-27,MO,Platte,11,275,29165
2020-12-28,MO,Platte,27,302,29165
2020-12-29,MO,Platte,76,378,29165
2020-12-30,MO,Platte,95,473,29165
2020-12-31,MO,Platte,48,521,29165
2021-01-01,MO,Platte,1,522,29165
2021-01-02,MO,Platte,22,544,29165
2021-01-03,MO,Platte,6,550,29165
2021-01-04,MO,Platte,28,578,29165
2021-01-05,MO,Platte,50,628,29165
2021-01-06,MO,Platte,85,713,29165
2021-01-07,MO,Platte,85,798,29165
2021-01-08,MO,Platte,108,906,29165
2021-01-09,MO,Platte,50,956,29165
2021-01-10,MO,Platte,7,963,29165
2021-01-11,MO,Platte,55,1018,29165
2021-01-12,MO,Platte,149,1167,29165
2021-01-13,MO,Platte,120,1287,29165
2021-01-14,MO,Platte,86,1373,29165
2021-01-15,MO,Platte,100,1473,29165
2021-01-16,MO,Platte,11,1484,29165
2021-01-17,MO,Platte,1,1485,29165
2021-01-18,MO,Platte,47,1532,29165
2021-01-19,MO,Platte,108,1640,29165
2021-01-20,MO,Platte,121,1761,29165
2021-01-21,MO,Platte,136,1897,29165
2021-01-22,MO,Platte,133,2030,29165
2021-01-23,MO,Platte,23,2053,29165
2021-01-25,MO,Platte,77,2130,29165
2021-01-26,MO,Platte,95,2225,29165
2021-01-27,MO,Platte,98,2323,29165
2021-01-28,MO,Platte,150,2473,29165
2021-01-29,MO,Platte,262,2735,29165
2021-01-30,MO,Platte,35,2770,29165
2021-01-31,MO,Platte,49,2819,29165
2021-02-01,MO,Platte,64,2883,29165
2021-02-02,MO,Platte,108,2991,29165
2021-02-03,MO,Platte,193,3184,29165
2021-02-04,MO,Platte,214,3398,29165
2021-02-05,MO,Platte,291,3689,29165
2021-02-06,MO,Platte,98,3787,29165
2021-02-07,MO,Platte,25,3812,29165
2021-02-08,MO,Platte,74,3886,29165
2021-02-09,MO,Platte,122,4008,29165
2021-02-10,MO,Platte,108,4116,29165
2021-02-11,MO,Platte,210,4326,29165
2021-02-12,MO,Platte,294,4620,29165
2021-02-13,MO,Platte,55,4675,29165
2021-02-14,MO,Platte,33,4708,29165
2021-02-15,MO,Platte,75,4783,29165
2021-02-16,MO,Platte,91,4874,29165
2021-02-17,MO,Platte,125,4999,29165
2021-02-18,MO,Platte,246,5245,29165
2021-02-19,MO,Platte,158,5403,29165
2021-02-20,MO,Platte,26,5429,29165
2021-02-21,MO,Platte,15,5444,29165
2021-02-22,MO,Platte,158,5602,29165
2021-02-23,MO,Platte,155,5757,29165
2021-02-24,MO,Platte,233,5990,29165
2021-02-25,MO,Platte,387,6377,29165
2021-02-26,MO,Platte,600,6977,29165
2021-02-27,MO,Platte,115,7092,29165
2021-02-28,MO,Platte,62,7154,29165
2021-03-01,MO,Platte,113,7267,29165
2021-03-02,MO,Platte,298,7565,29165
2021-03-03,MO,Platte,568,8133,29165
2021-03-04,MO,Platte,450,8583,29165
2021-03-05,MO,Platte,290,8873,29165
2021-03-06,MO,Platte,200,9073,29165
2021-03-07,MO,Platte,61,9134,29165
2021-03-08,MO,Platte,160,9294,29165
2021-03-09,MO,Platte,208,9502,29165
2021-03-10,MO,Platte,172,9674,29165
2021-03-11,MO,Platte,296,9970,29165
2021-03-12,MO,Platte,350,10320,29165
2021-03-13,MO,Platte,117,10437,29165
2021-03-14,MO,Platte,77,10514,29165
2021-03-15,MO,Platte,186,10700,29165
2021-03-16,MO,Platte,331,11031,29165
2021-03-17,MO,Platte,367,11398,29165
2021-03-18,MO,Platte,656,12054,29165
2021-03-19,MO,Platte,623,12677,29165
2021-03-20,MO,Platte,154,12831,29165
2021-03-21,MO,Platte,105,12936,29165
2021-03-22,MO,Platte,228,13164,29165
2021-03-23,MO,Platte,354,13518,29165
2021-03-24,MO,Platte,580,14098,29165
2021-03-25,MO,Platte,641,14739,29165
2021-03-26,MO,Platte,666,15405,29165
2021-03-27,MO,Platte,147,15552,29165
2021-03-28,MO,Platte,71,15623,29165
2021-03-29,MO,Platte,348,15971,29165
2021-03-30,MO,Platte,428,16399,29165
2021-03-31,MO,Platte,348,16747,29165
2021-04-01,MO,Platte,436,17183,29165
2021-04-02,MO,Platte,376,17559,29165
2021-04-03,MO,Platte,123,17682,29165
2021-04-04,MO,Platte,35,17717,29165
2021-04-05,MO,Platte,241,17958,29165
2021-04-06,MO,Platte,422,18380,29165
2021-04-07,MO,Platte,317,18697,29165
2021-04-08,MO,Platte,455,19152,29165
2021-04-09,MO,Platte,733,19885,29165
2021-04-10,MO,Platte,158,20043,29165
2021-04-11,MO,Platte,63,20106,29165
2021-04-12,MO,Platte,270,20376,29165
2021-04-13,MO,Platte,310,20686,29165
2021-04-14,MO,Platte,324,21010,29165
2021-04-15,MO,Platte,424,21434,29165
2021-04-16,MO,Platte,516,21950,29165
2021-04-17,MO,Platte,78,22028,29165
2021-04-18,MO,Platte,50,22078,29165
2021-04-19,MO,Platte,171,22249,29165
2021-04-20,MO,Platte,270,22519,29165
2021-04-21,MO,Platte,258,22777,29165
2021-04-22,MO,Platte,318,23095,29165
2021-04-23,MO,Platte,289,23384,29165
2021-04-24,MO,Platte,92,23476,29165
2021-04-25,MO,Platte,11,23487,29165
2020-12-14,MO,Polk,1,1,29167
2020-12-15,MO,Polk,2,3,29167
2020-12-16,MO,Polk,2,5,29167
2020-12-17,MO,Polk,8,13,29167
2020-12-18,MO,Polk,5,18,29167
2020-12-19,MO,Polk,2,20,29167
2020-12-20,MO,Polk,1,21,29167
2020-12-21,MO,Polk,18,39,29167
2020-12-22,MO,Polk,47,86,29167
2020-12-23,MO,Polk,84,170,29167
2020-12-24,MO,Polk,9,179,29167
2020-12-26,MO,Polk,7,186,29167
2020-12-27,MO,Polk,5,191,29167
2020-12-28,MO,Polk,76,267,29167
2020-12-29,MO,Polk,95,362,29167
2020-12-30,MO,Polk,127,489,29167
2020-12-31,MO,Polk,46,535,29167
2021-01-02,MO,Polk,2,537,29167
2021-01-03,MO,Polk,3,540,29167
2021-01-04,MO,Polk,19,559,29167
2021-01-05,MO,Polk,156,715,29167
2021-01-06,MO,Polk,18,733,29167
2021-01-07,MO,Polk,8,741,29167
2021-01-08,MO,Polk,13,754,29167
2021-01-09,MO,Polk,13,767,29167
2021-01-10,MO,Polk,1,768,29167
2021-01-11,MO,Polk,15,783,29167
2021-01-12,MO,Polk,79,862,29167
2021-01-13,MO,Polk,25,887,29167
2021-01-14,MO,Polk,22,909,29167
2021-01-15,MO,Polk,18,927,29167
2021-01-16,MO,Polk,9,936,29167
2021-01-17,MO,Polk,2,938,29167
2021-01-18,MO,Polk,11,949,29167
2021-01-19,MO,Polk,168,1117,29167
2021-01-20,MO,Polk,221,1338,29167
2021-01-21,MO,Polk,206,1544,29167
2021-01-22,MO,Polk,78,1622,29167
2021-01-23,MO,Polk,22,1644,29167
2021-01-24,MO,Polk,5,1649,29167
2021-01-25,MO,Polk,129,1778,29167
2021-01-26,MO,Polk,357,2135,29167
2021-01-27,MO,Polk,142,2277,29167
2021-01-28,MO,Polk,183,2460,29167
2021-01-29,MO,Polk,328,2788,29167
2021-01-30,MO,Polk,8,2796,29167
2021-02-01,MO,Polk,116,2912,29167
2021-02-02,MO,Polk,182,3094,29167
2021-02-03,MO,Polk,156,3250,29167
2021-02-04,MO,Polk,24,3274,29167
2021-02-05,MO,Polk,65,3339,29167
2021-02-06,MO,Polk,21,3360,29167
2021-02-08,MO,Polk,25,3385,29167
2021-02-09,MO,Polk,107,3492,29167
2021-02-10,MO,Polk,117,3609,29167
2021-02-11,MO,Polk,427,4036,29167
2021-02-12,MO,Polk,210,4246,29167
2021-02-13,MO,Polk,65,4311,29167
2021-02-14,MO,Polk,9,4320,29167
2021-02-15,MO,Polk,9,4329,29167
2021-02-16,MO,Polk,128,4457,29167
2021-02-17,MO,Polk,15,4472,29167
2021-02-18,MO,Polk,40,4512,29167
2021-02-19,MO,Polk,115,4627,29167
2021-02-20,MO,Polk,127,4754,29167
2021-02-21,MO,Polk,5,4759,29167
2021-02-22,MO,Polk,89,4848,29167
2021-02-23,MO,Polk,336,5184,29167
2021-02-24,MO,Polk,281,5465,29167
2021-02-25,MO,Polk,541,6006,29167
2021-02-26,MO,Polk,411,6417,29167
2021-02-27,MO,Polk,79,6496,29167
2021-03-01,MO,Polk,180,6676,29167
2021-03-02,MO,Polk,242,6918,29167
2021-03-03,MO,Polk,211,7129,29167
2021-03-04,MO,Polk,238,7367,29167
2021-03-05,MO,Polk,119,7486,29167
2021-03-06,MO,Polk,135,7621,29167
2021-03-07,MO,Polk,7,7628,29167
2021-03-08,MO,Polk,58,7686,29167
2021-03-09,MO,Polk,215,7901,29167
2021-03-10,MO,Polk,175,8076,29167
2021-03-11,MO,Polk,220,8296,29167
2021-03-12,MO,Polk,289,8585,29167
2021-03-13,MO,Polk,75,8660,29167
2021-03-14,MO,Polk,7,8667,29167
2021-03-15,MO,Polk,76,8743,29167
2021-03-16,MO,Polk,258,9001,29167
2021-03-17,MO,Polk,124,9125,29167
2021-03-18,MO,Polk,159,9284,29167
2021-03-19,MO,Polk,202,9486,29167
2021-03-20,MO,Polk,39,9525,29167
2021-03-21,MO,Polk,10,9535,29167
2021-03-22,MO,Polk,98,9633,29167
2021-03-23,MO,Polk,221,9854,29167
2021-03-24,MO,Polk,297,10151,29167
2021-03-25,MO,Polk,359,10510,29167
2021-03-26,MO,Polk,439,10949,29167
2021-03-27,MO,Polk,75,11024,29167
2021-03-28,MO,Polk,12,11036,29167
2021-03-29,MO,Polk,71,11107,29167
2021-03-30,MO,Polk,212,11319,29167
2021-03-31,MO,Polk,188,11507,29167
2021-04-01,MO,Polk,355,11862,29167
2021-04-02,MO,Polk,167,12029,29167
2021-04-03,MO,Polk,50,12079,29167
2021-04-04,MO,Polk,11,12090,29167
2021-04-05,MO,Polk,67,12157,29167
2021-04-06,MO,Polk,159,12316,29167
2021-04-07,MO,Polk,84,12400,29167
2021-04-08,MO,Polk,170,12570,29167
2021-04-09,MO,Polk,179,12749,29167
2021-04-10,MO,Polk,57,12806,29167
2021-04-11,MO,Polk,27,12833,29167
2021-04-12,MO,Polk,81,12914,29167
2021-04-13,MO,Polk,113,13027,29167
2021-04-14,MO,Polk,90,13117,29167
2021-04-15,MO,Polk,170,13287,29167
2021-04-16,MO,Polk,176,13463,29167
2021-04-17,MO,Polk,29,13492,29167
2021-04-18,MO,Polk,3,13495,29167
2021-04-19,MO,Polk,47,13542,29167
2021-04-20,MO,Polk,57,13599,29167
2021-04-21,MO,Polk,119,13718,29167
2021-04-22,MO,Polk,63,13781,29167
2021-04-23,MO,Polk,44,13825,29167
2021-04-24,MO,Polk,21,13846,29167
2021-04-25,MO,Polk,2,13848,29167
2020-12-15,MO,Pulaski,1,1,29169
2020-12-16,MO,Pulaski,14,15,29169
2020-12-17,MO,Pulaski,12,27,29169
2020-12-18,MO,Pulaski,4,31,29169
2020-12-19,MO,Pulaski,4,35,29169
2020-12-21,MO,Pulaski,24,59,29169
2020-12-22,MO,Pulaski,34,93,29169
2020-12-23,MO,Pulaski,7,100,29169
2020-12-24,MO,Pulaski,1,101,29169
2020-12-27,MO,Pulaski,3,104,29169
2020-12-28,MO,Pulaski,19,123,29169
2020-12-29,MO,Pulaski,17,140,29169
2020-12-30,MO,Pulaski,33,173,29169
2020-12-31,MO,Pulaski,39,212,29169
2021-01-01,MO,Pulaski,8,220,29169
2021-01-02,MO,Pulaski,12,232,29169
2021-01-03,MO,Pulaski,6,238,29169
2021-01-04,MO,Pulaski,14,252,29169
2021-01-05,MO,Pulaski,21,273,29169
2021-01-06,MO,Pulaski,34,307,29169
2021-01-07,MO,Pulaski,48,355,29169
2021-01-08,MO,Pulaski,68,423,29169
2021-01-09,MO,Pulaski,1,424,29169
2021-01-11,MO,Pulaski,30,454,29169
2021-01-12,MO,Pulaski,67,521,29169
2021-01-13,MO,Pulaski,42,563,29169
2021-01-14,MO,Pulaski,49,612,29169
2021-01-15,MO,Pulaski,54,666,29169
2021-01-16,MO,Pulaski,95,761,29169
2021-01-17,MO,Pulaski,7,768,29169
2021-01-18,MO,Pulaski,43,811,29169
2021-01-19,MO,Pulaski,99,910,29169
2021-01-20,MO,Pulaski,201,1111,29169
2021-01-21,MO,Pulaski,101,1212,29169
2021-01-22,MO,Pulaski,120,1332,29169
2021-01-23,MO,Pulaski,183,1515,29169
2021-01-24,MO,Pulaski,5,1520,29169
2021-01-25,MO,Pulaski,34,1554,29169
2021-01-26,MO,Pulaski,24,1578,29169
2021-01-27,MO,Pulaski,37,1615,29169
2021-01-28,MO,Pulaski,176,1791,29169
2021-01-29,MO,Pulaski,262,2053,29169
2021-01-30,MO,Pulaski,132,2185,29169
2021-02-01,MO,Pulaski,7,2192,29169
2021-02-02,MO,Pulaski,117,2309,29169
2021-02-03,MO,Pulaski,59,2368,29169
2021-02-04,MO,Pulaski,91,2459,29169
2021-02-05,MO,Pulaski,184,2643,29169
2021-02-06,MO,Pulaski,113,2756,29169
2021-02-07,MO,Pulaski,8,2764,29169
2021-02-08,MO,Pulaski,44,2808,29169
2021-02-09,MO,Pulaski,130,2938,29169
2021-02-10,MO,Pulaski,35,2973,29169
2021-02-11,MO,Pulaski,183,3156,29169
2021-02-12,MO,Pulaski,52,3208,29169
2021-02-13,MO,Pulaski,28,3236,29169
2021-02-14,MO,Pulaski,2,3238,29169
2021-02-15,MO,Pulaski,16,3254,29169
2021-02-16,MO,Pulaski,17,3271,29169
2021-02-17,MO,Pulaski,15,3286,29169
2021-02-18,MO,Pulaski,275,3561,29169
2021-02-19,MO,Pulaski,184,3745,29169
2021-02-20,MO,Pulaski,3,3748,29169
2021-02-22,MO,Pulaski,44,3792,29169
2021-02-23,MO,Pulaski,126,3918,29169
2021-02-24,MO,Pulaski,22,3940,29169
2021-02-25,MO,Pulaski,164,4104,29169
2021-02-26,MO,Pulaski,129,4233,29169
2021-02-27,MO,Pulaski,442,4675,29169
2021-02-28,MO,Pulaski,4,4679,29169
2021-03-01,MO,Pulaski,32,4711,29169
2021-03-02,MO,Pulaski,252,4963,29169
2021-03-03,MO,Pulaski,96,5059,29169
2021-03-04,MO,Pulaski,134,5193,29169
2021-03-05,MO,Pulaski,85,5278,29169
2021-03-06,MO,Pulaski,28,5306,29169
2021-03-07,MO,Pulaski,37,5343,29169
2021-03-08,MO,Pulaski,55,5398,29169
2021-03-09,MO,Pulaski,54,5452,29169
2021-03-10,MO,Pulaski,61,5513,29169
2021-03-11,MO,Pulaski,89,5602,29169
2021-03-12,MO,Pulaski,118,5720,29169
2021-03-13,MO,Pulaski,14,5734,29169
2021-03-14,MO,Pulaski,4,5738,29169
2021-03-15,MO,Pulaski,87,5825,29169
2021-03-16,MO,Pulaski,190,6015,29169
2021-03-17,MO,Pulaski,39,6054,29169
2021-03-18,MO,Pulaski,48,6102,29169
2021-03-19,MO,Pulaski,118,6220,29169
2021-03-20,MO,Pulaski,19,6239,29169
2021-03-21,MO,Pulaski,3,6242,29169
2021-03-22,MO,Pulaski,74,6316,29169
2021-03-23,MO,Pulaski,89,6405,29169
2021-03-24,MO,Pulaski,63,6468,29169
2021-03-25,MO,Pulaski,202,6670,29169
2021-03-26,MO,Pulaski,112,6782,29169
2021-03-27,MO,Pulaski,24,6806,29169
2021-03-28,MO,Pulaski,13,6819,29169
2021-03-29,MO,Pulaski,107,6926,29169
2021-03-30,MO,Pulaski,76,7002,29169
2021-03-31,MO,Pulaski,128,7130,29169
2021-04-01,MO,Pulaski,165,7295,29169
2021-04-02,MO,Pulaski,285,7580,29169
2021-04-03,MO,Pulaski,11,7591,29169
2021-04-04,MO,Pulaski,6,7597,29169
2021-04-05,MO,Pulaski,66,7663,29169
2021-04-06,MO,Pulaski,225,7888,29169
2021-04-07,MO,Pulaski,73,7961,29169
2021-04-08,MO,Pulaski,95,8056,29169
2021-04-09,MO,Pulaski,157,8213,29169
2021-04-10,MO,Pulaski,29,8242,29169
2021-04-11,MO,Pulaski,17,8259,29169
2021-04-12,MO,Pulaski,159,8418,29169
2021-04-13,MO,Pulaski,89,8507,29169
2021-04-14,MO,Pulaski,73,8580,29169
2021-04-15,MO,Pulaski,146,8726,29169
2021-04-16,MO,Pulaski,70,8796,29169
2021-04-17,MO,Pulaski,24,8820,29169
2021-04-18,MO,Pulaski,9,8829,29169
2021-04-19,MO,Pulaski,157,8986,29169
2021-04-20,MO,Pulaski,58,9044,29169
2021-04-21,MO,Pulaski,77,9121,29169
2021-04-22,MO,Pulaski,70,9191,29169
2021-04-23,MO,Pulaski,50,9241,29169
2021-04-24,MO,Pulaski,23,9264,29169
2021-04-25,MO,Pulaski,10,9274,29169
2020-12-16,MO,Putnam,2,2,29171
2020-12-21,MO,Putnam,4,6,29171
2020-12-23,MO,Putnam,2,8,29171
2020-12-28,MO,Putnam,2,10,29171
2020-12-29,MO,Putnam,1,11,29171
2020-12-30,MO,Putnam,1,12,29171
2021-01-03,MO,Putnam,1,13,29171
2021-01-05,MO,Putnam,1,14,29171
2021-01-11,MO,Putnam,7,21,29171
2021-01-12,MO,Putnam,2,23,29171
2021-01-13,MO,Putnam,45,68,29171
2021-01-14,MO,Putnam,1,69,29171
2021-01-15,MO,Putnam,5,74,29171
2021-01-18,MO,Putnam,1,75,29171
2021-01-19,MO,Putnam,1,76,29171
2021-01-20,MO,Putnam,41,117,29171
2021-01-21,MO,Putnam,14,131,29171
2021-01-22,MO,Putnam,7,138,29171
2021-01-24,MO,Putnam,1,139,29171
2021-01-27,MO,Putnam,11,150,29171
2021-01-29,MO,Putnam,71,221,29171
2021-02-01,MO,Putnam,9,230,29171
2021-02-02,MO,Putnam,1,231,29171
2021-02-03,MO,Putnam,3,234,29171
2021-02-04,MO,Putnam,154,388,29171
2021-02-05,MO,Putnam,115,503,29171
2021-02-06,MO,Putnam,4,507,29171
2021-02-08,MO,Putnam,2,509,29171
2021-02-09,MO,Putnam,2,511,29171
2021-02-10,MO,Putnam,101,612,29171
2021-02-11,MO,Putnam,3,615,29171
2021-02-12,MO,Putnam,5,620,29171
2021-02-15,MO,Putnam,1,621,29171
2021-02-16,MO,Putnam,2,623,29171
2021-02-18,MO,Putnam,69,692,29171
2021-02-19,MO,Putnam,3,695,29171
2021-02-22,MO,Putnam,1,696,29171
2021-02-23,MO,Putnam,3,699,29171
2021-02-24,MO,Putnam,11,710,29171
2021-02-25,MO,Putnam,10,720,29171
2021-02-26,MO,Putnam,7,727,29171
2021-02-27,MO,Putnam,131,858,29171
2021-02-28,MO,Putnam,1,859,29171
2021-03-01,MO,Putnam,5,864,29171
2021-03-02,MO,Putnam,25,889,29171
2021-03-03,MO,Putnam,1,890,29171
2021-03-04,MO,Putnam,178,1068,29171
2021-03-05,MO,Putnam,95,1163,29171
2021-03-06,MO,Putnam,5,1168,29171
2021-03-07,MO,Putnam,1,1169,29171
2021-03-08,MO,Putnam,5,1174,29171
2021-03-09,MO,Putnam,1,1175,29171
2021-03-11,MO,Putnam,3,1178,29171
2021-03-12,MO,Putnam,12,1190,29171
2021-03-15,MO,Putnam,2,1192,29171
2021-03-16,MO,Putnam,4,1196,29171
2021-03-17,MO,Putnam,6,1202,29171
2021-03-18,MO,Putnam,6,1208,29171
2021-03-19,MO,Putnam,5,1213,29171
2021-03-20,MO,Putnam,105,1318,29171
2021-03-21,MO,Putnam,2,1320,29171
2021-03-22,MO,Putnam,1,1321,29171
2021-03-23,MO,Putnam,3,1324,29171
2021-03-24,MO,Putnam,36,1360,29171
2021-03-25,MO,Putnam,30,1390,29171
2021-03-26,MO,Putnam,6,1396,29171
2021-03-27,MO,Putnam,2,1398,29171
2021-03-28,MO,Putnam,1,1399,29171
2021-03-29,MO,Putnam,7,1406,29171
2021-03-30,MO,Putnam,9,1415,29171
2021-03-31,MO,Putnam,32,1447,29171
2021-04-01,MO,Putnam,3,1450,29171
2021-04-02,MO,Putnam,11,1461,29171
2021-04-03,MO,Putnam,1,1462,29171
2021-04-05,MO,Putnam,1,1463,29171
2021-04-06,MO,Putnam,10,1473,29171
2021-04-07,MO,Putnam,7,1480,29171
2021-04-08,MO,Putnam,44,1524,29171
2021-04-09,MO,Putnam,21,1545,29171
2021-04-10,MO,Putnam,3,1548,29171
2021-04-12,MO,Putnam,2,1550,29171
2021-04-13,MO,Putnam,4,1554,29171
2021-04-14,MO,Putnam,3,1557,29171
2021-04-15,MO,Putnam,4,1561,29171
2021-04-16,MO,Putnam,8,1569,29171
2021-04-19,MO,Putnam,8,1577,29171
2021-04-20,MO,Putnam,3,1580,29171
2021-04-21,MO,Putnam,1,1581,29171
2021-04-22,MO,Putnam,33,1614,29171
2021-04-23,MO,Putnam,2,1616,29171
2021-04-24,MO,Putnam,3,1619,29171
2020-12-16,MO,Ralls,1,1,29173
2020-12-18,MO,Ralls,1,2,29173
2020-12-19,MO,Ralls,1,3,29173
2020-12-21,MO,Ralls,1,4,29173
2020-12-22,MO,Ralls,1,5,29173
2020-12-23,MO,Ralls,14,19,29173
2020-12-27,MO,Ralls,1,20,29173
2020-12-28,MO,Ralls,20,40,29173
2020-12-29,MO,Ralls,22,62,29173
2020-12-30,MO,Ralls,21,83,29173
2020-12-31,MO,Ralls,1,84,29173
2021-01-02,MO,Ralls,1,85,29173
2021-01-05,MO,Ralls,7,92,29173
2021-01-07,MO,Ralls,13,105,29173
2021-01-08,MO,Ralls,16,121,29173
2021-01-09,MO,Ralls,4,125,29173
2021-01-10,MO,Ralls,1,126,29173
2021-01-11,MO,Ralls,4,130,29173
2021-01-12,MO,Ralls,14,144,29173
2021-01-13,MO,Ralls,16,160,29173
2021-01-14,MO,Ralls,8,168,29173
2021-01-18,MO,Ralls,100,268,29173
2021-01-19,MO,Ralls,107,375,29173
2021-01-20,MO,Ralls,203,578,29173
2021-01-21,MO,Ralls,108,686,29173
2021-01-22,MO,Ralls,73,759,29173
2021-01-23,MO,Ralls,3,762,29173
2021-01-24,MO,Ralls,2,764,29173
2021-01-25,MO,Ralls,2,766,29173
2021-01-26,MO,Ralls,15,781,29173
2021-01-27,MO,Ralls,7,788,29173
2021-01-28,MO,Ralls,6,794,29173
2021-01-29,MO,Ralls,26,820,29173
2021-02-01,MO,Ralls,4,824,29173
2021-02-02,MO,Ralls,65,889,29173
2021-02-03,MO,Ralls,2,891,29173
2021-02-04,MO,Ralls,105,996,29173
2021-02-05,MO,Ralls,47,1043,29173
2021-02-06,MO,Ralls,7,1050,29173
2021-02-07,MO,Ralls,1,1051,29173
2021-02-08,MO,Ralls,82,1133,29173
2021-02-09,MO,Ralls,130,1263,29173
2021-02-10,MO,Ralls,6,1269,29173
2021-02-11,MO,Ralls,68,1337,29173
2021-02-12,MO,Ralls,125,1462,29173
2021-02-13,MO,Ralls,4,1466,29173
2021-02-15,MO,Ralls,88,1554,29173
2021-02-16,MO,Ralls,111,1665,29173
2021-02-17,MO,Ralls,15,1680,29173
2021-02-18,MO,Ralls,65,1745,29173
2021-02-19,MO,Ralls,28,1773,29173
2021-02-20,MO,Ralls,3,1776,29173
2021-02-21,MO,Ralls,2,1778,29173
2021-02-22,MO,Ralls,34,1812,29173
2021-02-23,MO,Ralls,10,1822,29173
2021-02-24,MO,Ralls,6,1828,29173
2021-02-25,MO,Ralls,87,1915,29173
2021-02-26,MO,Ralls,44,1959,29173
2021-02-27,MO,Ralls,6,1965,29173
2021-03-01,MO,Ralls,6,1971,29173
2021-03-02,MO,Ralls,118,2089,29173
2021-03-03,MO,Ralls,4,2093,29173
2021-03-04,MO,Ralls,101,2194,29173
2021-03-05,MO,Ralls,88,2282,29173
2021-03-06,MO,Ralls,3,2285,29173
2021-03-08,MO,Ralls,12,2297,29173
2021-03-09,MO,Ralls,23,2320,29173
2021-03-10,MO,Ralls,9,2329,29173
2021-03-11,MO,Ralls,21,2350,29173
2021-03-12,MO,Ralls,15,2365,29173
2021-03-13,MO,Ralls,2,2367,29173
2021-03-14,MO,Ralls,3,2370,29173
2021-03-15,MO,Ralls,67,2437,29173
2021-03-16,MO,Ralls,152,2589,29173
2021-03-17,MO,Ralls,12,2601,29173
2021-03-18,MO,Ralls,132,2733,29173
2021-03-19,MO,Ralls,19,2752,29173
2021-03-20,MO,Ralls,4,2756,29173
2021-03-22,MO,Ralls,37,2793,29173
2021-03-23,MO,Ralls,7,2800,29173
2021-03-24,MO,Ralls,46,2846,29173
2021-03-25,MO,Ralls,58,2904,29173
2021-03-26,MO,Ralls,13,2917,29173
2021-03-27,MO,Ralls,3,2920,29173
2021-03-29,MO,Ralls,5,2925,29173
2021-03-30,MO,Ralls,69,2994,29173
2021-03-31,MO,Ralls,13,3007,29173
2021-04-01,MO,Ralls,61,3068,29173
2021-04-02,MO,Ralls,82,3150,29173
2021-04-04,MO,Ralls,1,3151,29173
2021-04-05,MO,Ralls,4,3155,29173
2021-04-06,MO,Ralls,18,3173,29173
2021-04-07,MO,Ralls,20,3193,29173
2021-04-08,MO,Ralls,94,3287,29173
2021-04-09,MO,Ralls,87,3374,29173
2021-04-10,MO,Ralls,2,3376,29173
2021-04-11,MO,Ralls,5,3381,29173
2021-04-12,MO,Ralls,16,3397,29173
2021-04-13,MO,Ralls,137,3534,29173
2021-04-14,MO,Ralls,45,3579,29173
2021-04-15,MO,Ralls,17,3596,29173
2021-04-16,MO,Ralls,15,3611,29173
2021-04-17,MO,Ralls,2,3613,29173
2021-04-19,MO,Ralls,4,3617,29173
2021-04-20,MO,Ralls,27,3644,29173
2021-04-21,MO,Ralls,1,3645,29173
2021-04-22,MO,Ralls,15,3660,29173
2021-04-23,MO,Ralls,4,3664,29173
2021-04-24,MO,Ralls,2,3666,29173
2020-12-16,MO,Randolph,8,8,29175
2020-12-17,MO,Randolph,10,18,29175
2020-12-18,MO,Randolph,12,30,29175
2020-12-19,MO,Randolph,8,38,29175
2020-12-20,MO,Randolph,11,49,29175
2020-12-21,MO,Randolph,19,68,29175
2020-12-22,MO,Randolph,23,91,29175
2020-12-23,MO,Randolph,7,98,29175
2020-12-28,MO,Randolph,28,126,29175
2020-12-29,MO,Randolph,28,154,29175
2020-12-30,MO,Randolph,64,218,29175
2020-12-31,MO,Randolph,18,236,29175
2021-01-02,MO,Randolph,9,245,29175
2021-01-03,MO,Randolph,4,249,29175
2021-01-04,MO,Randolph,11,260,29175
2021-01-05,MO,Randolph,16,276,29175
2021-01-06,MO,Randolph,18,294,29175
2021-01-07,MO,Randolph,17,311,29175
2021-01-08,MO,Randolph,24,335,29175
2021-01-09,MO,Randolph,12,347,29175
2021-01-10,MO,Randolph,15,362,29175
2021-01-11,MO,Randolph,32,394,29175
2021-01-12,MO,Randolph,72,466,29175
2021-01-13,MO,Randolph,52,518,29175
2021-01-14,MO,Randolph,16,534,29175
2021-01-15,MO,Randolph,50,584,29175
2021-01-16,MO,Randolph,8,592,29175
2021-01-18,MO,Randolph,64,656,29175
2021-01-19,MO,Randolph,70,726,29175
2021-01-20,MO,Randolph,107,833,29175
2021-01-21,MO,Randolph,138,971,29175
2021-01-22,MO,Randolph,41,1012,29175
2021-01-23,MO,Randolph,43,1055,29175
2021-01-24,MO,Randolph,3,1058,29175
2021-01-25,MO,Randolph,36,1094,29175
2021-01-26,MO,Randolph,28,1122,29175
2021-01-27,MO,Randolph,9,1131,29175
2021-01-28,MO,Randolph,32,1163,29175
2021-01-29,MO,Randolph,978,2141,29175
2021-01-30,MO,Randolph,6,2147,29175
2021-01-31,MO,Randolph,6,2153,29175
2021-02-01,MO,Randolph,14,2167,29175
2021-02-02,MO,Randolph,127,2294,29175
2021-02-03,MO,Randolph,22,2316,29175
2021-02-04,MO,Randolph,57,2373,29175
2021-02-05,MO,Randolph,154,2527,29175
2021-02-06,MO,Randolph,25,2552,29175
2021-02-07,MO,Randolph,2,2554,29175
2021-02-08,MO,Randolph,15,2569,29175
2021-02-09,MO,Randolph,110,2679,29175
2021-02-10,MO,Randolph,108,2787,29175
2021-02-11,MO,Randolph,77,2864,29175
2021-02-12,MO,Randolph,107,2971,29175
2021-02-13,MO,Randolph,16,2987,29175
2021-02-14,MO,Randolph,3,2990,29175
2021-02-15,MO,Randolph,74,3064,29175
2021-02-16,MO,Randolph,75,3139,29175
2021-02-17,MO,Randolph,147,3286,29175
2021-02-18,MO,Randolph,80,3366,29175
2021-02-19,MO,Randolph,48,3414,29175
2021-02-20,MO,Randolph,42,3456,29175
2021-02-21,MO,Randolph,2,3458,29175
2021-02-22,MO,Randolph,48,3506,29175
2021-02-23,MO,Randolph,24,3530,29175
2021-02-24,MO,Randolph,668,4198,29175
2021-02-25,MO,Randolph,88,4286,29175
2021-02-26,MO,Randolph,30,4316,29175
2021-02-27,MO,Randolph,32,4348,29175
2021-02-28,MO,Randolph,1,4349,29175
2021-03-01,MO,Randolph,29,4378,29175
2021-03-02,MO,Randolph,100,4478,29175
2021-03-03,MO,Randolph,70,4548,29175
2021-03-04,MO,Randolph,86,4634,29175
2021-03-05,MO,Randolph,174,4808,29175
2021-03-06,MO,Randolph,32,4840,29175
2021-03-07,MO,Randolph,10,4850,29175
2021-03-08,MO,Randolph,84,4934,29175
2021-03-09,MO,Randolph,139,5073,29175
2021-03-10,MO,Randolph,422,5495,29175
2021-03-11,MO,Randolph,132,5627,29175
2021-03-12,MO,Randolph,91,5718,29175
2021-03-13,MO,Randolph,3,5721,29175
2021-03-15,MO,Randolph,81,5802,29175
2021-03-16,MO,Randolph,120,5922,29175
2021-03-17,MO,Randolph,207,6129,29175
2021-03-18,MO,Randolph,56,6185,29175
2021-03-19,MO,Randolph,55,6240,29175
2021-03-20,MO,Randolph,13,6253,29175
2021-03-21,MO,Randolph,9,6262,29175
2021-03-22,MO,Randolph,81,6343,29175
2021-03-23,MO,Randolph,109,6452,29175
2021-03-24,MO,Randolph,96,6548,29175
2021-03-25,MO,Randolph,88,6636,29175
2021-03-26,MO,Randolph,137,6773,29175
2021-03-27,MO,Randolph,23,6796,29175
2021-03-28,MO,Randolph,9,6805,29175
2021-03-29,MO,Randolph,53,6858,29175
2021-03-30,MO,Randolph,88,6946,29175
2021-03-31,MO,Randolph,381,7327,29175
2021-04-01,MO,Randolph,45,7372,29175
2021-04-02,MO,Randolph,109,7481,29175
2021-04-03,MO,Randolph,15,7496,29175
2021-04-04,MO,Randolph,2,7498,29175
2021-04-05,MO,Randolph,71,7569,29175
2021-04-06,MO,Randolph,145,7714,29175
2021-04-07,MO,Randolph,165,7879,29175
2021-04-08,MO,Randolph,60,7939,29175
2021-04-09,MO,Randolph,91,8030,29175
2021-04-10,MO,Randolph,13,8043,29175
2021-04-11,MO,Randolph,18,8061,29175
2021-04-12,MO,Randolph,97,8158,29175
2021-04-13,MO,Randolph,85,8243,29175
2021-04-14,MO,Randolph,102,8345,29175
2021-04-15,MO,Randolph,62,8407,29175
2021-04-16,MO,Randolph,141,8548,29175
2021-04-17,MO,Randolph,23,8571,29175
2021-04-18,MO,Randolph,4,8575,29175
2021-04-19,MO,Randolph,71,8646,29175
2021-04-20,MO,Randolph,95,8741,29175
2021-04-21,MO,Randolph,58,8799,29175
2021-04-22,MO,Randolph,30,8829,29175
2021-04-23,MO,Randolph,26,8855,29175
2021-04-24,MO,Randolph,9,8864,29175
2020-12-16,MO,Ray,1,1,29177
2020-12-17,MO,Ray,4,5,29177
2020-12-18,MO,Ray,3,8,29177
2020-12-19,MO,Ray,3,11,29177
2020-12-21,MO,Ray,10,21,29177
2020-12-22,MO,Ray,16,37,29177
2020-12-23,MO,Ray,13,50,29177
2020-12-24,MO,Ray,2,52,29177
2020-12-26,MO,Ray,3,55,29177
2020-12-27,MO,Ray,1,56,29177
2020-12-28,MO,Ray,4,60,29177
2020-12-29,MO,Ray,29,89,29177
2020-12-30,MO,Ray,46,135,29177
2020-12-31,MO,Ray,47,182,29177
2021-01-02,MO,Ray,17,199,29177
2021-01-03,MO,Ray,3,202,29177
2021-01-04,MO,Ray,1,203,29177
2021-01-05,MO,Ray,96,299,29177
2021-01-06,MO,Ray,26,325,29177
2021-01-07,MO,Ray,32,357,29177
2021-01-08,MO,Ray,33,390,29177
2021-01-09,MO,Ray,5,395,29177
2021-01-10,MO,Ray,1,396,29177
2021-01-11,MO,Ray,36,432,29177
2021-01-12,MO,Ray,25,457,29177
2021-01-13,MO,Ray,19,476,29177
2021-01-14,MO,Ray,10,486,29177
2021-01-15,MO,Ray,20,506,29177
2021-01-16,MO,Ray,3,509,29177
2021-01-17,MO,Ray,1,510,29177
2021-01-18,MO,Ray,108,618,29177
2021-01-19,MO,Ray,25,643,29177
2021-01-20,MO,Ray,34,677,29177
2021-01-21,MO,Ray,48,725,29177
2021-01-22,MO,Ray,49,774,29177
2021-01-23,MO,Ray,19,793,29177
2021-01-24,MO,Ray,1,794,29177
2021-01-25,MO,Ray,35,829,29177
2021-01-26,MO,Ray,90,919,29177
2021-01-27,MO,Ray,99,1018,29177
2021-01-28,MO,Ray,124,1142,29177
2021-01-29,MO,Ray,176,1318,29177
2021-01-30,MO,Ray,81,1399,29177
2021-01-31,MO,Ray,10,1409,29177
2021-02-01,MO,Ray,64,1473,29177
2021-02-02,MO,Ray,60,1533,29177
2021-02-03,MO,Ray,131,1664,29177
2021-02-04,MO,Ray,168,1832,29177
2021-02-05,MO,Ray,153,1985,29177
2021-02-06,MO,Ray,43,2028,29177
2021-02-08,MO,Ray,26,2054,29177
2021-02-09,MO,Ray,17,2071,29177
2021-02-10,MO,Ray,36,2107,29177
2021-02-11,MO,Ray,52,2159,29177
2021-02-12,MO,Ray,42,2201,29177
2021-02-13,MO,Ray,33,2234,29177
2021-02-14,MO,Ray,3,2237,29177
2021-02-15,MO,Ray,126,2363,29177
2021-02-16,MO,Ray,40,2403,29177
2021-02-17,MO,Ray,38,2441,29177
2021-02-18,MO,Ray,59,2500,29177
2021-02-19,MO,Ray,28,2528,29177
2021-02-20,MO,Ray,50,2578,29177
2021-02-21,MO,Ray,4,2582,29177
2021-02-22,MO,Ray,43,2625,29177
2021-02-23,MO,Ray,55,2680,29177
2021-02-24,MO,Ray,179,2859,29177
2021-02-25,MO,Ray,150,3009,29177
2021-02-26,MO,Ray,316,3325,29177
2021-02-27,MO,Ray,89,3414,29177
2021-02-28,MO,Ray,9,3423,29177
2021-03-01,MO,Ray,67,3490,29177
2021-03-02,MO,Ray,215,3705,29177
2021-03-03,MO,Ray,129,3834,29177
2021-03-04,MO,Ray,86,3920,29177
2021-03-05,MO,Ray,168,4088,29177
2021-03-06,MO,Ray,55,4143,29177
2021-03-07,MO,Ray,10,4153,29177
2021-03-08,MO,Ray,56,4209,29177
2021-03-09,MO,Ray,160,4369,29177
2021-03-10,MO,Ray,47,4416,29177
2021-03-11,MO,Ray,119,4535,29177
2021-03-12,MO,Ray,80,4615,29177
2021-03-13,MO,Ray,25,4640,29177
2021-03-14,MO,Ray,6,4646,29177
2021-03-15,MO,Ray,100,4746,29177
2021-03-16,MO,Ray,238,4984,29177
2021-03-17,MO,Ray,174,5158,29177
2021-03-18,MO,Ray,171,5329,29177
2021-03-19,MO,Ray,142,5471,29177
2021-03-20,MO,Ray,38,5509,29177
2021-03-21,MO,Ray,6,5515,29177
2021-03-22,MO,Ray,18,5533,29177
2021-03-23,MO,Ray,90,5623,29177
2021-03-24,MO,Ray,156,5779,29177
2021-03-25,MO,Ray,192,5971,29177
2021-03-26,MO,Ray,224,6195,29177
2021-03-27,MO,Ray,37,6232,29177
2021-03-28,MO,Ray,9,6241,29177
2021-03-29,MO,Ray,93,6334,29177
2021-03-30,MO,Ray,153,6487,29177
2021-03-31,MO,Ray,167,6654,29177
2021-04-01,MO,Ray,118,6772,29177
2021-04-02,MO,Ray,255,7027,29177
2021-04-03,MO,Ray,22,7049,29177
2021-04-04,MO,Ray,1,7050,29177
2021-04-05,MO,Ray,68,7118,29177
2021-04-06,MO,Ray,89,7207,29177
2021-04-07,MO,Ray,110,7317,29177
2021-04-08,MO,Ray,122,7439,29177
2021-04-09,MO,Ray,233,7672,29177
2021-04-10,MO,Ray,42,7714,29177
2021-04-11,MO,Ray,11,7725,29177
2021-04-12,MO,Ray,64,7789,29177
2021-04-13,MO,Ray,120,7909,29177
2021-04-14,MO,Ray,222,8131,29177
2021-04-15,MO,Ray,114,8245,29177
2021-04-16,MO,Ray,170,8415,29177
2021-04-17,MO,Ray,45,8460,29177
2021-04-18,MO,Ray,5,8465,29177
2021-04-19,MO,Ray,31,8496,29177
2021-04-20,MO,Ray,58,8554,29177
2021-04-21,MO,Ray,67,8621,29177
2021-04-22,MO,Ray,100,8721,29177
2021-04-23,MO,Ray,68,8789,29177
2021-04-24,MO,Ray,12,8801,29177
2021-04-25,MO,Ray,2,8803,29177
2020-12-18,MO,Reynolds,1,1,29179
2020-12-23,MO,Reynolds,3,4,29179
2020-12-24,MO,Reynolds,1,5,29179
2020-12-29,MO,Reynolds,2,7,29179
2020-12-31,MO,Reynolds,6,13,29179
2021-01-01,MO,Reynolds,1,14,29179
2021-01-02,MO,Reynolds,3,17,29179
2021-01-04,MO,Reynolds,1,18,29179
2021-01-06,MO,Reynolds,1,19,29179
2021-01-07,MO,Reynolds,1,20,29179
2021-01-08,MO,Reynolds,1,21,29179
2021-01-09,MO,Reynolds,1,22,29179
2021-01-11,MO,Reynolds,2,24,29179
2021-01-12,MO,Reynolds,1,25,29179
2021-01-13,MO,Reynolds,9,34,29179
2021-01-14,MO,Reynolds,3,37,29179
2021-01-15,MO,Reynolds,3,40,29179
2021-01-18,MO,Reynolds,1,41,29179
2021-01-19,MO,Reynolds,4,45,29179
2021-01-20,MO,Reynolds,11,56,29179
2021-01-21,MO,Reynolds,2,58,29179
2021-01-22,MO,Reynolds,17,75,29179
2021-01-23,MO,Reynolds,2,77,29179
2021-01-25,MO,Reynolds,7,84,29179
2021-01-26,MO,Reynolds,2,86,29179
2021-01-27,MO,Reynolds,3,89,29179
2021-01-28,MO,Reynolds,9,98,29179
2021-01-29,MO,Reynolds,14,112,29179
2021-01-30,MO,Reynolds,3,115,29179
2021-02-01,MO,Reynolds,2,117,29179
2021-02-02,MO,Reynolds,61,178,29179
2021-02-03,MO,Reynolds,31,209,29179
2021-02-04,MO,Reynolds,13,222,29179
2021-02-05,MO,Reynolds,6,228,29179
2021-02-06,MO,Reynolds,9,237,29179
2021-02-08,MO,Reynolds,138,375,29179
2021-02-09,MO,Reynolds,39,414,29179
2021-02-10,MO,Reynolds,7,421,29179
2021-02-11,MO,Reynolds,21,442,29179
2021-02-12,MO,Reynolds,30,472,29179
2021-02-13,MO,Reynolds,1,473,29179
2021-02-16,MO,Reynolds,1,474,29179
2021-02-17,MO,Reynolds,3,477,29179
2021-02-18,MO,Reynolds,10,487,29179
2021-02-19,MO,Reynolds,17,504,29179
2021-02-20,MO,Reynolds,3,507,29179
2021-02-21,MO,Reynolds,1,508,29179
2021-02-22,MO,Reynolds,66,574,29179
2021-02-23,MO,Reynolds,9,583,29179
2021-02-24,MO,Reynolds,3,586,29179
2021-02-25,MO,Reynolds,26,612,29179
2021-02-26,MO,Reynolds,19,631,29179
2021-02-27,MO,Reynolds,32,663,29179
2021-03-01,MO,Reynolds,131,794,29179
2021-03-02,MO,Reynolds,67,861,29179
2021-03-03,MO,Reynolds,42,903,29179
2021-03-04,MO,Reynolds,9,912,29179
2021-03-05,MO,Reynolds,3,915,29179
2021-03-06,MO,Reynolds,11,926,29179
2021-03-08,MO,Reynolds,9,935,29179
2021-03-09,MO,Reynolds,6,941,29179
2021-03-10,MO,Reynolds,7,948,29179
2021-03-11,MO,Reynolds,21,969,29179
2021-03-12,MO,Reynolds,19,988,29179
2021-03-13,MO,Reynolds,2,990,29179
2021-03-15,MO,Reynolds,2,992,29179
2021-03-16,MO,Reynolds,6,998,29179
2021-03-17,MO,Reynolds,8,1006,29179
2021-03-18,MO,Reynolds,26,1032,29179
2021-03-19,MO,Reynolds,19,1051,29179
2021-03-20,MO,Reynolds,5,1056,29179
2021-03-21,MO,Reynolds,2,1058,29179
2021-03-22,MO,Reynolds,14,1072,29179
2021-03-23,MO,Reynolds,73,1145,29179
2021-03-24,MO,Reynolds,6,1151,29179
2021-03-25,MO,Reynolds,16,1167,29179
2021-03-26,MO,Reynolds,4,1171,29179
2021-03-27,MO,Reynolds,27,1198,29179
2021-03-28,MO,Reynolds,3,1201,29179
2021-03-29,MO,Reynolds,12,1213,29179
2021-03-30,MO,Reynolds,12,1225,29179
2021-03-31,MO,Reynolds,40,1265,29179
2021-04-01,MO,Reynolds,16,1281,29179
2021-04-02,MO,Reynolds,4,1285,29179
2021-04-03,MO,Reynolds,5,1290,29179
2021-04-04,MO,Reynolds,1,1291,29179
2021-04-05,MO,Reynolds,6,1297,29179
2021-04-06,MO,Reynolds,8,1305,29179
2021-04-07,MO,Reynolds,25,1330,29179
2021-04-08,MO,Reynolds,11,1341,29179
2021-04-09,MO,Reynolds,19,1360,29179
2021-04-10,MO,Reynolds,6,1366,29179
2021-04-11,MO,Reynolds,3,1369,29179
2021-04-12,MO,Reynolds,2,1371,29179
2021-04-13,MO,Reynolds,4,1375,29179
2021-04-14,MO,Reynolds,10,1385,29179
2021-04-15,MO,Reynolds,25,1410,29179
2021-04-16,MO,Reynolds,6,1416,29179
2021-04-17,MO,Reynolds,1,1417,29179
2021-04-18,MO,Reynolds,1,1418,29179
2021-04-19,MO,Reynolds,9,1427,29179
2021-04-20,MO,Reynolds,9,1436,29179
2021-04-21,MO,Reynolds,21,1457,29179
2021-04-22,MO,Reynolds,16,1473,29179
2021-04-23,MO,Reynolds,9,1482,29179
2021-04-24,MO,Reynolds,1,1483,29179
2021-04-25,MO,Reynolds,3,1486,29179
2020-12-18,MO,Ripley,4,4,29181
2020-12-22,MO,Ripley,1,5,29181
2020-12-23,MO,Ripley,5,10,29181
2020-12-28,MO,Ripley,6,16,29181
2020-12-29,MO,Ripley,28,44,29181
2020-12-30,MO,Ripley,104,148,29181
2020-12-31,MO,Ripley,4,152,29181
2021-01-04,MO,Ripley,6,158,29181
2021-01-05,MO,Ripley,25,183,29181
2021-01-06,MO,Ripley,8,191,29181
2021-01-07,MO,Ripley,281,472,29181
2021-01-08,MO,Ripley,12,484,29181
2021-01-11,MO,Ripley,11,495,29181
2021-01-12,MO,Ripley,48,543,29181
2021-01-13,MO,Ripley,4,547,29181
2021-01-14,MO,Ripley,62,609,29181
2021-01-15,MO,Ripley,3,612,29181
2021-01-18,MO,Ripley,1,613,29181
2021-01-19,MO,Ripley,13,626,29181
2021-01-20,MO,Ripley,2,628,29181
2021-01-21,MO,Ripley,4,632,29181
2021-01-22,MO,Ripley,68,700,29181
2021-01-23,MO,Ripley,30,730,29181
2021-01-24,MO,Ripley,1,731,29181
2021-01-25,MO,Ripley,11,742,29181
2021-01-26,MO,Ripley,53,795,29181
2021-01-27,MO,Ripley,7,802,29181
2021-01-28,MO,Ripley,147,949,29181
2021-01-29,MO,Ripley,13,962,29181
2021-01-31,MO,Ripley,1,963,29181
2021-02-01,MO,Ripley,11,974,29181
2021-02-02,MO,Ripley,20,994,29181
2021-02-03,MO,Ripley,24,1018,29181
2021-02-04,MO,Ripley,153,1171,29181
2021-02-05,MO,Ripley,137,1308,29181
2021-02-06,MO,Ripley,491,1799,29181
2021-02-08,MO,Ripley,13,1812,29181
2021-02-09,MO,Ripley,63,1875,29181
2021-02-10,MO,Ripley,2,1877,29181
2021-02-11,MO,Ripley,2,1879,29181
2021-02-12,MO,Ripley,84,1963,29181
2021-02-13,MO,Ripley,1,1964,29181
2021-02-14,MO,Ripley,1,1965,29181
2021-02-15,MO,Ripley,1,1966,29181
2021-02-16,MO,Ripley,5,1971,29181
2021-02-17,MO,Ripley,3,1974,29181
2021-02-18,MO,Ripley,5,1979,29181
2021-02-19,MO,Ripley,11,1990,29181
2021-02-20,MO,Ripley,49,2039,29181
2021-02-21,MO,Ripley,7,2046,29181
2021-02-22,MO,Ripley,27,2073,29181
2021-02-23,MO,Ripley,16,2089,29181
2021-02-24,MO,Ripley,32,2121,29181
2021-02-25,MO,Ripley,10,2131,29181
2021-02-26,MO,Ripley,12,2143,29181
2021-02-27,MO,Ripley,4,2147,29181
2021-02-28,MO,Ripley,2,2149,29181
2021-03-01,MO,Ripley,12,2161,29181
2021-03-02,MO,Ripley,27,2188,29181
2021-03-03,MO,Ripley,23,2211,29181
2021-03-04,MO,Ripley,17,2228,29181
2021-03-05,MO,Ripley,21,2249,29181
2021-03-06,MO,Ripley,478,2727,29181
2021-03-07,MO,Ripley,1,2728,29181
2021-03-08,MO,Ripley,27,2755,29181
2021-03-09,MO,Ripley,42,2797,29181
2021-03-10,MO,Ripley,29,2826,29181
2021-03-11,MO,Ripley,107,2933,29181
2021-03-12,MO,Ripley,119,3052,29181
2021-03-13,MO,Ripley,6,3058,29181
2021-03-14,MO,Ripley,1,3059,29181
2021-03-15,MO,Ripley,12,3071,29181
2021-03-16,MO,Ripley,10,3081,29181
2021-03-17,MO,Ripley,32,3113,29181
2021-03-18,MO,Ripley,27,3140,29181
2021-03-19,MO,Ripley,25,3165,29181
2021-03-20,MO,Ripley,10,3175,29181
2021-03-21,MO,Ripley,3,3178,29181
2021-03-22,MO,Ripley,6,3184,29181
2021-03-23,MO,Ripley,30,3214,29181
2021-03-24,MO,Ripley,29,3243,29181
2021-03-25,MO,Ripley,11,3254,29181
2021-03-26,MO,Ripley,13,3267,29181
2021-03-27,MO,Ripley,4,3271,29181
2021-03-28,MO,Ripley,3,3274,29181
2021-03-29,MO,Ripley,8,3282,29181
2021-03-30,MO,Ripley,58,3340,29181
2021-03-31,MO,Ripley,27,3367,29181
2021-04-01,MO,Ripley,28,3395,29181
2021-04-02,MO,Ripley,10,3405,29181
2021-04-03,MO,Ripley,4,3409,29181
2021-04-04,MO,Ripley,5,3414,29181
2021-04-05,MO,Ripley,20,3434,29181
2021-04-06,MO,Ripley,40,3474,29181
2021-04-07,MO,Ripley,36,3510,29181
2021-04-08,MO,Ripley,105,3615,29181
2021-04-09,MO,Ripley,155,3770,29181
2021-04-10,MO,Ripley,13,3783,29181
2021-04-11,MO,Ripley,5,3788,29181
2021-04-12,MO,Ripley,17,3805,29181
2021-04-13,MO,Ripley,29,3834,29181
2021-04-14,MO,Ripley,29,3863,29181
2021-04-15,MO,Ripley,22,3885,29181
2021-04-16,MO,Ripley,34,3919,29181
2021-04-17,MO,Ripley,7,3926,29181
2021-04-18,MO,Ripley,6,3932,29181
2021-04-19,MO,Ripley,18,3950,29181
2021-04-20,MO,Ripley,12,3962,29181
2021-04-21,MO,Ripley,26,3988,29181
2021-04-22,MO,Ripley,24,4012,29181
2021-04-23,MO,Ripley,27,4039,29181
2021-04-24,MO,Ripley,2,4041,29181
2021-04-25,MO,Ripley,2,4043,29181
2020-12-16,MO,Saline,1,1,29195
2020-12-17,MO,Saline,4,5,29195
2020-12-18,MO,Saline,5,10,29195
2020-12-19,MO,Saline,4,14,29195
2020-12-20,MO,Saline,1,15,29195
2020-12-21,MO,Saline,10,25,29195
2020-12-22,MO,Saline,6,31,29195
2020-12-23,MO,Saline,10,41,29195
2020-12-24,MO,Saline,1,42,29195
2020-12-28,MO,Saline,95,137,29195
2020-12-29,MO,Saline,79,216,29195
2020-12-30,MO,Saline,44,260,29195
2020-12-31,MO,Saline,9,269,29195
2021-01-02,MO,Saline,1,270,29195
2021-01-03,MO,Saline,1,271,29195
2021-01-04,MO,Saline,20,291,29195
2021-01-05,MO,Saline,79,370,29195
2021-01-06,MO,Saline,102,472,29195
2021-01-07,MO,Saline,18,490,29195
2021-01-08,MO,Saline,9,499,29195
2021-01-09,MO,Saline,4,503,29195
2021-01-10,MO,Saline,11,514,29195
2021-01-11,MO,Saline,80,594,29195
2021-01-12,MO,Saline,142,736,29195
2021-01-13,MO,Saline,69,805,29195
2021-01-14,MO,Saline,43,848,29195
2021-01-15,MO,Saline,25,873,29195
2021-01-16,MO,Saline,6,879,29195
2021-01-18,MO,Saline,33,912,29195
2021-01-19,MO,Saline,135,1047,29195
2021-01-20,MO,Saline,86,1133,29195
2021-01-21,MO,Saline,51,1184,29195
2021-01-22,MO,Saline,27,1211,29195
2021-01-23,MO,Saline,7,1218,29195
2021-01-25,MO,Saline,54,1272,29195
2021-01-26,MO,Saline,146,1418,29195
2021-01-27,MO,Saline,88,1506,29195
2021-01-28,MO,Saline,329,1835,29195
2021-01-29,MO,Saline,337,2172,29195
2021-01-30,MO,Saline,24,2196,29195
2021-01-31,MO,Saline,2,2198,29195
2021-02-01,MO,Saline,216,2414,29195
2021-02-02,MO,Saline,86,2500,29195
2021-02-03,MO,Saline,383,2883,29195
2021-02-04,MO,Saline,306,3189,29195
2021-02-05,MO,Saline,85,3274,29195
2021-02-06,MO,Saline,4,3278,29195
2021-02-08,MO,Saline,187,3465,29195
2021-02-09,MO,Saline,451,3916,29195
2021-02-10,MO,Saline,309,4225,29195
2021-02-11,MO,Saline,86,4311,29195
2021-02-12,MO,Saline,91,4402,29195
2021-02-13,MO,Saline,16,4418,29195
2021-02-14,MO,Saline,4,4422,29195
2021-02-15,MO,Saline,25,4447,29195
2021-02-16,MO,Saline,251,4698,29195
2021-02-17,MO,Saline,87,4785,29195
2021-02-18,MO,Saline,83,4868,29195
2021-02-19,MO,Saline,95,4963,29195
2021-02-20,MO,Saline,8,4971,29195
2021-02-21,MO,Saline,1,4972,29195
2021-02-22,MO,Saline,18,4990,29195
2021-02-23,MO,Saline,528,5518,29195
2021-02-24,MO,Saline,275,5793,29195
2021-02-25,MO,Saline,252,6045,29195
2021-02-26,MO,Saline,110,6155,29195
2021-02-27,MO,Saline,17,6172,29195
2021-02-28,MO,Saline,6,6178,29195
2021-03-01,MO,Saline,242,6420,29195
2021-03-02,MO,Saline,325,6745,29195
2021-03-03,MO,Saline,546,7291,29195
2021-03-04,MO,Saline,155,7446,29195
2021-03-05,MO,Saline,27,7473,29195
2021-03-06,MO,Saline,11,7484,29195
2021-03-07,MO,Saline,3,7487,29195
2021-03-08,MO,Saline,164,7651,29195
2021-03-09,MO,Saline,49,7700,29195
2021-03-10,MO,Saline,187,7887,29195
2021-03-11,MO,Saline,24,7911,29195
2021-03-12,MO,Saline,488,8399,29195
2021-03-13,MO,Saline,25,8424,29195
2021-03-14,MO,Saline,9,8433,29195
2021-03-15,MO,Saline,151,8584,29195
2021-03-16,MO,Saline,334,8918,29195
2021-03-17,MO,Saline,129,9047,29195
2021-03-18,MO,Saline,105,9152,29195
2021-03-19,MO,Saline,39,9191,29195
2021-03-20,MO,Saline,12,9203,29195
2021-03-21,MO,Saline,5,9208,29195
2021-03-22,MO,Saline,48,9256,29195
2021-03-23,MO,Saline,63,9319,29195
2021-03-24,MO,Saline,299,9618,29195
2021-03-25,MO,Saline,212,9830,29195
2021-03-26,MO,Saline,163,9993,29195
2021-03-27,MO,Saline,240,10233,29195
2021-03-28,MO,Saline,16,10249,29195
2021-03-29,MO,Saline,62,10311,29195
2021-03-30,MO,Saline,55,10366,29195
2021-03-31,MO,Saline,183,10549,29195
2021-04-01,MO,Saline,119,10668,29195
2021-04-02,MO,Saline,530,11198,29195
2021-04-03,MO,Saline,24,11222,29195
2021-04-04,MO,Saline,3,11225,29195
2021-04-05,MO,Saline,151,11376,29195
2021-04-06,MO,Saline,58,11434,29195
2021-04-07,MO,Saline,107,11541,29195
2021-04-08,MO,Saline,48,11589,29195
2021-04-09,MO,Saline,78,11667,29195
2021-04-10,MO,Saline,20,11687,29195
2021-04-11,MO,Saline,6,11693,29195
2021-04-12,MO,Saline,171,11864,29195
2021-04-13,MO,Saline,47,11911,29195
2021-04-14,MO,Saline,116,12027,29195
2021-04-15,MO,Saline,90,12117,29195
2021-04-16,MO,Saline,43,12160,29195
2021-04-17,MO,Saline,214,12374,29195
2021-04-18,MO,Saline,6,12380,29195
2021-04-19,MO,Saline,38,12418,29195
2021-04-20,MO,Saline,74,12492,29195
2021-04-21,MO,Saline,132,12624,29195
2021-04-22,MO,Saline,65,12689,29195
2021-04-23,MO,Saline,84,12773,29195
2021-04-24,MO,Saline,17,12790,29195
2021-04-25,MO,Saline,6,12796,29195
2020-12-17,MO,Schuyler,1,1,29197
2020-12-20,MO,Schuyler,1,2,29197
2020-12-21,MO,Schuyler,10,12,29197
2020-12-22,MO,Schuyler,2,14,29197
2020-12-23,MO,Schuyler,14,28,29197
2020-12-28,MO,Schuyler,2,30,29197
2020-12-29,MO,Schuyler,1,31,29197
2020-12-30,MO,Schuyler,1,32,29197
2021-01-04,MO,Schuyler,1,33,29197
2021-01-05,MO,Schuyler,1,34,29197
2021-01-07,MO,Schuyler,2,36,29197
2021-01-10,MO,Schuyler,1,37,29197
2021-01-11,MO,Schuyler,13,50,29197
2021-01-12,MO,Schuyler,2,52,29197
2021-01-13,MO,Schuyler,10,62,29197
2021-01-14,MO,Schuyler,4,66,29197
2021-01-15,MO,Schuyler,36,102,29197
2021-01-17,MO,Schuyler,2,104,29197
2021-01-19,MO,Schuyler,4,108,29197
2021-01-20,MO,Schuyler,5,113,29197
2021-01-21,MO,Schuyler,23,136,29197
2021-01-22,MO,Schuyler,3,139,29197
2021-01-23,MO,Schuyler,2,141,29197
2021-01-27,MO,Schuyler,14,155,29197
2021-01-28,MO,Schuyler,1,156,29197
2021-01-29,MO,Schuyler,1,157,29197
2021-02-01,MO,Schuyler,5,162,29197
2021-02-02,MO,Schuyler,13,175,29197
2021-02-03,MO,Schuyler,8,183,29197
2021-02-04,MO,Schuyler,8,191,29197
2021-02-05,MO,Schuyler,134,325,29197
2021-02-06,MO,Schuyler,20,345,29197
2021-02-08,MO,Schuyler,3,348,29197
2021-02-09,MO,Schuyler,2,350,29197
2021-02-10,MO,Schuyler,2,352,29197
2021-02-11,MO,Schuyler,28,380,29197
2021-02-12,MO,Schuyler,70,450,29197
2021-02-13,MO,Schuyler,2,452,29197
2021-02-14,MO,Schuyler,2,454,29197
2021-02-15,MO,Schuyler,1,455,29197
2021-02-16,MO,Schuyler,6,461,29197
2021-02-18,MO,Schuyler,4,465,29197
2021-02-19,MO,Schuyler,7,472,29197
2021-02-23,MO,Schuyler,65,537,29197
2021-02-24,MO,Schuyler,12,549,29197
2021-02-25,MO,Schuyler,21,570,29197
2021-02-26,MO,Schuyler,15,585,29197
2021-02-27,MO,Schuyler,7,592,29197
2021-02-28,MO,Schuyler,2,594,29197
2021-03-01,MO,Schuyler,20,614,29197
2021-03-02,MO,Schuyler,62,676,29197
2021-03-03,MO,Schuyler,6,682,29197
2021-03-04,MO,Schuyler,3,685,29197
2021-03-05,MO,Schuyler,134,819,29197
2021-03-06,MO,Schuyler,20,839,29197
2021-03-08,MO,Schuyler,5,844,29197
2021-03-09,MO,Schuyler,29,873,29197
2021-03-10,MO,Schuyler,3,876,29197
2021-03-11,MO,Schuyler,3,879,29197
2021-03-12,MO,Schuyler,42,921,29197
2021-03-13,MO,Schuyler,1,922,29197
2021-03-15,MO,Schuyler,1,923,29197
2021-03-16,MO,Schuyler,14,937,29197
2021-03-17,MO,Schuyler,13,950,29197
2021-03-18,MO,Schuyler,11,961,29197
2021-03-19,MO,Schuyler,16,977,29197
2021-03-20,MO,Schuyler,9,986,29197
2021-03-22,MO,Schuyler,4,990,29197
2021-03-23,MO,Schuyler,55,1045,29197
2021-03-24,MO,Schuyler,7,1052,29197
2021-03-25,MO,Schuyler,24,1076,29197
2021-03-26,MO,Schuyler,24,1100,29197
2021-03-30,MO,Schuyler,64,1164,29197
2021-03-31,MO,Schuyler,5,1169,29197
2021-04-01,MO,Schuyler,4,1173,29197
2021-04-02,MO,Schuyler,8,1181,29197
2021-04-03,MO,Schuyler,1,1182,29197
2021-04-05,MO,Schuyler,6,1188,29197
2021-04-06,MO,Schuyler,58,1246,29197
2021-04-07,MO,Schuyler,1,1247,29197
2021-04-08,MO,Schuyler,7,1254,29197
2021-04-09,MO,Schuyler,3,1257,29197
2021-04-10,MO,Schuyler,4,1261,29197
2021-04-11,MO,Schuyler,1,1262,29197
2021-04-12,MO,Schuyler,4,1266,29197
2021-04-13,MO,Schuyler,3,1269,29197
2021-04-14,MO,Schuyler,6,1275,29197
2021-04-15,MO,Schuyler,6,1281,29197
2021-04-16,MO,Schuyler,23,1304,29197
2021-04-17,MO,Schuyler,2,1306,29197
2021-04-19,MO,Schuyler,1,1307,29197
2021-04-20,MO,Schuyler,2,1309,29197
2021-04-21,MO,Schuyler,7,1316,29197
2021-04-22,MO,Schuyler,2,1318,29197
2021-04-23,MO,Schuyler,3,1321,29197
2020-12-21,MO,Scotland,4,4,29199
2020-12-22,MO,Scotland,4,8,29199
2020-12-23,MO,Scotland,26,34,29199
2020-12-28,MO,Scotland,14,48,29199
2020-12-29,MO,Scotland,1,49,29199
2021-01-04,MO,Scotland,1,50,29199
2021-01-05,MO,Scotland,5,55,29199
2021-01-07,MO,Scotland,1,56,29199
2021-01-08,MO,Scotland,1,57,29199
2021-01-11,MO,Scotland,7,64,29199
2021-01-12,MO,Scotland,1,65,29199
2021-01-13,MO,Scotland,5,70,29199
2021-01-14,MO,Scotland,1,71,29199
2021-01-15,MO,Scotland,5,76,29199
2021-01-17,MO,Scotland,26,102,29199
2021-01-18,MO,Scotland,2,104,29199
2021-01-19,MO,Scotland,3,107,29199
2021-01-20,MO,Scotland,28,135,29199
2021-01-21,MO,Scotland,46,181,29199
2021-01-22,MO,Scotland,1,182,29199
2021-01-25,MO,Scotland,12,194,29199
2021-01-26,MO,Scotland,1,195,29199
2021-01-27,MO,Scotland,32,227,29199
2021-01-28,MO,Scotland,2,229,29199
2021-01-29,MO,Scotland,52,281,29199
2021-01-30,MO,Scotland,1,282,29199
2021-02-01,MO,Scotland,43,325,29199
2021-02-02,MO,Scotland,48,373,29199
2021-02-03,MO,Scotland,48,421,29199
2021-02-04,MO,Scotland,17,438,29199
2021-02-05,MO,Scotland,5,443,29199
2021-02-06,MO,Scotland,128,571,29199
2021-02-08,MO,Scotland,5,576,29199
2021-02-09,MO,Scotland,3,579,29199
2021-02-10,MO,Scotland,3,582,29199
2021-02-11,MO,Scotland,43,625,29199
2021-02-12,MO,Scotland,110,735,29199
2021-02-14,MO,Scotland,27,762,29199
2021-02-15,MO,Scotland,13,775,29199
2021-02-16,MO,Scotland,7,782,29199
2021-02-17,MO,Scotland,1,783,29199
2021-02-19,MO,Scotland,6,789,29199
2021-02-20,MO,Scotland,1,790,29199
2021-02-23,MO,Scotland,2,792,29199
2021-02-24,MO,Scotland,3,795,29199
2021-02-25,MO,Scotland,68,863,29199
2021-02-26,MO,Scotland,35,898,29199
2021-02-27,MO,Scotland,1,899,29199
2021-03-01,MO,Scotland,112,1011,29199
2021-03-02,MO,Scotland,6,1017,29199
2021-03-03,MO,Scotland,26,1043,29199
2021-03-04,MO,Scotland,2,1045,29199
2021-03-05,MO,Scotland,36,1081,29199
2021-03-06,MO,Scotland,121,1202,29199
2021-03-07,MO,Scotland,1,1203,29199
2021-03-08,MO,Scotland,4,1207,29199
2021-03-09,MO,Scotland,5,1212,29199
2021-03-10,MO,Scotland,6,1218,29199
2021-03-11,MO,Scotland,2,1220,29199
2021-03-12,MO,Scotland,91,1311,29199
2021-03-13,MO,Scotland,1,1312,29199
2021-03-14,MO,Scotland,1,1313,29199
2021-03-15,MO,Scotland,6,1319,29199
2021-03-16,MO,Scotland,12,1331,29199
2021-03-17,MO,Scotland,19,1350,29199
2021-03-18,MO,Scotland,22,1372,29199
2021-03-19,MO,Scotland,33,1405,29199
2021-03-20,MO,Scotland,2,1407,29199
2021-03-23,MO,Scotland,2,1409,29199
2021-03-24,MO,Scotland,8,1417,29199
2021-03-25,MO,Scotland,5,1422,29199
2021-03-26,MO,Scotland,33,1455,29199
2021-03-28,MO,Scotland,1,1456,29199
2021-03-29,MO,Scotland,2,1458,29199
2021-03-30,MO,Scotland,4,1462,29199
2021-03-31,MO,Scotland,12,1474,29199
2021-04-01,MO,Scotland,5,1479,29199
2021-04-02,MO,Scotland,4,1483,29199
2021-04-03,MO,Scotland,1,1484,29199
2021-04-05,MO,Scotland,2,1486,29199
2021-04-06,MO,Scotland,5,1491,29199
2021-04-07,MO,Scotland,1,1492,29199
2021-04-08,MO,Scotland,4,1496,29199
2021-04-09,MO,Scotland,2,1498,29199
2021-04-10,MO,Scotland,11,1509,29199
2021-04-12,MO,Scotland,1,1510,29199
2021-04-14,MO,Scotland,3,1513,29199
2021-04-15,MO,Scotland,2,1515,29199
2021-04-16,MO,Scotland,19,1534,29199
2021-04-19,MO,Scotland,3,1537,29199
2021-04-21,MO,Scotland,2,1539,29199
2021-04-22,MO,Scotland,2,1541,29199
2021-04-23,MO,Scotland,9,1550,29199
2020-12-15,MO,Scott,1,1,29201
2020-12-17,MO,Scott,31,32,29201
2020-12-18,MO,Scott,22,54,29201
2020-12-19,MO,Scott,4,58,29201
2020-12-20,MO,Scott,4,62,29201
2020-12-21,MO,Scott,71,133,29201
2020-12-22,MO,Scott,203,336,29201
2020-12-23,MO,Scott,186,522,29201
2020-12-24,MO,Scott,7,529,29201
2020-12-26,MO,Scott,2,531,29201
2020-12-28,MO,Scott,7,538,29201
2020-12-29,MO,Scott,18,556,29201
2020-12-30,MO,Scott,88,644,29201
2020-12-31,MO,Scott,12,656,29201
2021-01-01,MO,Scott,8,664,29201
2021-01-02,MO,Scott,2,666,29201
2021-01-03,MO,Scott,1,667,29201
2021-01-04,MO,Scott,20,687,29201
2021-01-05,MO,Scott,49,736,29201
2021-01-06,MO,Scott,93,829,29201
2021-01-07,MO,Scott,31,860,29201
2021-01-08,MO,Scott,143,1003,29201
2021-01-09,MO,Scott,24,1027,29201
2021-01-10,MO,Scott,3,1030,29201
2021-01-11,MO,Scott,60,1090,29201
2021-01-12,MO,Scott,305,1395,29201
2021-01-13,MO,Scott,186,1581,29201
2021-01-14,MO,Scott,95,1676,29201
2021-01-15,MO,Scott,98,1774,29201
2021-01-16,MO,Scott,42,1816,29201
2021-01-17,MO,Scott,1,1817,29201
2021-01-18,MO,Scott,272,2089,29201
2021-01-19,MO,Scott,310,2399,29201
2021-01-20,MO,Scott,506,2905,29201
2021-01-21,MO,Scott,401,3306,29201
2021-01-22,MO,Scott,561,3867,29201
2021-01-23,MO,Scott,11,3878,29201
2021-01-24,MO,Scott,1,3879,29201
2021-01-25,MO,Scott,238,4117,29201
2021-01-26,MO,Scott,213,4330,29201
2021-01-27,MO,Scott,164,4494,29201
2021-01-28,MO,Scott,102,4596,29201
2021-01-29,MO,Scott,979,5575,29201
2021-01-30,MO,Scott,3,5578,29201
2021-02-01,MO,Scott,47,5625,29201
2021-02-02,MO,Scott,90,5715,29201
2021-02-03,MO,Scott,42,5757,29201
2021-02-04,MO,Scott,119,5876,29201
2021-02-05,MO,Scott,770,6646,29201
2021-02-06,MO,Scott,22,6668,29201
2021-02-07,MO,Scott,3,6671,29201
2021-02-08,MO,Scott,243,6914,29201
2021-02-09,MO,Scott,566,7480,29201
2021-02-10,MO,Scott,427,7907,29201
2021-02-11,MO,Scott,251,8158,29201
2021-02-12,MO,Scott,646,8804,29201
2021-02-13,MO,Scott,143,8947,29201
2021-02-14,MO,Scott,3,8950,29201
2021-02-15,MO,Scott,115,9065,29201
2021-02-16,MO,Scott,120,9185,29201
2021-02-17,MO,Scott,71,9256,29201
2021-02-18,MO,Scott,49,9305,29201
2021-02-19,MO,Scott,156,9461,29201
2021-02-20,MO,Scott,66,9527,29201
2021-02-22,MO,Scott,123,9650,29201
2021-02-23,MO,Scott,102,9752,29201
2021-02-24,MO,Scott,772,10524,29201
2021-02-25,MO,Scott,171,10695,29201
2021-02-26,MO,Scott,877,11572,29201
2021-02-27,MO,Scott,89,11661,29201
2021-02-28,MO,Scott,5,11666,29201
2021-03-01,MO,Scott,76,11742,29201
2021-03-02,MO,Scott,172,11914,29201
2021-03-03,MO,Scott,417,12331,29201
2021-03-04,MO,Scott,328,12659,29201
2021-03-05,MO,Scott,590,13249,29201
2021-03-06,MO,Scott,23,13272,29201
2021-03-07,MO,Scott,1,13273,29201
2021-03-08,MO,Scott,178,13451,29201
2021-03-09,MO,Scott,194,13645,29201
2021-03-10,MO,Scott,155,13800,29201
2021-03-11,MO,Scott,139,13939,29201
2021-03-12,MO,Scott,179,14118,29201
2021-03-13,MO,Scott,16,14134,29201
2021-03-14,MO,Scott,418,14552,29201
2021-03-15,MO,Scott,127,14679,29201
2021-03-16,MO,Scott,320,14999,29201
2021-03-17,MO,Scott,605,15604,29201
2021-03-18,MO,Scott,114,15718,29201
2021-03-19,MO,Scott,261,15979,29201
2021-03-20,MO,Scott,19,15998,29201
2021-03-21,MO,Scott,32,16030,29201
2021-03-22,MO,Scott,107,16137,29201
2021-03-23,MO,Scott,53,16190,29201
2021-03-24,MO,Scott,321,16511,29201
2021-03-25,MO,Scott,336,16847,29201
2021-03-26,MO,Scott,162,17009,29201
2021-03-27,MO,Scott,15,17024,29201
2021-03-28,MO,Scott,186,17210,29201
2021-03-29,MO,Scott,95,17305,29201
2021-03-30,MO,Scott,285,17590,29201
2021-03-31,MO,Scott,254,17844,29201
2021-04-01,MO,Scott,77,17921,29201
2021-04-02,MO,Scott,133,18054,29201
2021-04-03,MO,Scott,33,18087,29201
2021-04-04,MO,Scott,11,18098,29201
2021-04-05,MO,Scott,509,18607,29201
2021-04-06,MO,Scott,443,19050,29201
2021-04-07,MO,Scott,221,19271,29201
2021-04-08,MO,Scott,286,19557,29201
2021-04-09,MO,Scott,299,19856,29201
2021-04-10,MO,Scott,20,19876,29201
2021-04-11,MO,Scott,27,19903,29201
2021-04-12,MO,Scott,93,19996,29201
2021-04-13,MO,Scott,69,20065,29201
2021-04-14,MO,Scott,118,20183,29201
2021-04-15,MO,Scott,179,20362,29201
2021-04-16,MO,Scott,217,20579,29201
2021-04-17,MO,Scott,18,20597,29201
2021-04-18,MO,Scott,165,20762,29201
2021-04-19,MO,Scott,83,20845,29201
2021-04-20,MO,Scott,201,21046,29201
2021-04-21,MO,Scott,95,21141,29201
2021-04-22,MO,Scott,82,21223,29201
2021-04-23,MO,Scott,66,21289,29201
2021-04-24,MO,Scott,18,21307,29201
2021-04-25,MO,Scott,3,21310,29201
2020-12-18,MO,Shannon,1,1,29203
2020-12-21,MO,Shannon,1,2,29203
2020-12-22,MO,Shannon,4,6,29203
2020-12-23,MO,Shannon,4,10,29203
2020-12-24,MO,Shannon,1,11,29203
2020-12-26,MO,Shannon,1,12,29203
2020-12-28,MO,Shannon,1,13,29203
2020-12-29,MO,Shannon,5,18,29203
2020-12-30,MO,Shannon,5,23,29203
2021-01-02,MO,Shannon,2,25,29203
2021-01-05,MO,Shannon,10,35,29203
2021-01-06,MO,Shannon,2,37,29203
2021-01-07,MO,Shannon,1,38,29203
2021-01-08,MO,Shannon,5,43,29203
2021-01-09,MO,Shannon,3,46,29203
2021-01-11,MO,Shannon,2,48,29203
2021-01-12,MO,Shannon,4,52,29203
2021-01-13,MO,Shannon,5,57,29203
2021-01-14,MO,Shannon,2,59,29203
2021-01-15,MO,Shannon,1,60,29203
2021-01-18,MO,Shannon,2,62,29203
2021-01-19,MO,Shannon,40,102,29203
2021-01-20,MO,Shannon,5,107,29203
2021-01-21,MO,Shannon,16,123,29203
2021-01-22,MO,Shannon,7,130,29203
2021-01-25,MO,Shannon,3,133,29203
2021-01-26,MO,Shannon,6,139,29203
2021-01-27,MO,Shannon,21,160,29203
2021-01-28,MO,Shannon,33,193,29203
2021-01-29,MO,Shannon,69,262,29203
2021-01-30,MO,Shannon,2,264,29203
2021-02-01,MO,Shannon,2,266,29203
2021-02-02,MO,Shannon,28,294,29203
2021-02-03,MO,Shannon,13,307,29203
2021-02-04,MO,Shannon,15,322,29203
2021-02-05,MO,Shannon,175,497,29203
2021-02-06,MO,Shannon,3,500,29203
2021-02-08,MO,Shannon,11,511,29203
2021-02-09,MO,Shannon,11,522,29203
2021-02-10,MO,Shannon,7,529,29203
2021-02-11,MO,Shannon,21,550,29203
2021-02-12,MO,Shannon,266,816,29203
2021-02-13,MO,Shannon,2,818,29203
2021-02-14,MO,Shannon,2,820,29203
2021-02-15,MO,Shannon,7,827,29203
2021-02-16,MO,Shannon,16,843,29203
2021-02-17,MO,Shannon,1,844,29203
2021-02-18,MO,Shannon,5,849,29203
2021-02-19,MO,Shannon,23,872,29203
2021-02-20,MO,Shannon,6,878,29203
2021-02-21,MO,Shannon,1,879,29203
2021-02-22,MO,Shannon,2,881,29203
2021-02-23,MO,Shannon,23,904,29203
2021-02-24,MO,Shannon,31,935,29203
2021-02-25,MO,Shannon,113,1048,29203
2021-02-26,MO,Shannon,47,1095,29203
2021-02-27,MO,Shannon,7,1102,29203
2021-02-28,MO,Shannon,7,1109,29203
2021-03-01,MO,Shannon,1,1110,29203
2021-03-02,MO,Shannon,29,1139,29203
2021-03-03,MO,Shannon,20,1159,29203
2021-03-04,MO,Shannon,42,1201,29203
2021-03-05,MO,Shannon,18,1219,29203
2021-03-06,MO,Shannon,1,1220,29203
2021-03-08,MO,Shannon,177,1397,29203
2021-03-09,MO,Shannon,22,1419,29203
2021-03-10,MO,Shannon,9,1428,29203
2021-03-11,MO,Shannon,5,1433,29203
2021-03-12,MO,Shannon,259,1692,29203
2021-03-13,MO,Shannon,2,1694,29203
2021-03-15,MO,Shannon,18,1712,29203
2021-03-16,MO,Shannon,19,1731,29203
2021-03-17,MO,Shannon,125,1856,29203
2021-03-18,MO,Shannon,4,1860,29203
2021-03-19,MO,Shannon,5,1865,29203
2021-03-20,MO,Shannon,7,1872,29203
2021-03-21,MO,Shannon,2,1874,29203
2021-03-22,MO,Shannon,3,1877,29203
2021-03-23,MO,Shannon,22,1899,29203
2021-03-24,MO,Shannon,3,1902,29203
2021-03-25,MO,Shannon,132,2034,29203
2021-03-26,MO,Shannon,8,2042,29203
2021-03-27,MO,Shannon,50,2092,29203
2021-03-29,MO,Shannon,1,2093,29203
2021-03-30,MO,Shannon,25,2118,29203
2021-03-31,MO,Shannon,9,2127,29203
2021-04-01,MO,Shannon,58,2185,29203
2021-04-02,MO,Shannon,4,2189,29203
2021-04-05,MO,Shannon,20,2209,29203
2021-04-06,MO,Shannon,29,2238,29203
2021-04-07,MO,Shannon,7,2245,29203
2021-04-08,MO,Shannon,10,2255,29203
2021-04-09,MO,Shannon,30,2285,29203
2021-04-10,MO,Shannon,2,2287,29203
2021-04-12,MO,Shannon,8,2295,29203
2021-04-13,MO,Shannon,10,2305,29203
2021-04-14,MO,Shannon,174,2479,29203
2021-04-15,MO,Shannon,34,2513,29203
2021-04-16,MO,Shannon,7,2520,29203
2021-04-17,MO,Shannon,1,2521,29203
2021-04-19,MO,Shannon,5,2526,29203
2021-04-20,MO,Shannon,7,2533,29203
2021-04-21,MO,Shannon,16,2549,29203
2021-04-22,MO,Shannon,7,2556,29203
2021-04-23,MO,Shannon,2,2558,29203
2021-04-24,MO,Shannon,79,2637,29203
2021-04-25,MO,Shannon,1,2638,29203
2020-12-16,MO,Shelby,1,1,29205
2020-12-17,MO,Shelby,2,3,29205
2020-12-19,MO,Shelby,1,4,29205
2020-12-21,MO,Shelby,2,6,29205
2020-12-22,MO,Shelby,4,10,29205
2020-12-23,MO,Shelby,4,14,29205
2020-12-28,MO,Shelby,17,31,29205
2020-12-29,MO,Shelby,9,40,29205
2020-12-30,MO,Shelby,8,48,29205
2020-12-31,MO,Shelby,1,49,29205
2021-01-04,MO,Shelby,5,54,29205
2021-01-05,MO,Shelby,13,67,29205
2021-01-06,MO,Shelby,88,155,29205
2021-01-07,MO,Shelby,6,161,29205
2021-01-08,MO,Shelby,5,166,29205
2021-01-09,MO,Shelby,4,170,29205
2021-01-11,MO,Shelby,2,172,29205
2021-01-12,MO,Shelby,6,178,29205
2021-01-13,MO,Shelby,11,189,29205
2021-01-14,MO,Shelby,3,192,29205
2021-01-15,MO,Shelby,3,195,29205
2021-01-17,MO,Shelby,1,196,29205
2021-01-18,MO,Shelby,57,253,29205
2021-01-19,MO,Shelby,39,292,29205
2021-01-20,MO,Shelby,123,415,29205
2021-01-21,MO,Shelby,109,524,29205
2021-01-22,MO,Shelby,45,569,29205
2021-01-24,MO,Shelby,1,570,29205
2021-01-25,MO,Shelby,8,578,29205
2021-01-26,MO,Shelby,5,583,29205
2021-01-27,MO,Shelby,2,585,29205
2021-01-28,MO,Shelby,286,871,29205
2021-01-29,MO,Shelby,15,886,29205
2021-01-30,MO,Shelby,30,916,29205
2021-02-01,MO,Shelby,15,931,29205
2021-02-02,MO,Shelby,40,971,29205
2021-02-03,MO,Shelby,236,1207,29205
2021-02-04,MO,Shelby,21,1228,29205
2021-02-05,MO,Shelby,15,1243,29205
2021-02-06,MO,Shelby,5,1248,29205
2021-02-08,MO,Shelby,42,1290,29205
2021-02-09,MO,Shelby,66,1356,29205
2021-02-10,MO,Shelby,11,1367,29205
2021-02-11,MO,Shelby,67,1434,29205
2021-02-12,MO,Shelby,207,1641,29205
2021-02-15,MO,Shelby,17,1658,29205
2021-02-16,MO,Shelby,56,1714,29205
2021-02-17,MO,Shelby,3,1717,29205
2021-02-18,MO,Shelby,53,1770,29205
2021-02-19,MO,Shelby,15,1785,29205
2021-02-21,MO,Shelby,1,1786,29205
2021-02-22,MO,Shelby,13,1799,29205
2021-02-23,MO,Shelby,3,1802,29205
2021-02-24,MO,Shelby,12,1814,29205
2021-02-25,MO,Shelby,323,2137,29205
2021-02-26,MO,Shelby,13,2150,29205
2021-02-27,MO,Shelby,1,2151,29205
2021-03-01,MO,Shelby,13,2164,29205
2021-03-02,MO,Shelby,34,2198,29205
2021-03-03,MO,Shelby,156,2354,29205
2021-03-04,MO,Shelby,45,2399,29205
2021-03-05,MO,Shelby,24,2423,29205
2021-03-06,MO,Shelby,4,2427,29205
2021-03-08,MO,Shelby,47,2474,29205
2021-03-09,MO,Shelby,54,2528,29205
2021-03-10,MO,Shelby,7,2535,29205
2021-03-11,MO,Shelby,164,2699,29205
2021-03-12,MO,Shelby,7,2706,29205
2021-03-13,MO,Shelby,13,2719,29205
2021-03-14,MO,Shelby,1,2720,29205
2021-03-15,MO,Shelby,10,2730,29205
2021-03-16,MO,Shelby,27,2757,29205
2021-03-17,MO,Shelby,13,2770,29205
2021-03-18,MO,Shelby,39,2809,29205
2021-03-19,MO,Shelby,16,2825,29205
2021-03-20,MO,Shelby,17,2842,29205
2021-03-21,MO,Shelby,1,2843,29205
2021-03-22,MO,Shelby,10,2853,29205
2021-03-23,MO,Shelby,6,2859,29205
2021-03-24,MO,Shelby,20,2879,29205
2021-03-25,MO,Shelby,34,2913,29205
2021-03-26,MO,Shelby,20,2933,29205
2021-03-27,MO,Shelby,19,2952,29205
2021-03-29,MO,Shelby,15,2967,29205
2021-03-30,MO,Shelby,17,2984,29205
2021-03-31,MO,Shelby,14,2998,29205
2021-04-01,MO,Shelby,41,3039,29205
2021-04-02,MO,Shelby,22,3061,29205
2021-04-03,MO,Shelby,8,3069,29205
2021-04-04,MO,Shelby,1,3070,29205
2021-04-05,MO,Shelby,49,3119,29205
2021-04-06,MO,Shelby,43,3162,29205
2021-04-07,MO,Shelby,25,3187,29205
2021-04-08,MO,Shelby,85,3272,29205
2021-04-09,MO,Shelby,31,3303,29205
2021-04-10,MO,Shelby,14,3317,29205
2021-04-11,MO,Shelby,1,3318,29205
2021-04-12,MO,Shelby,4,3322,29205
2021-04-13,MO,Shelby,30,3352,29205
2021-04-14,MO,Shelby,62,3414,29205
2021-04-15,MO,Shelby,27,3441,29205
2021-04-16,MO,Shelby,13,3454,29205
2021-04-17,MO,Shelby,14,3468,29205
2021-04-19,MO,Shelby,3,3471,29205
2021-04-20,MO,Shelby,12,3483,29205
2021-04-21,MO,Shelby,12,3495,29205
2021-04-22,MO,Shelby,8,3503,29205
2021-04-23,MO,Shelby,17,3520,29205
2021-04-24,MO,Shelby,1,3521,29205
2020-12-14,MO,St. Charles,13,13,29183
2020-12-15,MO,St. Charles,69,82,29183
2020-12-16,MO,St. Charles,124,206,29183
2020-12-17,MO,St. Charles,524,730,29183
2020-12-18,MO,St. Charles,632,1362,29183
2020-12-19,MO,St. Charles,206,1568,29183
2020-12-20,MO,St. Charles,72,1640,29183
2020-12-21,MO,St. Charles,419,2059,29183
2020-12-22,MO,St. Charles,727,2786,29183
2020-12-23,MO,St. Charles,506,3292,29183
2020-12-24,MO,St. Charles,100,3392,29183
2020-12-26,MO,St. Charles,199,3591,29183
2020-12-27,MO,St. Charles,105,3696,29183
2020-12-28,MO,St. Charles,600,4296,29183
2020-12-29,MO,St. Charles,647,4943,29183
2020-12-30,MO,St. Charles,619,5562,29183
2020-12-31,MO,St. Charles,308,5870,29183
2021-01-01,MO,St. Charles,30,5900,29183
2021-01-02,MO,St. Charles,98,5998,29183
2021-01-03,MO,St. Charles,80,6078,29183
2021-01-04,MO,St. Charles,429,6507,29183
2021-01-05,MO,St. Charles,490,6997,29183
2021-01-06,MO,St. Charles,798,7795,29183
2021-01-07,MO,St. Charles,661,8456,29183
2021-01-08,MO,St. Charles,911,9367,29183
2021-01-09,MO,St. Charles,316,9683,29183
2021-01-10,MO,St. Charles,173,9856,29183
2021-01-11,MO,St. Charles,855,10711,29183
2021-01-12,MO,St. Charles,917,11628,29183
2021-01-13,MO,St. Charles,619,12247,29183
2021-01-14,MO,St. Charles,565,12812,29183
2021-01-15,MO,St. Charles,851,13663,29183
2021-01-16,MO,St. Charles,338,14001,29183
2021-01-17,MO,St. Charles,57,14058,29183
2021-01-18,MO,St. Charles,845,14903,29183
2021-01-19,MO,St. Charles,1211,16114,29183
2021-01-20,MO,St. Charles,1905,18019,29183
2021-01-21,MO,St. Charles,1080,19099,29183
2021-01-22,MO,St. Charles,1058,20157,29183
2021-01-23,MO,St. Charles,578,20735,29183
2021-01-24,MO,St. Charles,225,20960,29183
2021-01-25,MO,St. Charles,1375,22335,29183
2021-01-26,MO,St. Charles,1241,23576,29183
2021-01-27,MO,St. Charles,1549,25125,29183
2021-01-28,MO,St. Charles,1469,26594,29183
2021-01-29,MO,St. Charles,1658,28252,29183
2021-01-30,MO,St. Charles,842,29094,29183
2021-01-31,MO,St. Charles,155,29249,29183
2021-02-01,MO,St. Charles,1092,30341,29183
2021-02-02,MO,St. Charles,1262,31603,29183
2021-02-03,MO,St. Charles,2035,33638,29183
2021-02-04,MO,St. Charles,1374,35012,29183
2021-02-05,MO,St. Charles,1794,36806,29183
2021-02-06,MO,St. Charles,769,37575,29183
2021-02-07,MO,St. Charles,63,37638,29183
2021-02-08,MO,St. Charles,1341,38979,29183
2021-02-09,MO,St. Charles,1904,40883,29183
2021-02-10,MO,St. Charles,1879,42762,29183
2021-02-11,MO,St. Charles,1404,44166,29183
2021-02-12,MO,St. Charles,1864,46030,29183
2021-02-13,MO,St. Charles,1042,47072,29183
2021-02-14,MO,St. Charles,87,47159,29183
2021-02-15,MO,St. Charles,437,47596,29183
2021-02-16,MO,St. Charles,1561,49157,29183
2021-02-17,MO,St. Charles,1693,50850,29183
2021-02-18,MO,St. Charles,2414,53264,29183
2021-02-19,MO,St. Charles,2311,55575,29183
2021-02-20,MO,St. Charles,1686,57261,29183
2021-02-21,MO,St. Charles,287,57548,29183
2021-02-22,MO,St. Charles,1957,59505,29183
2021-02-23,MO,St. Charles,2023,61528,29183
2021-02-24,MO,St. Charles,3579,65107,29183
2021-02-25,MO,St. Charles,3210,68317,29183
2021-02-26,MO,St. Charles,1946,70263,29183
2021-02-27,MO,St. Charles,2142,72405,29183
2021-02-28,MO,St. Charles,878,73283,29183
2021-03-01,MO,St. Charles,2081,75364,29183
2021-03-02,MO,St. Charles,3384,78748,29183
2021-03-03,MO,St. Charles,2572,81320,29183
2021-03-04,MO,St. Charles,2820,84140,29183
2021-03-05,MO,St. Charles,2354,86494,29183
2021-03-06,MO,St. Charles,1534,88028,29183
2021-03-07,MO,St. Charles,1038,89066,29183
2021-03-08,MO,St. Charles,2421,91487,29183
2021-03-09,MO,St. Charles,3004,94491,29183
2021-03-10,MO,St. Charles,3095,97586,29183
2021-03-11,MO,St. Charles,2746,100332,29183
2021-03-12,MO,St. Charles,2289,102621,29183
2021-03-13,MO,St. Charles,1889,104510,29183
2021-03-14,MO,St. Charles,369,104879,29183
2021-03-15,MO,St. Charles,2229,107108,29183
2021-03-16,MO,St. Charles,3596,110704,29183
2021-03-17,MO,St. Charles,2697,113401,29183
2021-03-18,MO,St. Charles,6274,119675,29183
2021-03-19,MO,St. Charles,2563,122238,29183
2021-03-20,MO,St. Charles,3387,125625,29183
2021-03-21,MO,St. Charles,1539,127164,29183
2021-03-22,MO,St. Charles,2849,130013,29183
2021-03-23,MO,St. Charles,4340,134353,29183
2021-03-24,MO,St. Charles,4014,138367,29183
2021-03-25,MO,St. Charles,5752,144119,29183
2021-03-26,MO,St. Charles,5660,149779,29183
2021-03-27,MO,St. Charles,4111,153890,29183
2021-03-28,MO,St. Charles,1279,155169,29183
2021-03-29,MO,St. Charles,2426,157595,29183
2021-03-30,MO,St. Charles,5380,162975,29183
2021-03-31,MO,St. Charles,5951,168926,29183
2021-04-01,MO,St. Charles,5237,174163,29183
2021-04-02,MO,St. Charles,3419,177582,29183
2021-04-03,MO,St. Charles,2091,179673,29183
2021-04-04,MO,St. Charles,380,180053,29183
2021-04-05,MO,St. Charles,2899,182952,29183
2021-04-06,MO,St. Charles,3717,186669,29183
2021-04-07,MO,St. Charles,4122,190791,29183
2021-04-08,MO,St. Charles,7662,198453,29183
2021-04-09,MO,St. Charles,4951,203404,29183
2021-04-10,MO,St. Charles,3785,207189,29183
2021-04-11,MO,St. Charles,1284,208473,29183
2021-04-12,MO,St. Charles,3340,211813,29183
2021-04-13,MO,St. Charles,3325,215138,29183
2021-04-14,MO,St. Charles,3434,218572,29183
2021-04-15,MO,St. Charles,6792,225364,29183
2021-04-16,MO,St. Charles,6161,231525,29183
2021-04-17,MO,St. Charles,4572,236097,29183
2021-04-18,MO,St. Charles,1096,237193,29183
2021-04-19,MO,St. Charles,2999,240192,29183
2021-04-20,MO,St. Charles,4481,244673,29183
2021-04-21,MO,St. Charles,3229,247902,29183
2021-04-22,MO,St. Charles,2606,250508,29183
2021-04-23,MO,St. Charles,2393,252901,29183
2021-04-24,MO,St. Charles,1945,254846,29183
2021-04-25,MO,St. Charles,376,255222,29183
2020-12-17,MO,St. Clair,1,1,29185
2020-12-18,MO,St. Clair,4,5,29185
2020-12-19,MO,St. Clair,3,8,29185
2020-12-21,MO,St. Clair,10,18,29185
2020-12-22,MO,St. Clair,7,25,29185
2020-12-23,MO,St. Clair,3,28,29185
2020-12-28,MO,St. Clair,7,35,29185
2020-12-29,MO,St. Clair,7,42,29185
2020-12-30,MO,St. Clair,13,55,29185
2020-12-31,MO,St. Clair,10,65,29185
2021-01-04,MO,St. Clair,32,97,29185
2021-01-05,MO,St. Clair,10,107,29185
2021-01-06,MO,St. Clair,13,120,29185
2021-01-07,MO,St. Clair,4,124,29185
2021-01-08,MO,St. Clair,12,136,29185
2021-01-09,MO,St. Clair,1,137,29185
2021-01-10,MO,St. Clair,1,138,29185
2021-01-11,MO,St. Clair,10,148,29185
2021-01-12,MO,St. Clair,11,159,29185
2021-01-13,MO,St. Clair,8,167,29185
2021-01-14,MO,St. Clair,8,175,29185
2021-01-15,MO,St. Clair,5,180,29185
2021-01-16,MO,St. Clair,2,182,29185
2021-01-19,MO,St. Clair,38,220,29185
2021-01-20,MO,St. Clair,10,230,29185
2021-01-21,MO,St. Clair,32,262,29185
2021-01-22,MO,St. Clair,18,280,29185
2021-01-23,MO,St. Clair,51,331,29185
2021-01-24,MO,St. Clair,1,332,29185
2021-01-25,MO,St. Clair,19,351,29185
2021-01-26,MO,St. Clair,31,382,29185
2021-01-27,MO,St. Clair,44,426,29185
2021-01-28,MO,St. Clair,136,562,29185
2021-01-29,MO,St. Clair,31,593,29185
2021-01-30,MO,St. Clair,1,594,29185
2021-01-31,MO,St. Clair,1,595,29185
2021-02-01,MO,St. Clair,30,625,29185
2021-02-02,MO,St. Clair,23,648,29185
2021-02-03,MO,St. Clair,21,669,29185
2021-02-04,MO,St. Clair,16,685,29185
2021-02-05,MO,St. Clair,48,733,29185
2021-02-06,MO,St. Clair,3,736,29185
2021-02-07,MO,St. Clair,1,737,29185
2021-02-08,MO,St. Clair,44,781,29185
2021-02-09,MO,St. Clair,43,824,29185
2021-02-10,MO,St. Clair,32,856,29185
2021-02-11,MO,St. Clair,77,933,29185
2021-02-12,MO,St. Clair,19,952,29185
2021-02-13,MO,St. Clair,91,1043,29185
2021-02-14,MO,St. Clair,45,1088,29185
2021-02-15,MO,St. Clair,4,1092,29185
2021-02-16,MO,St. Clair,28,1120,29185
2021-02-17,MO,St. Clair,26,1146,29185
2021-02-18,MO,St. Clair,44,1190,29185
2021-02-19,MO,St. Clair,7,1197,29185
2021-02-20,MO,St. Clair,4,1201,29185
2021-02-21,MO,St. Clair,2,1203,29185
2021-02-22,MO,St. Clair,11,1214,29185
2021-02-23,MO,St. Clair,20,1234,29185
2021-02-24,MO,St. Clair,81,1315,29185
2021-02-25,MO,St. Clair,212,1527,29185
2021-02-26,MO,St. Clair,83,1610,29185
2021-02-27,MO,St. Clair,38,1648,29185
2021-02-28,MO,St. Clair,27,1675,29185
2021-03-01,MO,St. Clair,58,1733,29185
2021-03-02,MO,St. Clair,63,1796,29185
2021-03-03,MO,St. Clair,33,1829,29185
2021-03-04,MO,St. Clair,28,1857,29185
2021-03-05,MO,St. Clair,98,1955,29185
2021-03-06,MO,St. Clair,10,1965,29185
2021-03-07,MO,St. Clair,1,1966,29185
2021-03-08,MO,St. Clair,13,1979,29185
2021-03-09,MO,St. Clair,59,2038,29185
2021-03-10,MO,St. Clair,35,2073,29185
2021-03-11,MO,St. Clair,132,2205,29185
2021-03-12,MO,St. Clair,33,2238,29185
2021-03-13,MO,St. Clair,71,2309,29185
2021-03-14,MO,St. Clair,45,2354,29185
2021-03-15,MO,St. Clair,24,2378,29185
2021-03-16,MO,St. Clair,23,2401,29185
2021-03-17,MO,St. Clair,29,2430,29185
2021-03-18,MO,St. Clair,46,2476,29185
2021-03-19,MO,St. Clair,34,2510,29185
2021-03-20,MO,St. Clair,5,2515,29185
2021-03-21,MO,St. Clair,2,2517,29185
2021-03-22,MO,St. Clair,16,2533,29185
2021-03-23,MO,St. Clair,14,2547,29185
2021-03-24,MO,St. Clair,76,2623,29185
2021-03-25,MO,St. Clair,95,2718,29185
2021-03-26,MO,St. Clair,115,2833,29185
2021-03-27,MO,St. Clair,42,2875,29185
2021-03-28,MO,St. Clair,27,2902,29185
2021-03-29,MO,St. Clair,37,2939,29185
2021-03-30,MO,St. Clair,80,3019,29185
2021-03-31,MO,St. Clair,25,3044,29185
2021-04-01,MO,St. Clair,39,3083,29185
2021-04-02,MO,St. Clair,51,3134,29185
2021-04-03,MO,St. Clair,11,3145,29185
2021-04-05,MO,St. Clair,18,3163,29185
2021-04-06,MO,St. Clair,40,3203,29185
2021-04-07,MO,St. Clair,19,3222,29185
2021-04-08,MO,St. Clair,77,3299,29185
2021-04-09,MO,St. Clair,28,3327,29185
2021-04-10,MO,St. Clair,34,3361,29185
2021-04-11,MO,St. Clair,2,3363,29185
2021-04-12,MO,St. Clair,23,3386,29185
2021-04-13,MO,St. Clair,23,3409,29185
2021-04-14,MO,St. Clair,20,3429,29185
2021-04-15,MO,St. Clair,41,3470,29185
2021-04-16,MO,St. Clair,38,3508,29185
2021-04-17,MO,St. Clair,7,3515,29185
2021-04-18,MO,St. Clair,1,3516,29185
2021-04-19,MO,St. Clair,13,3529,29185
2021-04-20,MO,St. Clair,17,3546,29185
2021-04-21,MO,St. Clair,13,3559,29185
2021-04-22,MO,St. Clair,14,3573,29185
2021-04-23,MO,St. Clair,10,3583,29185
2021-04-24,MO,St. Clair,4,3587,29185
2021-04-25,MO,St. Clair,3,3590,29185
2020-12-14,MO,St. Francois,3,3,29187
2020-12-16,MO,St. Francois,10,13,29187
2020-12-17,MO,St. Francois,74,87,29187
2020-12-18,MO,St. Francois,67,154,29187
2020-12-19,MO,St. Francois,17,171,29187
2020-12-20,MO,St. Francois,5,176,29187
2020-12-21,MO,St. Francois,61,237,29187
2020-12-22,MO,St. Francois,72,309,29187
2020-12-23,MO,St. Francois,143,452,29187
2020-12-24,MO,St. Francois,2,454,29187
2020-12-26,MO,St. Francois,1,455,29187
2020-12-27,MO,St. Francois,3,458,29187
2020-12-28,MO,St. Francois,34,492,29187
2020-12-29,MO,St. Francois,290,782,29187
2020-12-30,MO,St. Francois,233,1015,29187
2020-12-31,MO,St. Francois,90,1105,29187
2021-01-01,MO,St. Francois,1,1106,29187
2021-01-02,MO,St. Francois,40,1146,29187
2021-01-03,MO,St. Francois,6,1152,29187
2021-01-04,MO,St. Francois,72,1224,29187
2021-01-05,MO,St. Francois,108,1332,29187
2021-01-06,MO,St. Francois,62,1394,29187
2021-01-07,MO,St. Francois,96,1490,29187
2021-01-08,MO,St. Francois,132,1622,29187
2021-01-09,MO,St. Francois,154,1776,29187
2021-01-10,MO,St. Francois,4,1780,29187
2021-01-11,MO,St. Francois,92,1872,29187
2021-01-12,MO,St. Francois,89,1961,29187
2021-01-13,MO,St. Francois,156,2117,29187
2021-01-14,MO,St. Francois,118,2235,29187
2021-01-15,MO,St. Francois,110,2345,29187
2021-01-16,MO,St. Francois,5,2350,29187
2021-01-17,MO,St. Francois,30,2380,29187
2021-01-18,MO,St. Francois,56,2436,29187
2021-01-19,MO,St. Francois,394,2830,29187
2021-01-20,MO,St. Francois,254,3084,29187
2021-01-21,MO,St. Francois,159,3243,29187
2021-01-22,MO,St. Francois,252,3495,29187
2021-01-23,MO,St. Francois,61,3556,29187
2021-01-24,MO,St. Francois,13,3569,29187
2021-01-25,MO,St. Francois,206,3775,29187
2021-01-26,MO,St. Francois,138,3913,29187
2021-01-27,MO,St. Francois,172,4085,29187
2021-01-28,MO,St. Francois,539,4624,29187
2021-01-29,MO,St. Francois,454,5078,29187
2021-01-30,MO,St. Francois,120,5198,29187
2021-02-01,MO,St. Francois,282,5480,29187
2021-02-02,MO,St. Francois,231,5711,29187
2021-02-03,MO,St. Francois,218,5929,29187
2021-02-04,MO,St. Francois,1651,7580,29187
2021-02-05,MO,St. Francois,265,7845,29187
2021-02-06,MO,St. Francois,236,8081,29187
2021-02-07,MO,St. Francois,9,8090,29187
2021-02-08,MO,St. Francois,246,8336,29187
2021-02-09,MO,St. Francois,170,8506,29187
2021-02-10,MO,St. Francois,136,8642,29187
2021-02-11,MO,St. Francois,251,8893,29187
2021-02-12,MO,St. Francois,321,9214,29187
2021-02-13,MO,St. Francois,86,9300,29187
2021-02-14,MO,St. Francois,48,9348,29187
2021-02-15,MO,St. Francois,66,9414,29187
2021-02-16,MO,St. Francois,91,9505,29187
2021-02-17,MO,St. Francois,107,9612,29187
2021-02-18,MO,St. Francois,242,9854,29187
2021-02-19,MO,St. Francois,374,10228,29187
2021-02-20,MO,St. Francois,95,10323,29187
2021-02-21,MO,St. Francois,5,10328,29187
2021-02-22,MO,St. Francois,265,10593,29187
2021-02-23,MO,St. Francois,208,10801,29187
2021-02-24,MO,St. Francois,374,11175,29187
2021-02-25,MO,St. Francois,493,11668,29187
2021-02-26,MO,St. Francois,2068,13736,29187
2021-02-27,MO,St. Francois,126,13862,29187
2021-02-28,MO,St. Francois,62,13924,29187
2021-03-01,MO,St. Francois,492,14416,29187
2021-03-02,MO,St. Francois,395,14811,29187
2021-03-03,MO,St. Francois,340,15151,29187
2021-03-04,MO,St. Francois,500,15651,29187
2021-03-05,MO,St. Francois,440,16091,29187
2021-03-06,MO,St. Francois,89,16180,29187
2021-03-07,MO,St. Francois,11,16191,29187
2021-03-08,MO,St. Francois,241,16432,29187
2021-03-09,MO,St. Francois,219,16651,29187
2021-03-10,MO,St. Francois,342,16993,29187
2021-03-11,MO,St. Francois,271,17264,29187
2021-03-12,MO,St. Francois,415,17679,29187
2021-03-13,MO,St. Francois,105,17784,29187
2021-03-14,MO,St. Francois,17,17801,29187
2021-03-15,MO,St. Francois,247,18048,29187
2021-03-16,MO,St. Francois,459,18507,29187
2021-03-17,MO,St. Francois,375,18882,29187
2021-03-18,MO,St. Francois,596,19478,29187
2021-03-19,MO,St. Francois,268,19746,29187
2021-03-20,MO,St. Francois,114,19860,29187
2021-03-21,MO,St. Francois,19,19879,29187
2021-03-22,MO,St. Francois,294,20173,29187
2021-03-23,MO,St. Francois,247,20420,29187
2021-03-24,MO,St. Francois,289,20709,29187
2021-03-25,MO,St. Francois,307,21016,29187
2021-03-26,MO,St. Francois,390,21406,29187
2021-03-27,MO,St. Francois,299,21705,29187
2021-03-28,MO,St. Francois,15,21720,29187
2021-03-29,MO,St. Francois,577,22297,29187
2021-03-30,MO,St. Francois,559,22856,29187
2021-03-31,MO,St. Francois,523,23379,29187
2021-04-01,MO,St. Francois,284,23663,29187
2021-04-02,MO,St. Francois,221,23884,29187
2021-04-03,MO,St. Francois,55,23939,29187
2021-04-04,MO,St. Francois,15,23954,29187
2021-04-05,MO,St. Francois,227,24181,29187
2021-04-06,MO,St. Francois,402,24583,29187
2021-04-07,MO,St. Francois,732,25315,29187
2021-04-08,MO,St. Francois,517,25832,29187
2021-04-09,MO,St. Francois,473,26305,29187
2021-04-10,MO,St. Francois,357,26662,29187
2021-04-11,MO,St. Francois,37,26699,29187
2021-04-12,MO,St. Francois,287,26986,29187
2021-04-13,MO,St. Francois,282,27268,29187
2021-04-14,MO,St. Francois,305,27573,29187
2021-04-15,MO,St. Francois,235,27808,29187
2021-04-16,MO,St. Francois,346,28154,29187
2021-04-17,MO,St. Francois,292,28446,29187
2021-04-18,MO,St. Francois,41,28487,29187
2021-04-19,MO,St. Francois,676,29163,29187
2021-04-20,MO,St. Francois,156,29319,29187
2021-04-21,MO,St. Francois,308,29627,29187
2021-04-22,MO,St. Francois,260,29887,29187
2021-04-23,MO,St. Francois,145,30032,29187
2021-04-24,MO,St. Francois,62,30094,29187
2021-04-25,MO,St. Francois,12,30106,29187
2020-12-14,MO,St. Louis,90,90,29189
2020-12-15,MO,St. Louis,330,420,29189
2020-12-16,MO,St. Louis,544,964,29189
2020-12-17,MO,St. Louis,1675,2639,29189
2020-12-18,MO,St. Louis,1572,4211,29189
2020-12-19,MO,St. Louis,574,4785,29189
2020-12-20,MO,St. Louis,165,4950,29189
2020-12-21,MO,St. Louis,1070,6020,29189
2020-12-22,MO,St. Louis,1683,7703,29189
2020-12-23,MO,St. Louis,1554,9257,29189
2020-12-24,MO,St. Louis,325,9582,29189
2020-12-26,MO,St. Louis,624,10206,29189
2020-12-27,MO,St. Louis,355,10561,29189
2020-12-28,MO,St. Louis,1552,12113,29189
2020-12-29,MO,St. Louis,2116,14229,29189
2020-12-30,MO,St. Louis,2055,16284,29189
2020-12-31,MO,St. Louis,707,16991,29189
2021-01-01,MO,St. Louis,96,17087,29189
2021-01-02,MO,St. Louis,241,17328,29189
2021-01-03,MO,St. Louis,68,17396,29189
2021-01-04,MO,St. Louis,1405,18801,29189
2021-01-05,MO,St. Louis,2028,20829,29189
2021-01-06,MO,St. Louis,2340,23169,29189
2021-01-07,MO,St. Louis,2297,25466,29189
2021-01-08,MO,St. Louis,2510,27976,29189
2021-01-09,MO,St. Louis,920,28896,29189
2021-01-10,MO,St. Louis,460,29356,29189
2021-01-11,MO,St. Louis,2560,31916,29189
2021-01-12,MO,St. Louis,2348,34264,29189
2021-01-13,MO,St. Louis,2575,36839,29189
2021-01-14,MO,St. Louis,2623,39462,29189
2021-01-15,MO,St. Louis,2506,41968,29189
2021-01-16,MO,St. Louis,829,42797,29189
2021-01-17,MO,St. Louis,185,42982,29189
2021-01-18,MO,St. Louis,2861,45843,29189
2021-01-19,MO,St. Louis,3246,49089,29189
2021-01-20,MO,St. Louis,3362,52451,29189
2021-01-21,MO,St. Louis,4294,56745,29189
2021-01-22,MO,St. Louis,3470,60215,29189
2021-01-23,MO,St. Louis,1974,62189,29189
2021-01-24,MO,St. Louis,1090,63279,29189
2021-01-25,MO,St. Louis,3590,66869,29189
2021-01-26,MO,St. Louis,4814,71683,29189
2021-01-27,MO,St. Louis,4544,76227,29189
2021-01-28,MO,St. Louis,4264,80491,29189
2021-01-29,MO,St. Louis,5564,86055,29189
2021-01-30,MO,St. Louis,1597,87652,29189
2021-01-31,MO,St. Louis,271,87923,29189
2021-02-01,MO,St. Louis,3805,91728,29189
2021-02-02,MO,St. Louis,4427,96155,29189
2021-02-03,MO,St. Louis,4782,100937,29189
2021-02-04,MO,St. Louis,4354,105291,29189
2021-02-05,MO,St. Louis,5474,110765,29189
2021-02-06,MO,St. Louis,1475,112240,29189
2021-02-07,MO,St. Louis,424,112664,29189
2021-02-08,MO,St. Louis,3990,116654,29189
2021-02-09,MO,St. Louis,4097,120751,29189
2021-02-10,MO,St. Louis,4338,125089,29189
2021-02-11,MO,St. Louis,5795,130884,29189
2021-02-12,MO,St. Louis,5570,136454,29189
2021-02-13,MO,St. Louis,3285,139739,29189
2021-02-14,MO,St. Louis,562,140301,29189
2021-02-15,MO,St. Louis,2411,142712,29189
2021-02-16,MO,St. Louis,4908,147620,29189
2021-02-17,MO,St. Louis,5456,153076,29189
2021-02-18,MO,St. Louis,7054,160130,29189
2021-02-19,MO,St. Louis,6690,166820,29189
2021-02-20,MO,St. Louis,4687,171507,29189
2021-02-21,MO,St. Louis,421,171928,29189
2021-02-22,MO,St. Louis,5838,177766,29189
2021-02-23,MO,St. Louis,6319,184085,29189
2021-02-24,MO,St. Louis,6664,190749,29189
2021-02-25,MO,St. Louis,6744,197493,29189
2021-02-26,MO,St. Louis,7223,204716,29189
2021-02-27,MO,St. Louis,5167,209883,29189
2021-02-28,MO,St. Louis,1588,211471,29189
2021-03-01,MO,St. Louis,6954,218425,29189
2021-03-02,MO,St. Louis,7300,225725,29189
2021-03-03,MO,St. Louis,6197,231922,29189
2021-03-04,MO,St. Louis,6767,238689,29189
2021-03-05,MO,St. Louis,7676,246365,29189
2021-03-06,MO,St. Louis,5555,251920,29189
2021-03-07,MO,St. Louis,2221,254141,29189
2021-03-08,MO,St. Louis,6200,260341,29189
2021-03-09,MO,St. Louis,6738,267079,29189
2021-03-10,MO,St. Louis,8051,275130,29189
2021-03-11,MO,St. Louis,7682,282812,29189
2021-03-12,MO,St. Louis,7498,290310,29189
2021-03-13,MO,St. Louis,6388,296698,29189
2021-03-14,MO,St. Louis,1110,297808,29189
2021-03-15,MO,St. Louis,6722,304530,29189
2021-03-16,MO,St. Louis,8836,313366,29189
2021-03-17,MO,St. Louis,8224,321590,29189
2021-03-18,MO,St. Louis,9448,331038,29189
2021-03-19,MO,St. Louis,9435,340473,29189
2021-03-20,MO,St. Louis,6639,347112,29189
2021-03-21,MO,St. Louis,2928,350040,29189
2021-03-22,MO,St. Louis,7758,357798,29189
2021-03-23,MO,St. Louis,9575,367373,29189
2021-03-24,MO,St. Louis,9162,376535,29189
2021-03-25,MO,St. Louis,11158,387693,29189
2021-03-26,MO,St. Louis,10287,397980,29189
2021-03-27,MO,St. Louis,8521,406501,29189
2021-03-28,MO,St. Louis,3332,409833,29189
2021-03-29,MO,St. Louis,7970,417803,29189
2021-03-30,MO,St. Louis,9963,427766,29189
2021-03-31,MO,St. Louis,9964,437730,29189
2021-04-01,MO,St. Louis,11080,448810,29189
2021-04-02,MO,St. Louis,10387,459197,29189
2021-04-03,MO,St. Louis,8077,467274,29189
2021-04-04,MO,St. Louis,880,468154,29189
2021-04-05,MO,St. Louis,9700,477854,29189
2021-04-06,MO,St. Louis,11923,489777,29189
2021-04-07,MO,St. Louis,12467,502244,29189
2021-04-08,MO,St. Louis,12244,514488,29189
2021-04-09,MO,St. Louis,11162,525650,29189
2021-04-10,MO,St. Louis,8269,533919,29189
2021-04-11,MO,St. Louis,2800,536719,29189
2021-04-12,MO,St. Louis,8612,545331,29189
2021-04-13,MO,St. Louis,8415,553746,29189
2021-04-14,MO,St. Louis,9613,563359,29189
2021-04-15,MO,St. Louis,9815,573174,29189
2021-04-16,MO,St. Louis,9396,582570,29189
2021-04-17,MO,St. Louis,7148,589718,29189
2021-04-18,MO,St. Louis,2494,592212,29189
2021-04-19,MO,St. Louis,6799,599011,29189
2021-04-20,MO,St. Louis,7485,606496,29189
2021-04-21,MO,St. Louis,6831,613327,29189
2021-04-22,MO,St. Louis,6896,620223,29189
2021-04-23,MO,St. Louis,6027,626250,29189
2021-04-24,MO,St. Louis,5203,631453,29189
2021-04-25,MO,St. Louis,591,632044,29189
2020-12-14,MO,St. Louis City,27,27,29510
2020-12-15,MO,St. Louis City,76,103,29510
2020-12-16,MO,St. Louis City,122,225,29510
2020-12-17,MO,St. Louis City,521,746,29510
2020-12-18,MO,St. Louis City,396,1142,29510
2020-12-19,MO,St. Louis City,120,1262,29510
2020-12-20,MO,St. Louis City,41,1303,29510
2020-12-21,MO,St. Louis City,320,1623,29510
2020-12-22,MO,St. Louis City,515,2138,29510
2020-12-23,MO,St. Louis City,490,2628,29510
2020-12-24,MO,St. Louis City,98,2726,29510
2020-12-26,MO,St. Louis City,430,3156,29510
2020-12-27,MO,St. Louis City,370,3526,29510
2020-12-28,MO,St. Louis City,471,3997,29510
2020-12-29,MO,St. Louis City,673,4670,29510
2020-12-30,MO,St. Louis City,660,5330,29510
2020-12-31,MO,St. Louis City,151,5481,29510
2021-01-01,MO,St. Louis City,21,5502,29510
2021-01-02,MO,St. Louis City,72,5574,29510
2021-01-03,MO,St. Louis City,48,5622,29510
2021-01-04,MO,St. Louis City,578,6200,29510
2021-01-05,MO,St. Louis City,612,6812,29510
2021-01-06,MO,St. Louis City,597,7409,29510
2021-01-07,MO,St. Louis City,596,8005,29510
2021-01-08,MO,St. Louis City,762,8767,29510
2021-01-09,MO,St. Louis City,404,9171,29510
2021-01-10,MO,St. Louis City,102,9273,29510
2021-01-11,MO,St. Louis City,773,10046,29510
2021-01-12,MO,St. Louis City,679,10725,29510
2021-01-13,MO,St. Louis City,825,11550,29510
2021-01-14,MO,St. Louis City,976,12526,29510
2021-01-15,MO,St. Louis City,804,13330,29510
2021-01-16,MO,St. Louis City,359,13689,29510
2021-01-17,MO,St. Louis City,30,13719,29510
2021-01-18,MO,St. Louis City,774,14493,29510
2021-01-19,MO,St. Louis City,962,15455,29510
2021-01-20,MO,St. Louis City,900,16355,29510
2021-01-21,MO,St. Louis City,703,17058,29510
2021-01-22,MO,St. Louis City,804,17862,29510
2021-01-23,MO,St. Louis City,478,18340,29510
2021-01-24,MO,St. Louis City,214,18554,29510
2021-01-25,MO,St. Louis City,972,19526,29510
2021-01-26,MO,St. Louis City,1084,20610,29510
2021-01-27,MO,St. Louis City,963,21573,29510
2021-01-28,MO,St. Louis City,873,22446,29510
2021-01-29,MO,St. Louis City,1182,23628,29510
2021-01-30,MO,St. Louis City,325,23953,29510
2021-01-31,MO,St. Louis City,66,24019,29510
2021-02-01,MO,St. Louis City,929,24948,29510
2021-02-02,MO,St. Louis City,877,25825,29510
2021-02-03,MO,St. Louis City,820,26645,29510
2021-02-04,MO,St. Louis City,791,27436,29510
2021-02-05,MO,St. Louis City,1030,28466,29510
2021-02-06,MO,St. Louis City,251,28717,29510
2021-02-07,MO,St. Louis City,27,28744,29510
2021-02-08,MO,St. Louis City,746,29490,29510
2021-02-09,MO,St. Louis City,763,30253,29510
2021-02-10,MO,St. Louis City,807,31060,29510
2021-02-11,MO,St. Louis City,1191,32251,29510
2021-02-12,MO,St. Louis City,1074,33325,29510
2021-02-13,MO,St. Louis City,413,33738,29510
2021-02-14,MO,St. Louis City,69,33807,29510
2021-02-15,MO,St. Louis City,353,34160,29510
2021-02-16,MO,St. Louis City,695,34855,29510
2021-02-17,MO,St. Louis City,1009,35864,29510
2021-02-18,MO,St. Louis City,1054,36918,29510
2021-02-19,MO,St. Louis City,1462,38380,29510
2021-02-20,MO,St. Louis City,900,39280,29510
2021-02-21,MO,St. Louis City,89,39369,29510
2021-02-22,MO,St. Louis City,1104,40473,29510
2021-02-23,MO,St. Louis City,1191,41664,29510
2021-02-24,MO,St. Louis City,1284,42948,29510
2021-02-25,MO,St. Louis City,1130,44078,29510
2021-02-26,MO,St. Louis City,1269,45347,29510
2021-02-27,MO,St. Louis City,630,45977,29510
2021-02-28,MO,St. Louis City,162,46139,29510
2021-03-01,MO,St. Louis City,1307,47446,29510
2021-03-02,MO,St. Louis City,1312,48758,29510
2021-03-03,MO,St. Louis City,1141,49899,29510
2021-03-04,MO,St. Louis City,1097,50996,29510
2021-03-05,MO,St. Louis City,1409,52405,29510
2021-03-06,MO,St. Louis City,830,53235,29510
2021-03-07,MO,St. Louis City,245,53480,29510
2021-03-08,MO,St. Louis City,1011,54491,29510
2021-03-09,MO,St. Louis City,1198,55689,29510
2021-03-10,MO,St. Louis City,1472,57161,29510
2021-03-11,MO,St. Louis City,1413,58574,29510
2021-03-12,MO,St. Louis City,1261,59835,29510
2021-03-13,MO,St. Louis City,887,60722,29510
2021-03-14,MO,St. Louis City,236,60958,29510
2021-03-15,MO,St. Louis City,1387,62345,29510
2021-03-16,MO,St. Louis City,1647,63992,29510
2021-03-17,MO,St. Louis City,1613,65605,29510
2021-03-18,MO,St. Louis City,1677,67282,29510
2021-03-19,MO,St. Louis City,1874,69156,29510
2021-03-20,MO,St. Louis City,1192,70348,29510
2021-03-21,MO,St. Louis City,846,71194,29510
2021-03-22,MO,St. Louis City,1708,72902,29510
2021-03-23,MO,St. Louis City,1909,74811,29510
2021-03-24,MO,St. Louis City,1804,76615,29510
2021-03-25,MO,St. Louis City,4141,80756,29510
2021-03-26,MO,St. Louis City,4109,84865,29510
2021-03-27,MO,St. Louis City,1235,86100,29510
2021-03-28,MO,St. Louis City,523,86623,29510
2021-03-29,MO,St. Louis City,1591,88214,29510
2021-03-30,MO,St. Louis City,1862,90076,29510
2021-03-31,MO,St. Louis City,2150,92226,29510
2021-04-01,MO,St. Louis City,1894,94120,29510
2021-04-02,MO,St. Louis City,1827,95947,29510
2021-04-03,MO,St. Louis City,2555,98502,29510
2021-04-04,MO,St. Louis City,195,98697,29510
2021-04-05,MO,St. Louis City,1915,100612,29510
2021-04-06,MO,St. Louis City,2392,103004,29510
2021-04-07,MO,St. Louis City,2613,105617,29510
2021-04-08,MO,St. Louis City,2397,108014,29510
2021-04-09,MO,St. Louis City,2434,110448,29510
2021-04-10,MO,St. Louis City,2142,112590,29510
2021-04-11,MO,St. Louis City,569,113159,29510
2021-04-12,MO,St. Louis City,2050,115209,29510
2021-04-13,MO,St. Louis City,1992,117201,29510
2021-04-14,MO,St. Louis City,2358,119559,29510
2021-04-15,MO,St. Louis City,2027,121586,29510
2021-04-16,MO,St. Louis City,2055,123641,29510
2021-04-17,MO,St. Louis City,1948,125589,29510
2021-04-18,MO,St. Louis City,958,126547,29510
2021-04-19,MO,St. Louis City,1587,128134,29510
2021-04-20,MO,St. Louis City,1669,129803,29510
2021-04-21,MO,St. Louis City,1825,131628,29510
2021-04-22,MO,St. Louis City,1586,133214,29510
2021-04-23,MO,St. Louis City,1269,134483,29510
2021-04-24,MO,St. Louis City,1006,135489,29510
2021-04-25,MO,St. Louis City,82,135571,29510
2020-12-15,MO,Ste. Genevieve,1,1,29186
2020-12-16,MO,Ste. Genevieve,5,6,29186
2020-12-17,MO,Ste. Genevieve,7,13,29186
2020-12-18,MO,Ste. Genevieve,12,25,29186
2020-12-19,MO,Ste. Genevieve,4,29,29186
2020-12-20,MO,Ste. Genevieve,2,31,29186
2020-12-21,MO,Ste. Genevieve,11,42,29186
2020-12-22,MO,Ste. Genevieve,17,59,29186
2020-12-23,MO,Ste. Genevieve,19,78,29186
2020-12-24,MO,Ste. Genevieve,2,80,29186
2020-12-26,MO,Ste. Genevieve,1,81,29186
2020-12-27,MO,Ste. Genevieve,1,82,29186
2020-12-28,MO,Ste. Genevieve,45,127,29186
2020-12-29,MO,Ste. Genevieve,85,212,29186
2020-12-30,MO,Ste. Genevieve,94,306,29186
2020-12-31,MO,Ste. Genevieve,42,348,29186
2021-01-01,MO,Ste. Genevieve,1,349,29186
2021-01-02,MO,Ste. Genevieve,4,353,29186
2021-01-03,MO,Ste. Genevieve,1,354,29186
2021-01-04,MO,Ste. Genevieve,12,366,29186
2021-01-05,MO,Ste. Genevieve,12,378,29186
2021-01-06,MO,Ste. Genevieve,7,385,29186
2021-01-07,MO,Ste. Genevieve,14,399,29186
2021-01-08,MO,Ste. Genevieve,23,422,29186
2021-01-09,MO,Ste. Genevieve,11,433,29186
2021-01-11,MO,Ste. Genevieve,21,454,29186
2021-01-12,MO,Ste. Genevieve,16,470,29186
2021-01-13,MO,Ste. Genevieve,35,505,29186
2021-01-14,MO,Ste. Genevieve,39,544,29186
2021-01-15,MO,Ste. Genevieve,83,627,29186
2021-01-16,MO,Ste. Genevieve,4,631,29186
2021-01-17,MO,Ste. Genevieve,1,632,29186
2021-01-18,MO,Ste. Genevieve,34,666,29186
2021-01-19,MO,Ste. Genevieve,27,693,29186
2021-01-20,MO,Ste. Genevieve,30,723,29186
2021-01-21,MO,Ste. Genevieve,48,771,29186
2021-01-22,MO,Ste. Genevieve,83,854,29186
2021-01-23,MO,Ste. Genevieve,24,878,29186
2021-01-24,MO,Ste. Genevieve,8,886,29186
2021-01-25,MO,Ste. Genevieve,132,1018,29186
2021-01-26,MO,Ste. Genevieve,93,1111,29186
2021-01-27,MO,Ste. Genevieve,116,1227,29186
2021-01-28,MO,Ste. Genevieve,42,1269,29186
2021-01-29,MO,Ste. Genevieve,189,1458,29186
2021-01-30,MO,Ste. Genevieve,1,1459,29186
2021-02-01,MO,Ste. Genevieve,20,1479,29186
2021-02-02,MO,Ste. Genevieve,481,1960,29186
2021-02-03,MO,Ste. Genevieve,326,2286,29186
2021-02-04,MO,Ste. Genevieve,50,2336,29186
2021-02-05,MO,Ste. Genevieve,59,2395,29186
2021-02-06,MO,Ste. Genevieve,9,2404,29186
2021-02-07,MO,Ste. Genevieve,1,2405,29186
2021-02-08,MO,Ste. Genevieve,36,2441,29186
2021-02-09,MO,Ste. Genevieve,126,2567,29186
2021-02-10,MO,Ste. Genevieve,20,2587,29186
2021-02-11,MO,Ste. Genevieve,51,2638,29186
2021-02-12,MO,Ste. Genevieve,234,2872,29186
2021-02-13,MO,Ste. Genevieve,19,2891,29186
2021-02-14,MO,Ste. Genevieve,5,2896,29186
2021-02-15,MO,Ste. Genevieve,37,2933,29186
2021-02-16,MO,Ste. Genevieve,41,2974,29186
2021-02-17,MO,Ste. Genevieve,16,2990,29186
2021-02-18,MO,Ste. Genevieve,23,3013,29186
2021-02-19,MO,Ste. Genevieve,156,3169,29186
2021-02-20,MO,Ste. Genevieve,5,3174,29186
2021-02-21,MO,Ste. Genevieve,5,3179,29186
2021-02-22,MO,Ste. Genevieve,29,3208,29186
2021-02-23,MO,Ste. Genevieve,23,3231,29186
2021-02-24,MO,Ste. Genevieve,432,3663,29186
2021-02-25,MO,Ste. Genevieve,49,3712,29186
2021-02-26,MO,Ste. Genevieve,121,3833,29186
2021-02-27,MO,Ste. Genevieve,26,3859,29186
2021-02-28,MO,Ste. Genevieve,2,3861,29186
2021-03-01,MO,Ste. Genevieve,21,3882,29186
2021-03-02,MO,Ste. Genevieve,501,4383,29186
2021-03-03,MO,Ste. Genevieve,377,4760,29186
2021-03-04,MO,Ste. Genevieve,27,4787,29186
2021-03-05,MO,Ste. Genevieve,72,4859,29186
2021-03-06,MO,Ste. Genevieve,5,4864,29186
2021-03-07,MO,Ste. Genevieve,4,4868,29186
2021-03-08,MO,Ste. Genevieve,64,4932,29186
2021-03-09,MO,Ste. Genevieve,272,5204,29186
2021-03-10,MO,Ste. Genevieve,114,5318,29186
2021-03-11,MO,Ste. Genevieve,66,5384,29186
2021-03-12,MO,Ste. Genevieve,79,5463,29186
2021-03-13,MO,Ste. Genevieve,11,5474,29186
2021-03-14,MO,Ste. Genevieve,2,5476,29186
2021-03-15,MO,Ste. Genevieve,50,5526,29186
2021-03-16,MO,Ste. Genevieve,51,5577,29186
2021-03-17,MO,Ste. Genevieve,78,5655,29186
2021-03-18,MO,Ste. Genevieve,121,5776,29186
2021-03-19,MO,Ste. Genevieve,118,5894,29186
2021-03-20,MO,Ste. Genevieve,10,5904,29186
2021-03-21,MO,Ste. Genevieve,4,5908,29186
2021-03-22,MO,Ste. Genevieve,33,5941,29186
2021-03-23,MO,Ste. Genevieve,25,5966,29186
2021-03-24,MO,Ste. Genevieve,384,6350,29186
2021-03-25,MO,Ste. Genevieve,137,6487,29186
2021-03-26,MO,Ste. Genevieve,64,6551,29186
2021-03-27,MO,Ste. Genevieve,8,6559,29186
2021-03-28,MO,Ste. Genevieve,4,6563,29186
2021-03-29,MO,Ste. Genevieve,16,6579,29186
2021-03-30,MO,Ste. Genevieve,304,6883,29186
2021-03-31,MO,Ste. Genevieve,249,7132,29186
2021-04-01,MO,Ste. Genevieve,150,7282,29186
2021-04-02,MO,Ste. Genevieve,82,7364,29186
2021-04-03,MO,Ste. Genevieve,8,7372,29186
2021-04-04,MO,Ste. Genevieve,1,7373,29186
2021-04-05,MO,Ste. Genevieve,45,7418,29186
2021-04-06,MO,Ste. Genevieve,267,7685,29186
2021-04-07,MO,Ste. Genevieve,137,7822,29186
2021-04-08,MO,Ste. Genevieve,187,8009,29186
2021-04-09,MO,Ste. Genevieve,87,8096,29186
2021-04-10,MO,Ste. Genevieve,36,8132,29186
2021-04-11,MO,Ste. Genevieve,7,8139,29186
2021-04-12,MO,Ste. Genevieve,57,8196,29186
2021-04-13,MO,Ste. Genevieve,43,8239,29186
2021-04-14,MO,Ste. Genevieve,98,8337,29186
2021-04-15,MO,Ste. Genevieve,174,8511,29186
2021-04-16,MO,Ste. Genevieve,73,8584,29186
2021-04-17,MO,Ste. Genevieve,12,8596,29186
2021-04-18,MO,Ste. Genevieve,6,8602,29186
2021-04-19,MO,Ste. Genevieve,17,8619,29186
2021-04-20,MO,Ste. Genevieve,34,8653,29186
2021-04-21,MO,Ste. Genevieve,40,8693,29186
2021-04-22,MO,Ste. Genevieve,111,8804,29186
2021-04-23,MO,Ste. Genevieve,50,8854,29186
2021-04-24,MO,Ste. Genevieve,8,8862,29186
2021-04-25,MO,Ste. Genevieve,4,8866,29186
2020-12-15,MO,Stoddard,3,3,29207
2020-12-17,MO,Stoddard,3,6,29207
2020-12-18,MO,Stoddard,44,50,29207
2020-12-20,MO,Stoddard,2,52,29207
2020-12-21,MO,Stoddard,6,58,29207
2020-12-22,MO,Stoddard,28,86,29207
2020-12-23,MO,Stoddard,32,118,29207
2020-12-24,MO,Stoddard,1,119,29207
2020-12-26,MO,Stoddard,1,120,29207
2020-12-28,MO,Stoddard,57,177,29207
2020-12-29,MO,Stoddard,57,234,29207
2020-12-30,MO,Stoddard,44,278,29207
2020-12-31,MO,Stoddard,29,307,29207
2021-01-01,MO,Stoddard,1,308,29207
2021-01-02,MO,Stoddard,1,309,29207
2021-01-03,MO,Stoddard,5,314,29207
2021-01-04,MO,Stoddard,59,373,29207
2021-01-05,MO,Stoddard,97,470,29207
2021-01-06,MO,Stoddard,12,482,29207
2021-01-07,MO,Stoddard,26,508,29207
2021-01-08,MO,Stoddard,60,568,29207
2021-01-09,MO,Stoddard,10,578,29207
2021-01-10,MO,Stoddard,2,580,29207
2021-01-11,MO,Stoddard,14,594,29207
2021-01-12,MO,Stoddard,43,637,29207
2021-01-13,MO,Stoddard,47,684,29207
2021-01-14,MO,Stoddard,28,712,29207
2021-01-15,MO,Stoddard,36,748,29207
2021-01-16,MO,Stoddard,7,755,29207
2021-01-18,MO,Stoddard,54,809,29207
2021-01-19,MO,Stoddard,98,907,29207
2021-01-20,MO,Stoddard,193,1100,29207
2021-01-21,MO,Stoddard,140,1240,29207
2021-01-22,MO,Stoddard,365,1605,29207
2021-01-23,MO,Stoddard,73,1678,29207
2021-01-24,MO,Stoddard,3,1681,29207
2021-01-25,MO,Stoddard,139,1820,29207
2021-01-26,MO,Stoddard,157,1977,29207
2021-01-27,MO,Stoddard,441,2418,29207
2021-01-28,MO,Stoddard,47,2465,29207
2021-01-29,MO,Stoddard,132,2597,29207
2021-01-30,MO,Stoddard,4,2601,29207
2021-02-01,MO,Stoddard,86,2687,29207
2021-02-02,MO,Stoddard,62,2749,29207
2021-02-03,MO,Stoddard,30,2779,29207
2021-02-04,MO,Stoddard,166,2945,29207
2021-02-05,MO,Stoddard,433,3378,29207
2021-02-06,MO,Stoddard,13,3391,29207
2021-02-07,MO,Stoddard,3,3394,29207
2021-02-08,MO,Stoddard,63,3457,29207
2021-02-09,MO,Stoddard,255,3712,29207
2021-02-10,MO,Stoddard,154,3866,29207
2021-02-11,MO,Stoddard,72,3938,29207
2021-02-12,MO,Stoddard,355,4293,29207
2021-02-13,MO,Stoddard,24,4317,29207
2021-02-14,MO,Stoddard,9,4326,29207
2021-02-15,MO,Stoddard,33,4359,29207
2021-02-16,MO,Stoddard,59,4418,29207
2021-02-17,MO,Stoddard,17,4435,29207
2021-02-18,MO,Stoddard,17,4452,29207
2021-02-19,MO,Stoddard,117,4569,29207
2021-02-20,MO,Stoddard,24,4593,29207
2021-02-21,MO,Stoddard,4,4597,29207
2021-02-22,MO,Stoddard,64,4661,29207
2021-02-23,MO,Stoddard,226,4887,29207
2021-02-24,MO,Stoddard,536,5423,29207
2021-02-25,MO,Stoddard,84,5507,29207
2021-02-26,MO,Stoddard,134,5641,29207
2021-02-27,MO,Stoddard,37,5678,29207
2021-02-28,MO,Stoddard,1,5679,29207
2021-03-01,MO,Stoddard,59,5738,29207
2021-03-02,MO,Stoddard,204,5942,29207
2021-03-03,MO,Stoddard,488,6430,29207
2021-03-04,MO,Stoddard,162,6592,29207
2021-03-05,MO,Stoddard,355,6947,29207
2021-03-06,MO,Stoddard,12,6959,29207
2021-03-07,MO,Stoddard,7,6966,29207
2021-03-08,MO,Stoddard,165,7131,29207
2021-03-09,MO,Stoddard,93,7224,29207
2021-03-10,MO,Stoddard,67,7291,29207
2021-03-11,MO,Stoddard,60,7351,29207
2021-03-12,MO,Stoddard,112,7463,29207
2021-03-13,MO,Stoddard,32,7495,29207
2021-03-14,MO,Stoddard,29,7524,29207
2021-03-15,MO,Stoddard,106,7630,29207
2021-03-16,MO,Stoddard,99,7729,29207
2021-03-17,MO,Stoddard,124,7853,29207
2021-03-18,MO,Stoddard,92,7945,29207
2021-03-19,MO,Stoddard,396,8341,29207
2021-03-20,MO,Stoddard,63,8404,29207
2021-03-21,MO,Stoddard,24,8428,29207
2021-03-22,MO,Stoddard,85,8513,29207
2021-03-23,MO,Stoddard,263,8776,29207
2021-03-24,MO,Stoddard,86,8862,29207
2021-03-25,MO,Stoddard,248,9110,29207
2021-03-26,MO,Stoddard,58,9168,29207
2021-03-27,MO,Stoddard,28,9196,29207
2021-03-28,MO,Stoddard,21,9217,29207
2021-03-29,MO,Stoddard,66,9283,29207
2021-03-30,MO,Stoddard,218,9501,29207
2021-03-31,MO,Stoddard,488,9989,29207
2021-04-01,MO,Stoddard,66,10055,29207
2021-04-02,MO,Stoddard,104,10159,29207
2021-04-03,MO,Stoddard,41,10200,29207
2021-04-04,MO,Stoddard,12,10212,29207
2021-04-05,MO,Stoddard,125,10337,29207
2021-04-06,MO,Stoddard,122,10459,29207
2021-04-07,MO,Stoddard,97,10556,29207
2021-04-08,MO,Stoddard,115,10671,29207
2021-04-09,MO,Stoddard,230,10901,29207
2021-04-10,MO,Stoddard,30,10931,29207
2021-04-11,MO,Stoddard,25,10956,29207
2021-04-12,MO,Stoddard,77,11033,29207
2021-04-13,MO,Stoddard,100,11133,29207
2021-04-14,MO,Stoddard,93,11226,29207
2021-04-15,MO,Stoddard,109,11335,29207
2021-04-16,MO,Stoddard,316,11651,29207
2021-04-17,MO,Stoddard,47,11698,29207
2021-04-18,MO,Stoddard,31,11729,29207
2021-04-19,MO,Stoddard,69,11798,29207
2021-04-20,MO,Stoddard,58,11856,29207
2021-04-21,MO,Stoddard,89,11945,29207
2021-04-22,MO,Stoddard,214,12159,29207
2021-04-23,MO,Stoddard,64,12223,29207
2021-04-24,MO,Stoddard,44,12267,29207
2021-04-25,MO,Stoddard,9,12276,29207
2020-12-16,MO,Stone,11,11,29209
2020-12-17,MO,Stone,6,17,29209
2020-12-18,MO,Stone,5,22,29209
2020-12-20,MO,Stone,1,23,29209
2020-12-21,MO,Stone,11,34,29209
2020-12-22,MO,Stone,38,72,29209
2020-12-23,MO,Stone,21,93,29209
2020-12-24,MO,Stone,17,110,29209
2020-12-26,MO,Stone,3,113,29209
2020-12-27,MO,Stone,7,120,29209
2020-12-28,MO,Stone,19,139,29209
2020-12-29,MO,Stone,29,168,29209
2020-12-30,MO,Stone,30,198,29209
2020-12-31,MO,Stone,21,219,29209
2021-01-02,MO,Stone,5,224,29209
2021-01-04,MO,Stone,11,235,29209
2021-01-05,MO,Stone,12,247,29209
2021-01-06,MO,Stone,6,253,29209
2021-01-07,MO,Stone,7,260,29209
2021-01-08,MO,Stone,19,279,29209
2021-01-09,MO,Stone,1,280,29209
2021-01-10,MO,Stone,1,281,29209
2021-01-11,MO,Stone,12,293,29209
2021-01-12,MO,Stone,11,304,29209
2021-01-13,MO,Stone,46,350,29209
2021-01-14,MO,Stone,27,377,29209
2021-01-15,MO,Stone,10,387,29209
2021-01-16,MO,Stone,13,400,29209
2021-01-17,MO,Stone,2,402,29209
2021-01-18,MO,Stone,11,413,29209
2021-01-19,MO,Stone,15,428,29209
2021-01-20,MO,Stone,75,503,29209
2021-01-21,MO,Stone,84,587,29209
2021-01-22,MO,Stone,74,661,29209
2021-01-23,MO,Stone,23,684,29209
2021-01-24,MO,Stone,2,686,29209
2021-01-25,MO,Stone,39,725,29209
2021-01-26,MO,Stone,190,915,29209
2021-01-27,MO,Stone,222,1137,29209
2021-01-28,MO,Stone,54,1191,29209
2021-01-29,MO,Stone,43,1234,29209
2021-01-30,MO,Stone,10,1244,29209
2021-02-01,MO,Stone,277,1521,29209
2021-02-02,MO,Stone,298,1819,29209
2021-02-03,MO,Stone,286,2105,29209
2021-02-04,MO,Stone,119,2224,29209
2021-02-05,MO,Stone,86,2310,29209
2021-02-06,MO,Stone,46,2356,29209
2021-02-07,MO,Stone,1,2357,29209
2021-02-08,MO,Stone,50,2407,29209
2021-02-09,MO,Stone,84,2491,29209
2021-02-10,MO,Stone,42,2533,29209
2021-02-11,MO,Stone,154,2687,29209
2021-02-12,MO,Stone,717,3404,29209
2021-02-13,MO,Stone,65,3469,29209
2021-02-14,MO,Stone,14,3483,29209
2021-02-15,MO,Stone,8,3491,29209
2021-02-16,MO,Stone,18,3509,29209
2021-02-17,MO,Stone,19,3528,29209
2021-02-18,MO,Stone,127,3655,29209
2021-02-19,MO,Stone,100,3755,29209
2021-02-20,MO,Stone,14,3769,29209
2021-02-22,MO,Stone,86,3855,29209
2021-02-23,MO,Stone,357,4212,29209
2021-02-24,MO,Stone,227,4439,29209
2021-02-25,MO,Stone,117,4556,29209
2021-02-26,MO,Stone,84,4640,29209
2021-02-27,MO,Stone,114,4754,29209
2021-02-28,MO,Stone,2,4756,29209
2021-03-01,MO,Stone,321,5077,29209
2021-03-02,MO,Stone,422,5499,29209
2021-03-03,MO,Stone,443,5942,29209
2021-03-04,MO,Stone,553,6495,29209
2021-03-05,MO,Stone,194,6689,29209
2021-03-06,MO,Stone,67,6756,29209
2021-03-07,MO,Stone,4,6760,29209
2021-03-08,MO,Stone,162,6922,29209
2021-03-09,MO,Stone,219,7141,29209
2021-03-10,MO,Stone,50,7191,29209
2021-03-11,MO,Stone,452,7643,29209
2021-03-12,MO,Stone,720,8363,29209
2021-03-13,MO,Stone,79,8442,29209
2021-03-14,MO,Stone,8,8450,29209
2021-03-15,MO,Stone,55,8505,29209
2021-03-16,MO,Stone,94,8599,29209
2021-03-17,MO,Stone,270,8869,29209
2021-03-18,MO,Stone,260,9129,29209
2021-03-19,MO,Stone,183,9312,29209
2021-03-20,MO,Stone,90,9402,29209
2021-03-21,MO,Stone,12,9414,29209
2021-03-22,MO,Stone,162,9576,29209
2021-03-23,MO,Stone,456,10032,29209
2021-03-24,MO,Stone,125,10157,29209
2021-03-25,MO,Stone,366,10523,29209
2021-03-26,MO,Stone,118,10641,29209
2021-03-27,MO,Stone,90,10731,29209
2021-03-28,MO,Stone,11,10742,29209
2021-03-29,MO,Stone,47,10789,29209
2021-03-30,MO,Stone,262,11051,29209
2021-03-31,MO,Stone,265,11316,29209
2021-04-01,MO,Stone,477,11793,29209
2021-04-02,MO,Stone,232,12025,29209
2021-04-03,MO,Stone,97,12122,29209
2021-04-04,MO,Stone,6,12128,29209
2021-04-05,MO,Stone,101,12229,29209
2021-04-06,MO,Stone,372,12601,29209
2021-04-07,MO,Stone,304,12905,29209
2021-04-08,MO,Stone,210,13115,29209
2021-04-09,MO,Stone,164,13279,29209
2021-04-10,MO,Stone,78,13357,29209
2021-04-11,MO,Stone,14,13371,29209
2021-04-12,MO,Stone,177,13548,29209
2021-04-13,MO,Stone,195,13743,29209
2021-04-14,MO,Stone,88,13831,29209
2021-04-15,MO,Stone,82,13913,29209
2021-04-16,MO,Stone,98,14011,29209
2021-04-17,MO,Stone,60,14071,29209
2021-04-18,MO,Stone,11,14082,29209
2021-04-19,MO,Stone,41,14123,29209
2021-04-20,MO,Stone,63,14186,29209
2021-04-21,MO,Stone,70,14256,29209
2021-04-22,MO,Stone,81,14337,29209
2021-04-23,MO,Stone,139,14476,29209
2021-04-24,MO,Stone,65,14541,29209
2021-04-25,MO,Stone,9,14550,29209
2020-12-19,MO,Sullivan,1,1,29211
2020-12-21,MO,Sullivan,16,17,29211
2020-12-23,MO,Sullivan,12,29,29211
2020-12-28,MO,Sullivan,1,30,29211
2020-12-29,MO,Sullivan,2,32,29211
2020-12-31,MO,Sullivan,1,33,29211
2021-01-05,MO,Sullivan,3,36,29211
2021-01-06,MO,Sullivan,1,37,29211
2021-01-07,MO,Sullivan,2,39,29211
2021-01-08,MO,Sullivan,1,40,29211
2021-01-09,MO,Sullivan,2,42,29211
2021-01-11,MO,Sullivan,19,61,29211
2021-01-12,MO,Sullivan,39,100,29211
2021-01-13,MO,Sullivan,13,113,29211
2021-01-14,MO,Sullivan,6,119,29211
2021-01-15,MO,Sullivan,9,128,29211
2021-01-18,MO,Sullivan,1,129,29211
2021-01-19,MO,Sullivan,5,134,29211
2021-01-20,MO,Sullivan,7,141,29211
2021-01-21,MO,Sullivan,4,145,29211
2021-01-22,MO,Sullivan,54,199,29211
2021-01-25,MO,Sullivan,2,201,29211
2021-01-27,MO,Sullivan,35,236,29211
2021-01-28,MO,Sullivan,39,275,29211
2021-01-29,MO,Sullivan,24,299,29211
2021-01-30,MO,Sullivan,1,300,29211
2021-02-01,MO,Sullivan,200,500,29211
2021-02-02,MO,Sullivan,14,514,29211
2021-02-03,MO,Sullivan,3,517,29211
2021-02-04,MO,Sullivan,25,542,29211
2021-02-05,MO,Sullivan,122,664,29211
2021-02-06,MO,Sullivan,3,667,29211
2021-02-08,MO,Sullivan,14,681,29211
2021-02-09,MO,Sullivan,44,725,29211
2021-02-10,MO,Sullivan,11,736,29211
2021-02-11,MO,Sullivan,8,744,29211
2021-02-12,MO,Sullivan,14,758,29211
2021-02-13,MO,Sullivan,1,759,29211
2021-02-14,MO,Sullivan,2,761,29211
2021-02-15,MO,Sullivan,1,762,29211
2021-02-16,MO,Sullivan,4,766,29211
2021-02-17,MO,Sullivan,1,767,29211
2021-02-18,MO,Sullivan,58,825,29211
2021-02-19,MO,Sullivan,7,832,29211
2021-02-20,MO,Sullivan,1,833,29211
2021-02-22,MO,Sullivan,5,838,29211
2021-02-23,MO,Sullivan,3,841,29211
2021-02-24,MO,Sullivan,44,885,29211
2021-02-25,MO,Sullivan,104,989,29211
2021-02-26,MO,Sullivan,121,1110,29211
2021-02-27,MO,Sullivan,24,1134,29211
2021-02-28,MO,Sullivan,1,1135,29211
2021-03-01,MO,Sullivan,32,1167,29211
2021-03-02,MO,Sullivan,20,1187,29211
2021-03-03,MO,Sullivan,95,1282,29211
2021-03-04,MO,Sullivan,208,1490,29211
2021-03-05,MO,Sullivan,40,1530,29211
2021-03-06,MO,Sullivan,9,1539,29211
2021-03-07,MO,Sullivan,2,1541,29211
2021-03-08,MO,Sullivan,9,1550,29211
2021-03-09,MO,Sullivan,16,1566,29211
2021-03-10,MO,Sullivan,7,1573,29211
2021-03-11,MO,Sullivan,11,1584,29211
2021-03-12,MO,Sullivan,92,1676,29211
2021-03-13,MO,Sullivan,3,1679,29211
2021-03-15,MO,Sullivan,2,1681,29211
2021-03-16,MO,Sullivan,20,1701,29211
2021-03-17,MO,Sullivan,11,1712,29211
2021-03-18,MO,Sullivan,26,1738,29211
2021-03-19,MO,Sullivan,106,1844,29211
2021-03-20,MO,Sullivan,17,1861,29211
2021-03-22,MO,Sullivan,5,1866,29211
2021-03-23,MO,Sullivan,84,1950,29211
2021-03-24,MO,Sullivan,8,1958,29211
2021-03-25,MO,Sullivan,72,2030,29211
2021-03-26,MO,Sullivan,198,2228,29211
2021-03-27,MO,Sullivan,5,2233,29211
2021-03-28,MO,Sullivan,3,2236,29211
2021-03-29,MO,Sullivan,16,2252,29211
2021-03-30,MO,Sullivan,22,2274,29211
2021-03-31,MO,Sullivan,20,2294,29211
2021-04-01,MO,Sullivan,15,2309,29211
2021-04-02,MO,Sullivan,131,2440,29211
2021-04-03,MO,Sullivan,9,2449,29211
2021-04-04,MO,Sullivan,2,2451,29211
2021-04-05,MO,Sullivan,3,2454,29211
2021-04-06,MO,Sullivan,18,2472,29211
2021-04-07,MO,Sullivan,10,2482,29211
2021-04-08,MO,Sullivan,13,2495,29211
2021-04-09,MO,Sullivan,25,2520,29211
2021-04-10,MO,Sullivan,3,2523,29211
2021-04-11,MO,Sullivan,4,2527,29211
2021-04-12,MO,Sullivan,12,2539,29211
2021-04-13,MO,Sullivan,7,2546,29211
2021-04-14,MO,Sullivan,12,2558,29211
2021-04-15,MO,Sullivan,23,2581,29211
2021-04-16,MO,Sullivan,164,2745,29211
2021-04-17,MO,Sullivan,10,2755,29211
2021-04-18,MO,Sullivan,1,2756,29211
2021-04-19,MO,Sullivan,4,2760,29211
2021-04-20,MO,Sullivan,13,2773,29211
2021-04-21,MO,Sullivan,12,2785,29211
2021-04-22,MO,Sullivan,10,2795,29211
2021-04-23,MO,Sullivan,12,2807,29211
2021-04-24,MO,Sullivan,9,2816,29211
2021-04-25,MO,Sullivan,1,2817,29211
2020-12-14,MO,Taney,2,2,29213
2020-12-15,MO,Taney,2,4,29213
2020-12-16,MO,Taney,6,10,29213
2020-12-17,MO,Taney,8,18,29213
2020-12-18,MO,Taney,1,19,29213
2020-12-19,MO,Taney,3,22,29213
2020-12-20,MO,Taney,1,23,29213
2020-12-21,MO,Taney,32,55,29213
2020-12-22,MO,Taney,168,223,29213
2020-12-23,MO,Taney,112,335,29213
2020-12-24,MO,Taney,19,354,29213
2020-12-26,MO,Taney,9,363,29213
2020-12-27,MO,Taney,16,379,29213
2020-12-28,MO,Taney,46,425,29213
2020-12-29,MO,Taney,78,503,29213
2020-12-30,MO,Taney,54,557,29213
2020-12-31,MO,Taney,24,581,29213
2021-01-02,MO,Taney,2,583,29213
2021-01-03,MO,Taney,1,584,29213
2021-01-04,MO,Taney,23,607,29213
2021-01-05,MO,Taney,12,619,29213
2021-01-06,MO,Taney,25,644,29213
2021-01-07,MO,Taney,9,653,29213
2021-01-08,MO,Taney,32,685,29213
2021-01-09,MO,Taney,2,687,29213
2021-01-10,MO,Taney,26,713,29213
2021-01-11,MO,Taney,15,728,29213
2021-01-12,MO,Taney,16,744,29213
2021-01-13,MO,Taney,22,766,29213
2021-01-14,MO,Taney,155,921,29213
2021-01-15,MO,Taney,19,940,29213
2021-01-16,MO,Taney,7,947,29213
2021-01-17,MO,Taney,5,952,29213
2021-01-18,MO,Taney,33,985,29213
2021-01-19,MO,Taney,55,1040,29213
2021-01-20,MO,Taney,255,1295,29213
2021-01-21,MO,Taney,218,1513,29213
2021-01-22,MO,Taney,355,1868,29213
2021-01-23,MO,Taney,42,1910,29213
2021-01-24,MO,Taney,11,1921,29213
2021-01-25,MO,Taney,39,1960,29213
2021-01-26,MO,Taney,111,2071,29213
2021-01-27,MO,Taney,110,2181,29213
2021-01-28,MO,Taney,326,2507,29213
2021-01-29,MO,Taney,260,2767,29213
2021-01-30,MO,Taney,7,2774,29213
2021-01-31,MO,Taney,2,2776,29213
2021-02-01,MO,Taney,103,2879,29213
2021-02-02,MO,Taney,136,3015,29213
2021-02-03,MO,Taney,74,3089,29213
2021-02-04,MO,Taney,274,3363,29213
2021-02-05,MO,Taney,221,3584,29213
2021-02-06,MO,Taney,24,3608,29213
2021-02-07,MO,Taney,27,3635,29213
2021-02-08,MO,Taney,167,3802,29213
2021-02-09,MO,Taney,199,4001,29213
2021-02-10,MO,Taney,19,4020,29213
2021-02-11,MO,Taney,255,4275,29213
2021-02-12,MO,Taney,336,4611,29213
2021-02-13,MO,Taney,268,4879,29213
2021-02-14,MO,Taney,16,4895,29213
2021-02-15,MO,Taney,7,4902,29213
2021-02-16,MO,Taney,20,4922,29213
2021-02-17,MO,Taney,20,4942,29213
2021-02-18,MO,Taney,183,5125,29213
2021-02-19,MO,Taney,310,5435,29213
2021-02-20,MO,Taney,11,5446,29213
2021-02-21,MO,Taney,3,5449,29213
2021-02-22,MO,Taney,153,5602,29213
2021-02-23,MO,Taney,190,5792,29213
2021-02-24,MO,Taney,424,6216,29213
2021-02-25,MO,Taney,102,6318,29213
2021-02-26,MO,Taney,123,6441,29213
2021-02-27,MO,Taney,671,7112,29213
2021-02-28,MO,Taney,3,7115,29213
2021-03-01,MO,Taney,361,7476,29213
2021-03-02,MO,Taney,323,7799,29213
2021-03-03,MO,Taney,638,8437,29213
2021-03-04,MO,Taney,358,8795,29213
2021-03-05,MO,Taney,348,9143,29213
2021-03-06,MO,Taney,40,9183,29213
2021-03-07,MO,Taney,20,9203,29213
2021-03-08,MO,Taney,460,9663,29213
2021-03-09,MO,Taney,447,10110,29213
2021-03-10,MO,Taney,71,10181,29213
2021-03-11,MO,Taney,198,10379,29213
2021-03-12,MO,Taney,256,10635,29213
2021-03-13,MO,Taney,216,10851,29213
2021-03-14,MO,Taney,12,10863,29213
2021-03-15,MO,Taney,453,11316,29213
2021-03-16,MO,Taney,334,11650,29213
2021-03-17,MO,Taney,425,12075,29213
2021-03-18,MO,Taney,605,12680,29213
2021-03-19,MO,Taney,371,13051,29213
2021-03-20,MO,Taney,575,13626,29213
2021-03-21,MO,Taney,22,13648,29213
2021-03-22,MO,Taney,614,14262,29213
2021-03-23,MO,Taney,545,14807,29213
2021-03-24,MO,Taney,331,15138,29213
2021-03-25,MO,Taney,104,15242,29213
2021-03-26,MO,Taney,136,15378,29213
2021-03-27,MO,Taney,150,15528,29213
2021-03-28,MO,Taney,22,15550,29213
2021-03-29,MO,Taney,100,15650,29213
2021-03-30,MO,Taney,279,15929,29213
2021-03-31,MO,Taney,448,16377,29213
2021-04-01,MO,Taney,352,16729,29213
2021-04-02,MO,Taney,421,17150,29213
2021-04-03,MO,Taney,112,17262,29213
2021-04-04,MO,Taney,14,17276,29213
2021-04-05,MO,Taney,266,17542,29213
2021-04-06,MO,Taney,541,18083,29213
2021-04-07,MO,Taney,267,18350,29213
2021-04-08,MO,Taney,496,18846,29213
2021-04-09,MO,Taney,396,19242,29213
2021-04-10,MO,Taney,125,19367,29213
2021-04-11,MO,Taney,33,19400,29213
2021-04-12,MO,Taney,320,19720,29213
2021-04-13,MO,Taney,241,19961,29213
2021-04-14,MO,Taney,219,20180,29213
2021-04-15,MO,Taney,189,20369,29213
2021-04-16,MO,Taney,124,20493,29213
2021-04-17,MO,Taney,37,20530,29213
2021-04-18,MO,Taney,12,20542,29213
2021-04-19,MO,Taney,108,20650,29213
2021-04-20,MO,Taney,128,20778,29213
2021-04-21,MO,Taney,47,20825,29213
2021-04-22,MO,Taney,86,20911,29213
2021-04-23,MO,Taney,302,21213,29213
2021-04-24,MO,Taney,49,21262,29213
2021-04-25,MO,Taney,10,21272,29213
2020-12-15,MO,Texas,2,2,29215
2020-12-16,MO,Texas,6,8,29215
2020-12-17,MO,Texas,2,10,29215
2020-12-18,MO,Texas,1,11,29215
2020-12-20,MO,Texas,1,12,29215
2020-12-21,MO,Texas,3,15,29215
2020-12-22,MO,Texas,7,22,29215
2020-12-23,MO,Texas,9,31,29215
2020-12-26,MO,Texas,2,33,29215
2020-12-28,MO,Texas,4,37,29215
2020-12-29,MO,Texas,27,64,29215
2020-12-30,MO,Texas,13,77,29215
2020-12-31,MO,Texas,5,82,29215
2021-01-01,MO,Texas,5,87,29215
2021-01-02,MO,Texas,12,99,29215
2021-01-03,MO,Texas,1,100,29215
2021-01-04,MO,Texas,10,110,29215
2021-01-05,MO,Texas,22,132,29215
2021-01-06,MO,Texas,30,162,29215
2021-01-07,MO,Texas,12,174,29215
2021-01-08,MO,Texas,32,206,29215
2021-01-09,MO,Texas,2,208,29215
2021-01-10,MO,Texas,3,211,29215
2021-01-11,MO,Texas,6,217,29215
2021-01-12,MO,Texas,16,233,29215
2021-01-13,MO,Texas,17,250,29215
2021-01-14,MO,Texas,6,256,29215
2021-01-15,MO,Texas,10,266,29215
2021-01-16,MO,Texas,2,268,29215
2021-01-18,MO,Texas,9,277,29215
2021-01-19,MO,Texas,22,299,29215
2021-01-20,MO,Texas,19,318,29215
2021-01-21,MO,Texas,68,386,29215
2021-01-22,MO,Texas,32,418,29215
2021-01-23,MO,Texas,10,428,29215
2021-01-24,MO,Texas,2,430,29215
2021-01-25,MO,Texas,18,448,29215
2021-01-26,MO,Texas,13,461,29215
2021-01-27,MO,Texas,16,477,29215
2021-01-28,MO,Texas,76,553,29215
2021-01-29,MO,Texas,124,677,29215
2021-01-30,MO,Texas,72,749,29215
2021-02-01,MO,Texas,17,766,29215
2021-02-02,MO,Texas,32,798,29215
2021-02-03,MO,Texas,50,848,29215
2021-02-04,MO,Texas,56,904,29215
2021-02-05,MO,Texas,824,1728,29215
2021-02-06,MO,Texas,9,1737,29215
2021-02-08,MO,Texas,20,1757,29215
2021-02-09,MO,Texas,37,1794,29215
2021-02-10,MO,Texas,30,1824,29215
2021-02-11,MO,Texas,158,1982,29215
2021-02-12,MO,Texas,125,2107,29215
2021-02-13,MO,Texas,22,2129,29215
2021-02-14,MO,Texas,5,2134,29215
2021-02-15,MO,Texas,9,2143,29215
2021-02-16,MO,Texas,20,2163,29215
2021-02-17,MO,Texas,8,2171,29215
2021-02-18,MO,Texas,61,2232,29215
2021-02-19,MO,Texas,58,2290,29215
2021-02-20,MO,Texas,10,2300,29215
2021-02-21,MO,Texas,4,2304,29215
2021-02-22,MO,Texas,28,2332,29215
2021-02-23,MO,Texas,105,2437,29215
2021-02-24,MO,Texas,35,2472,29215
2021-02-25,MO,Texas,71,2543,29215
2021-02-26,MO,Texas,128,2671,29215
2021-02-27,MO,Texas,97,2768,29215
2021-02-28,MO,Texas,9,2777,29215
2021-03-01,MO,Texas,16,2793,29215
2021-03-02,MO,Texas,348,3141,29215
2021-03-03,MO,Texas,84,3225,29215
2021-03-04,MO,Texas,81,3306,29215
2021-03-05,MO,Texas,42,3348,29215
2021-03-06,MO,Texas,13,3361,29215
2021-03-07,MO,Texas,3,3364,29215
2021-03-08,MO,Texas,47,3411,29215
2021-03-09,MO,Texas,747,4158,29215
2021-03-10,MO,Texas,45,4203,29215
2021-03-11,MO,Texas,190,4393,29215
2021-03-12,MO,Texas,125,4518,29215
2021-03-13,MO,Texas,19,4537,29215
2021-03-14,MO,Texas,2,4539,29215
2021-03-15,MO,Texas,131,4670,29215
2021-03-16,MO,Texas,145,4815,29215
2021-03-17,MO,Texas,54,4869,29215
2021-03-18,MO,Texas,56,4925,29215
2021-03-19,MO,Texas,59,4984,29215
2021-03-20,MO,Texas,31,5015,29215
2021-03-21,MO,Texas,8,5023,29215
2021-03-22,MO,Texas,43,5066,29215
2021-03-23,MO,Texas,180,5246,29215
2021-03-24,MO,Texas,42,5288,29215
2021-03-25,MO,Texas,137,5425,29215
2021-03-26,MO,Texas,62,5487,29215
2021-03-27,MO,Texas,66,5553,29215
2021-03-28,MO,Texas,10,5563,29215
2021-03-29,MO,Texas,33,5596,29215
2021-03-30,MO,Texas,354,5950,29215
2021-03-31,MO,Texas,92,6042,29215
2021-04-01,MO,Texas,77,6119,29215
2021-04-02,MO,Texas,42,6161,29215
2021-04-03,MO,Texas,26,6187,29215
2021-04-04,MO,Texas,5,6192,29215
2021-04-05,MO,Texas,34,6226,29215
2021-04-06,MO,Texas,108,6334,29215
2021-04-07,MO,Texas,96,6430,29215
2021-04-08,MO,Texas,65,6495,29215
2021-04-09,MO,Texas,108,6603,29215
2021-04-10,MO,Texas,61,6664,29215
2021-04-11,MO,Texas,7,6671,29215
2021-04-12,MO,Texas,154,6825,29215
2021-04-13,MO,Texas,169,6994,29215
2021-04-14,MO,Texas,57,7051,29215
2021-04-15,MO,Texas,64,7115,29215
2021-04-16,MO,Texas,83,7198,29215
2021-04-17,MO,Texas,35,7233,29215
2021-04-18,MO,Texas,6,7239,29215
2021-04-19,MO,Texas,39,7278,29215
2021-04-20,MO,Texas,76,7354,29215
2021-04-21,MO,Texas,41,7395,29215
2021-04-22,MO,Texas,122,7517,29215
2021-04-23,MO,Texas,27,7544,29215
2021-04-24,MO,Texas,46,7590,29215
2021-04-25,MO,Texas,10,7600,29215
2020-12-16,MO,Vernon,2,2,29217
2020-12-17,MO,Vernon,1,3,29217
2020-12-18,MO,Vernon,16,19,29217
2020-12-19,MO,Vernon,8,27,29217
2020-12-20,MO,Vernon,1,28,29217
2020-12-21,MO,Vernon,1,29,29217
2020-12-22,MO,Vernon,3,32,29217
2020-12-23,MO,Vernon,9,41,29217
2020-12-24,MO,Vernon,1,42,29217
2020-12-26,MO,Vernon,1,43,29217
2020-12-28,MO,Vernon,33,76,29217
2020-12-29,MO,Vernon,4,80,29217
2020-12-30,MO,Vernon,10,90,29217
2020-12-31,MO,Vernon,12,102,29217
2021-01-01,MO,Vernon,1,103,29217
2021-01-03,MO,Vernon,1,104,29217
2021-01-04,MO,Vernon,6,110,29217
2021-01-05,MO,Vernon,19,129,29217
2021-01-06,MO,Vernon,128,257,29217
2021-01-07,MO,Vernon,106,363,29217
2021-01-08,MO,Vernon,86,449,29217
2021-01-09,MO,Vernon,5,454,29217
2021-01-10,MO,Vernon,1,455,29217
2021-01-11,MO,Vernon,3,458,29217
2021-01-12,MO,Vernon,36,494,29217
2021-01-13,MO,Vernon,9,503,29217
2021-01-14,MO,Vernon,4,507,29217
2021-01-15,MO,Vernon,46,553,29217
2021-01-18,MO,Vernon,1,554,29217
2021-01-19,MO,Vernon,7,561,29217
2021-01-20,MO,Vernon,14,575,29217
2021-01-21,MO,Vernon,14,589,29217
2021-01-22,MO,Vernon,23,612,29217
2021-01-23,MO,Vernon,2,614,29217
2021-01-25,MO,Vernon,20,634,29217
2021-01-26,MO,Vernon,75,709,29217
2021-01-27,MO,Vernon,56,765,29217
2021-01-28,MO,Vernon,88,853,29217
2021-01-29,MO,Vernon,90,943,29217
2021-01-30,MO,Vernon,232,1175,29217
2021-01-31,MO,Vernon,1,1176,29217
2021-02-01,MO,Vernon,66,1242,29217
2021-02-02,MO,Vernon,121,1363,29217
2021-02-03,MO,Vernon,98,1461,29217
2021-02-04,MO,Vernon,98,1559,29217
2021-02-05,MO,Vernon,322,1881,29217
2021-02-08,MO,Vernon,13,1894,29217
2021-02-09,MO,Vernon,69,1963,29217
2021-02-10,MO,Vernon,67,2030,29217
2021-02-11,MO,Vernon,166,2196,29217
2021-02-12,MO,Vernon,45,2241,29217
2021-02-13,MO,Vernon,7,2248,29217
2021-02-14,MO,Vernon,1,2249,29217
2021-02-15,MO,Vernon,6,2255,29217
2021-02-16,MO,Vernon,9,2264,29217
2021-02-17,MO,Vernon,11,2275,29217
2021-02-18,MO,Vernon,72,2347,29217
2021-02-19,MO,Vernon,31,2378,29217
2021-02-20,MO,Vernon,5,2383,29217
2021-02-21,MO,Vernon,2,2385,29217
2021-02-22,MO,Vernon,8,2393,29217
2021-02-23,MO,Vernon,109,2502,29217
2021-02-24,MO,Vernon,97,2599,29217
2021-02-25,MO,Vernon,66,2665,29217
2021-02-26,MO,Vernon,257,2922,29217
2021-02-27,MO,Vernon,8,2930,29217
2021-02-28,MO,Vernon,1,2931,29217
2021-03-01,MO,Vernon,43,2974,29217
2021-03-02,MO,Vernon,90,3064,29217
2021-03-03,MO,Vernon,542,3606,29217
2021-03-04,MO,Vernon,243,3849,29217
2021-03-05,MO,Vernon,332,4181,29217
2021-03-06,MO,Vernon,5,4186,29217
2021-03-07,MO,Vernon,4,4190,29217
2021-03-08,MO,Vernon,19,4209,29217
2021-03-09,MO,Vernon,99,4308,29217
2021-03-10,MO,Vernon,67,4375,29217
2021-03-11,MO,Vernon,170,4545,29217
2021-03-12,MO,Vernon,36,4581,29217
2021-03-13,MO,Vernon,15,4596,29217
2021-03-14,MO,Vernon,1,4597,29217
2021-03-15,MO,Vernon,56,4653,29217
2021-03-16,MO,Vernon,442,5095,29217
2021-03-17,MO,Vernon,21,5116,29217
2021-03-18,MO,Vernon,107,5223,29217
2021-03-19,MO,Vernon,28,5251,29217
2021-03-20,MO,Vernon,6,5257,29217
2021-03-21,MO,Vernon,6,5263,29217
2021-03-22,MO,Vernon,17,5280,29217
2021-03-23,MO,Vernon,161,5441,29217
2021-03-24,MO,Vernon,85,5526,29217
2021-03-25,MO,Vernon,37,5563,29217
2021-03-26,MO,Vernon,42,5605,29217
2021-03-27,MO,Vernon,6,5611,29217
2021-03-28,MO,Vernon,1,5612,29217
2021-03-29,MO,Vernon,127,5739,29217
2021-03-30,MO,Vernon,173,5912,29217
2021-03-31,MO,Vernon,526,6438,29217
2021-04-01,MO,Vernon,226,6664,29217
2021-04-02,MO,Vernon,74,6738,29217
2021-04-03,MO,Vernon,13,6751,29217
2021-04-05,MO,Vernon,33,6784,29217
2021-04-06,MO,Vernon,26,6810,29217
2021-04-07,MO,Vernon,100,6910,29217
2021-04-08,MO,Vernon,28,6938,29217
2021-04-09,MO,Vernon,67,7005,29217
2021-04-10,MO,Vernon,23,7028,29217
2021-04-11,MO,Vernon,9,7037,29217
2021-04-12,MO,Vernon,51,7088,29217
2021-04-13,MO,Vernon,23,7111,29217
2021-04-14,MO,Vernon,80,7191,29217
2021-04-15,MO,Vernon,89,7280,29217
2021-04-16,MO,Vernon,171,7451,29217
2021-04-17,MO,Vernon,6,7457,29217
2021-04-18,MO,Vernon,6,7463,29217
2021-04-19,MO,Vernon,15,7478,29217
2021-04-20,MO,Vernon,84,7562,29217
2021-04-21,MO,Vernon,30,7592,29217
2021-04-22,MO,Vernon,21,7613,29217
2021-04-23,MO,Vernon,40,7653,29217
2021-04-24,MO,Vernon,4,7657,29217
2021-04-25,MO,Vernon,3,7660,29217
2020-12-15,MO,Warren,5,5,29219
2020-12-16,MO,Warren,8,13,29219
2020-12-17,MO,Warren,30,43,29219
2020-12-18,MO,Warren,36,79,29219
2020-12-19,MO,Warren,7,86,29219
2020-12-21,MO,Warren,34,120,29219
2020-12-22,MO,Warren,59,179,29219
2020-12-23,MO,Warren,33,212,29219
2020-12-24,MO,Warren,5,217,29219
2020-12-26,MO,Warren,7,224,29219
2020-12-27,MO,Warren,4,228,29219
2020-12-28,MO,Warren,35,263,29219
2020-12-29,MO,Warren,25,288,29219
2020-12-30,MO,Warren,28,316,29219
2020-12-31,MO,Warren,22,338,29219
2021-01-01,MO,Warren,2,340,29219
2021-01-02,MO,Warren,3,343,29219
2021-01-03,MO,Warren,1,344,29219
2021-01-04,MO,Warren,21,365,29219
2021-01-05,MO,Warren,24,389,29219
2021-01-06,MO,Warren,95,484,29219
2021-01-07,MO,Warren,39,523,29219
2021-01-08,MO,Warren,45,568,29219
2021-01-09,MO,Warren,10,578,29219
2021-01-10,MO,Warren,5,583,29219
2021-01-11,MO,Warren,62,645,29219
2021-01-12,MO,Warren,44,689,29219
2021-01-13,MO,Warren,28,717,29219
2021-01-14,MO,Warren,28,745,29219
2021-01-15,MO,Warren,66,811,29219
2021-01-16,MO,Warren,10,821,29219
2021-01-17,MO,Warren,1,822,29219
2021-01-18,MO,Warren,49,871,29219
2021-01-19,MO,Warren,73,944,29219
2021-01-20,MO,Warren,76,1020,29219
2021-01-21,MO,Warren,114,1134,29219
2021-01-22,MO,Warren,56,1190,29219
2021-01-23,MO,Warren,26,1216,29219
2021-01-24,MO,Warren,22,1238,29219
2021-01-25,MO,Warren,69,1307,29219
2021-01-26,MO,Warren,77,1384,29219
2021-01-27,MO,Warren,58,1442,29219
2021-01-28,MO,Warren,61,1503,29219
2021-01-29,MO,Warren,76,1579,29219
2021-01-30,MO,Warren,70,1649,29219
2021-01-31,MO,Warren,17,1666,29219
2021-02-01,MO,Warren,79,1745,29219
2021-02-02,MO,Warren,78,1823,29219
2021-02-03,MO,Warren,145,1968,29219
2021-02-04,MO,Warren,65,2033,29219
2021-02-05,MO,Warren,103,2136,29219
2021-02-06,MO,Warren,31,2167,29219
2021-02-07,MO,Warren,1,2168,29219
2021-02-08,MO,Warren,81,2249,29219
2021-02-09,MO,Warren,115,2364,29219
2021-02-10,MO,Warren,58,2422,29219
2021-02-11,MO,Warren,83,2505,29219
2021-02-12,MO,Warren,152,2657,29219
2021-02-13,MO,Warren,70,2727,29219
2021-02-14,MO,Warren,20,2747,29219
2021-02-15,MO,Warren,64,2811,29219
2021-02-16,MO,Warren,84,2895,29219
2021-02-17,MO,Warren,91,2986,29219
2021-02-18,MO,Warren,161,3147,29219
2021-02-19,MO,Warren,85,3232,29219
2021-02-20,MO,Warren,97,3329,29219
2021-02-21,MO,Warren,13,3342,29219
2021-02-22,MO,Warren,139,3481,29219
2021-02-23,MO,Warren,290,3771,29219
2021-02-24,MO,Warren,179,3950,29219
2021-02-25,MO,Warren,174,4124,29219
2021-02-26,MO,Warren,112,4236,29219
2021-02-27,MO,Warren,112,4348,29219
2021-02-28,MO,Warren,25,4373,29219
2021-03-01,MO,Warren,210,4583,29219
2021-03-02,MO,Warren,318,4901,29219
2021-03-03,MO,Warren,131,5032,29219
2021-03-04,MO,Warren,131,5163,29219
2021-03-05,MO,Warren,163,5326,29219
2021-03-06,MO,Warren,64,5390,29219
2021-03-07,MO,Warren,31,5421,29219
2021-03-08,MO,Warren,268,5689,29219
2021-03-09,MO,Warren,230,5919,29219
2021-03-10,MO,Warren,180,6099,29219
2021-03-11,MO,Warren,211,6310,29219
2021-03-12,MO,Warren,243,6553,29219
2021-03-13,MO,Warren,95,6648,29219
2021-03-14,MO,Warren,11,6659,29219
2021-03-15,MO,Warren,196,6855,29219
2021-03-16,MO,Warren,292,7147,29219
2021-03-17,MO,Warren,179,7326,29219
2021-03-18,MO,Warren,196,7522,29219
2021-03-19,MO,Warren,155,7677,29219
2021-03-20,MO,Warren,154,7831,29219
2021-03-21,MO,Warren,49,7880,29219
2021-03-22,MO,Warren,173,8053,29219
2021-03-23,MO,Warren,368,8421,29219
2021-03-24,MO,Warren,232,8653,29219
2021-03-25,MO,Warren,225,8878,29219
2021-03-26,MO,Warren,219,9097,29219
2021-03-27,MO,Warren,125,9222,29219
2021-03-28,MO,Warren,33,9255,29219
2021-03-29,MO,Warren,268,9523,29219
2021-03-30,MO,Warren,383,9906,29219
2021-03-31,MO,Warren,315,10221,29219
2021-04-01,MO,Warren,298,10519,29219
2021-04-02,MO,Warren,285,10804,29219
2021-04-03,MO,Warren,121,10925,29219
2021-04-04,MO,Warren,20,10945,29219
2021-04-05,MO,Warren,306,11251,29219
2021-04-06,MO,Warren,309,11560,29219
2021-04-07,MO,Warren,248,11808,29219
2021-04-08,MO,Warren,348,12156,29219
2021-04-09,MO,Warren,337,12493,29219
2021-04-10,MO,Warren,143,12636,29219
2021-04-11,MO,Warren,46,12682,29219
2021-04-12,MO,Warren,328,13010,29219
2021-04-13,MO,Warren,320,13330,29219
2021-04-14,MO,Warren,229,13559,29219
2021-04-15,MO,Warren,188,13747,29219
2021-04-16,MO,Warren,279,14026,29219
2021-04-17,MO,Warren,143,14169,29219
2021-04-18,MO,Warren,118,14287,29219
2021-04-19,MO,Warren,187,14474,29219
2021-04-20,MO,Warren,297,14771,29219
2021-04-21,MO,Warren,201,14972,29219
2021-04-22,MO,Warren,153,15125,29219
2021-04-23,MO,Warren,141,15266,29219
2021-04-24,MO,Warren,97,15363,29219
2021-04-25,MO,Warren,22,15385,29219
2020-12-16,MO,Washington,4,4,29221
2020-12-17,MO,Washington,6,10,29221
2020-12-18,MO,Washington,9,19,29221
2020-12-19,MO,Washington,2,21,29221
2020-12-20,MO,Washington,1,22,29221
2020-12-21,MO,Washington,8,30,29221
2020-12-22,MO,Washington,22,52,29221
2020-12-23,MO,Washington,40,92,29221
2020-12-27,MO,Washington,1,93,29221
2020-12-28,MO,Washington,23,116,29221
2020-12-29,MO,Washington,8,124,29221
2020-12-30,MO,Washington,51,175,29221
2020-12-31,MO,Washington,12,187,29221
2021-01-01,MO,Washington,1,188,29221
2021-01-02,MO,Washington,8,196,29221
2021-01-03,MO,Washington,1,197,29221
2021-01-04,MO,Washington,33,230,29221
2021-01-05,MO,Washington,18,248,29221
2021-01-06,MO,Washington,6,254,29221
2021-01-07,MO,Washington,11,265,29221
2021-01-08,MO,Washington,20,285,29221
2021-01-09,MO,Washington,7,292,29221
2021-01-11,MO,Washington,15,307,29221
2021-01-12,MO,Washington,6,313,29221
2021-01-13,MO,Washington,21,334,29221
2021-01-14,MO,Washington,21,355,29221
2021-01-15,MO,Washington,12,367,29221
2021-01-16,MO,Washington,2,369,29221
2021-01-17,MO,Washington,3,372,29221
2021-01-18,MO,Washington,11,383,29221
2021-01-19,MO,Washington,33,416,29221
2021-01-20,MO,Washington,33,449,29221
2021-01-21,MO,Washington,29,478,29221
2021-01-22,MO,Washington,41,519,29221
2021-01-23,MO,Washington,4,523,29221
2021-01-24,MO,Washington,1,524,29221
2021-01-25,MO,Washington,101,625,29221
2021-01-26,MO,Washington,70,695,29221
2021-01-27,MO,Washington,95,790,29221
2021-01-28,MO,Washington,309,1099,29221
2021-01-29,MO,Washington,354,1453,29221
2021-01-30,MO,Washington,7,1460,29221
2021-02-01,MO,Washington,74,1534,29221
2021-02-02,MO,Washington,45,1579,29221
2021-02-03,MO,Washington,72,1651,29221
2021-02-04,MO,Washington,128,1779,29221
2021-02-05,MO,Washington,71,1850,29221
2021-02-06,MO,Washington,16,1866,29221
2021-02-07,MO,Washington,3,1869,29221
2021-02-08,MO,Washington,49,1918,29221
2021-02-09,MO,Washington,42,1960,29221
2021-02-10,MO,Washington,29,1989,29221
2021-02-11,MO,Washington,39,2028,29221
2021-02-12,MO,Washington,40,2068,29221
2021-02-13,MO,Washington,14,2082,29221
2021-02-14,MO,Washington,3,2085,29221
2021-02-15,MO,Washington,10,2095,29221
2021-02-16,MO,Washington,19,2114,29221
2021-02-17,MO,Washington,22,2136,29221
2021-02-18,MO,Washington,50,2186,29221
2021-02-19,MO,Washington,28,2214,29221
2021-02-20,MO,Washington,9,2223,29221
2021-02-22,MO,Washington,88,2311,29221
2021-02-23,MO,Washington,64,2375,29221
2021-02-24,MO,Washington,117,2492,29221
2021-02-25,MO,Washington,302,2794,29221
2021-02-26,MO,Washington,358,3152,29221
2021-02-27,MO,Washington,18,3170,29221
2021-02-28,MO,Washington,2,3172,29221
2021-03-01,MO,Washington,266,3438,29221
2021-03-02,MO,Washington,106,3544,29221
2021-03-03,MO,Washington,113,3657,29221
2021-03-04,MO,Washington,128,3785,29221
2021-03-05,MO,Washington,69,3854,29221
2021-03-06,MO,Washington,11,3865,29221
2021-03-07,MO,Washington,2,3867,29221
2021-03-08,MO,Washington,88,3955,29221
2021-03-09,MO,Washington,102,4057,29221
2021-03-10,MO,Washington,53,4110,29221
2021-03-11,MO,Washington,42,4152,29221
2021-03-12,MO,Washington,41,4193,29221
2021-03-13,MO,Washington,12,4205,29221
2021-03-14,MO,Washington,3,4208,29221
2021-03-15,MO,Washington,89,4297,29221
2021-03-16,MO,Washington,94,4391,29221
2021-03-17,MO,Washington,70,4461,29221
2021-03-18,MO,Washington,63,4524,29221
2021-03-19,MO,Washington,82,4606,29221
2021-03-20,MO,Washington,14,4620,29221
2021-03-21,MO,Washington,11,4631,29221
2021-03-22,MO,Washington,49,4680,29221
2021-03-23,MO,Washington,45,4725,29221
2021-03-24,MO,Washington,290,5015,29221
2021-03-25,MO,Washington,65,5080,29221
2021-03-26,MO,Washington,72,5152,29221
2021-03-27,MO,Washington,12,5164,29221
2021-03-28,MO,Washington,9,5173,29221
2021-03-29,MO,Washington,60,5233,29221
2021-03-30,MO,Washington,224,5457,29221
2021-03-31,MO,Washington,113,5570,29221
2021-04-01,MO,Washington,111,5681,29221
2021-04-02,MO,Washington,34,5715,29221
2021-04-03,MO,Washington,7,5722,29221
2021-04-04,MO,Washington,11,5733,29221
2021-04-05,MO,Washington,83,5816,29221
2021-04-06,MO,Washington,111,5927,29221
2021-04-07,MO,Washington,80,6007,29221
2021-04-08,MO,Washington,103,6110,29221
2021-04-09,MO,Washington,106,6216,29221
2021-04-10,MO,Washington,36,6252,29221
2021-04-11,MO,Washington,6,6258,29221
2021-04-12,MO,Washington,107,6365,29221
2021-04-13,MO,Washington,102,6467,29221
2021-04-14,MO,Washington,71,6538,29221
2021-04-15,MO,Washington,81,6619,29221
2021-04-16,MO,Washington,140,6759,29221
2021-04-17,MO,Washington,16,6775,29221
2021-04-18,MO,Washington,13,6788,29221
2021-04-19,MO,Washington,45,6833,29221
2021-04-20,MO,Washington,127,6960,29221
2021-04-21,MO,Washington,263,7223,29221
2021-04-22,MO,Washington,50,7273,29221
2021-04-23,MO,Washington,32,7305,29221
2021-04-24,MO,Washington,16,7321,29221
2021-04-25,MO,Washington,18,7339,29221
2020-12-18,MO,Wayne,1,1,29223
2020-12-21,MO,Wayne,2,3,29223
2020-12-22,MO,Wayne,3,6,29223
2020-12-23,MO,Wayne,17,23,29223
2020-12-28,MO,Wayne,2,25,29223
2020-12-29,MO,Wayne,5,30,29223
2020-12-30,MO,Wayne,7,37,29223
2020-12-31,MO,Wayne,17,54,29223
2021-01-02,MO,Wayne,1,55,29223
2021-01-04,MO,Wayne,3,58,29223
2021-01-05,MO,Wayne,31,89,29223
2021-01-06,MO,Wayne,6,95,29223
2021-01-07,MO,Wayne,9,104,29223
2021-01-08,MO,Wayne,6,110,29223
2021-01-09,MO,Wayne,3,113,29223
2021-01-11,MO,Wayne,3,116,29223
2021-01-12,MO,Wayne,6,122,29223
2021-01-13,MO,Wayne,13,135,29223
2021-01-14,MO,Wayne,25,160,29223
2021-01-15,MO,Wayne,6,166,29223
2021-01-16,MO,Wayne,1,167,29223
2021-01-18,MO,Wayne,9,176,29223
2021-01-19,MO,Wayne,9,185,29223
2021-01-20,MO,Wayne,43,228,29223
2021-01-21,MO,Wayne,60,288,29223
2021-01-22,MO,Wayne,190,478,29223
2021-01-23,MO,Wayne,28,506,29223
2021-01-24,MO,Wayne,3,509,29223
2021-01-25,MO,Wayne,14,523,29223
2021-01-26,MO,Wayne,49,572,29223
2021-01-27,MO,Wayne,18,590,29223
2021-01-28,MO,Wayne,48,638,29223
2021-01-29,MO,Wayne,81,719,29223
2021-01-30,MO,Wayne,1,720,29223
2021-02-01,MO,Wayne,22,742,29223
2021-02-02,MO,Wayne,24,766,29223
2021-02-03,MO,Wayne,32,798,29223
2021-02-04,MO,Wayne,52,850,29223
2021-02-05,MO,Wayne,62,912,29223
2021-02-06,MO,Wayne,101,1013,29223
2021-02-08,MO,Wayne,13,1026,29223
2021-02-09,MO,Wayne,92,1118,29223
2021-02-10,MO,Wayne,18,1136,29223
2021-02-11,MO,Wayne,14,1150,29223
2021-02-12,MO,Wayne,197,1347,29223
2021-02-13,MO,Wayne,6,1353,29223
2021-02-14,MO,Wayne,1,1354,29223
2021-02-15,MO,Wayne,12,1366,29223
2021-02-16,MO,Wayne,22,1388,29223
2021-02-17,MO,Wayne,20,1408,29223
2021-02-18,MO,Wayne,28,1436,29223
2021-02-19,MO,Wayne,65,1501,29223
2021-02-20,MO,Wayne,9,1510,29223
2021-02-21,MO,Wayne,48,1558,29223
2021-02-22,MO,Wayne,30,1588,29223
2021-02-23,MO,Wayne,43,1631,29223
2021-02-24,MO,Wayne,337,1968,29223
2021-02-25,MO,Wayne,42,2010,29223
2021-02-26,MO,Wayne,78,2088,29223
2021-02-27,MO,Wayne,9,2097,29223
2021-02-28,MO,Wayne,4,2101,29223
2021-03-01,MO,Wayne,189,2290,29223
2021-03-02,MO,Wayne,51,2341,29223
2021-03-03,MO,Wayne,77,2418,29223
2021-03-04,MO,Wayne,56,2474,29223
2021-03-05,MO,Wayne,90,2564,29223
2021-03-06,MO,Wayne,99,2663,29223
2021-03-08,MO,Wayne,37,2700,29223
2021-03-09,MO,Wayne,61,2761,29223
2021-03-10,MO,Wayne,45,2806,29223
2021-03-11,MO,Wayne,25,2831,29223
2021-03-12,MO,Wayne,36,2867,29223
2021-03-13,MO,Wayne,10,2877,29223
2021-03-14,MO,Wayne,6,2883,29223
2021-03-15,MO,Wayne,54,2937,29223
2021-03-16,MO,Wayne,40,2977,29223
2021-03-17,MO,Wayne,69,3046,29223
2021-03-18,MO,Wayne,78,3124,29223
2021-03-19,MO,Wayne,122,3246,29223
2021-03-20,MO,Wayne,1,3247,29223
2021-03-21,MO,Wayne,5,3252,29223
2021-03-22,MO,Wayne,28,3280,29223
2021-03-23,MO,Wayne,36,3316,29223
2021-03-24,MO,Wayne,455,3771,29223
2021-03-25,MO,Wayne,45,3816,29223
2021-03-26,MO,Wayne,25,3841,29223
2021-03-27,MO,Wayne,1,3842,29223
2021-03-28,MO,Wayne,4,3846,29223
2021-03-29,MO,Wayne,245,4091,29223
2021-03-30,MO,Wayne,71,4162,29223
2021-03-31,MO,Wayne,66,4228,29223
2021-04-01,MO,Wayne,46,4274,29223
2021-04-02,MO,Wayne,67,4341,29223
2021-04-03,MO,Wayne,3,4344,29223
2021-04-04,MO,Wayne,11,4355,29223
2021-04-05,MO,Wayne,39,4394,29223
2021-04-06,MO,Wayne,46,4440,29223
2021-04-07,MO,Wayne,43,4483,29223
2021-04-08,MO,Wayne,27,4510,29223
2021-04-09,MO,Wayne,114,4624,29223
2021-04-10,MO,Wayne,8,4632,29223
2021-04-11,MO,Wayne,5,4637,29223
2021-04-12,MO,Wayne,42,4679,29223
2021-04-13,MO,Wayne,35,4714,29223
2021-04-14,MO,Wayne,68,4782,29223
2021-04-15,MO,Wayne,23,4805,29223
2021-04-16,MO,Wayne,44,4849,29223
2021-04-17,MO,Wayne,2,4851,29223
2021-04-18,MO,Wayne,10,4861,29223
2021-04-19,MO,Wayne,88,4949,29223
2021-04-20,MO,Wayne,19,4968,29223
2021-04-21,MO,Wayne,186,5154,29223
2021-04-22,MO,Wayne,36,5190,29223
2021-04-23,MO,Wayne,25,5215,29223
2021-04-24,MO,Wayne,8,5223,29223
2021-04-25,MO,Wayne,6,5229,29223
2020-12-14,MO,Webster,2,2,29225
2020-12-15,MO,Webster,2,4,29225
2020-12-16,MO,Webster,41,45,29225
2020-12-17,MO,Webster,30,75,29225
2020-12-18,MO,Webster,30,105,29225
2020-12-19,MO,Webster,9,114,29225
2020-12-20,MO,Webster,4,118,29225
2020-12-21,MO,Webster,33,151,29225
2020-12-22,MO,Webster,73,224,29225
2020-12-23,MO,Webster,69,293,29225
2020-12-24,MO,Webster,34,327,29225
2020-12-26,MO,Webster,26,353,29225
2020-12-27,MO,Webster,13,366,29225
2020-12-28,MO,Webster,55,421,29225
2020-12-29,MO,Webster,51,472,29225
2020-12-30,MO,Webster,47,519,29225
2020-12-31,MO,Webster,54,573,29225
2021-01-02,MO,Webster,12,585,29225
2021-01-03,MO,Webster,1,586,29225
2021-01-04,MO,Webster,64,650,29225
2021-01-05,MO,Webster,45,695,29225
2021-01-06,MO,Webster,53,748,29225
2021-01-07,MO,Webster,15,763,29225
2021-01-08,MO,Webster,67,830,29225
2021-01-09,MO,Webster,13,843,29225
2021-01-10,MO,Webster,5,848,29225
2021-01-11,MO,Webster,59,907,29225
2021-01-12,MO,Webster,73,980,29225
2021-01-13,MO,Webster,58,1038,29225
2021-01-14,MO,Webster,42,1080,29225
2021-01-15,MO,Webster,165,1245,29225
2021-01-16,MO,Webster,29,1274,29225
2021-01-17,MO,Webster,5,1279,29225
2021-01-18,MO,Webster,101,1380,29225
2021-01-19,MO,Webster,94,1474,29225
2021-01-20,MO,Webster,96,1570,29225
2021-01-21,MO,Webster,138,1708,29225
2021-01-22,MO,Webster,344,2052,29225
2021-01-23,MO,Webster,33,2085,29225
2021-01-24,MO,Webster,12,2097,29225
2021-01-25,MO,Webster,163,2260,29225
2021-01-26,MO,Webster,298,2558,29225
2021-01-27,MO,Webster,141,2699,29225
2021-01-28,MO,Webster,163,2862,29225
2021-01-29,MO,Webster,116,2978,29225
2021-01-30,MO,Webster,52,3030,29225
2021-01-31,MO,Webster,1,3031,29225
2021-02-01,MO,Webster,123,3154,29225
2021-02-02,MO,Webster,65,3219,29225
2021-02-03,MO,Webster,120,3339,29225
2021-02-04,MO,Webster,54,3393,29225
2021-02-05,MO,Webster,376,3769,29225
2021-02-06,MO,Webster,152,3921,29225
2021-02-07,MO,Webster,2,3923,29225
2021-02-08,MO,Webster,118,4041,29225
2021-02-09,MO,Webster,96,4137,29225
2021-02-10,MO,Webster,62,4199,29225
2021-02-11,MO,Webster,254,4453,29225
2021-02-12,MO,Webster,609,5062,29225
2021-02-13,MO,Webster,69,5131,29225
2021-02-14,MO,Webster,33,5164,29225
2021-02-15,MO,Webster,66,5230,29225
2021-02-16,MO,Webster,73,5303,29225
2021-02-17,MO,Webster,67,5370,29225
2021-02-18,MO,Webster,100,5470,29225
2021-02-19,MO,Webster,250,5720,29225
2021-02-20,MO,Webster,8,5728,29225
2021-02-21,MO,Webster,2,5730,29225
2021-02-22,MO,Webster,71,5801,29225
2021-02-23,MO,Webster,214,6015,29225
2021-02-24,MO,Webster,131,6146,29225
2021-02-25,MO,Webster,138,6284,29225
2021-02-26,MO,Webster,460,6744,29225
2021-02-27,MO,Webster,229,6973,29225
2021-02-28,MO,Webster,20,6993,29225
2021-03-01,MO,Webster,225,7218,29225
2021-03-02,MO,Webster,99,7317,29225
2021-03-03,MO,Webster,222,7539,29225
2021-03-04,MO,Webster,409,7948,29225
2021-03-05,MO,Webster,391,8339,29225
2021-03-06,MO,Webster,172,8511,29225
2021-03-07,MO,Webster,14,8525,29225
2021-03-08,MO,Webster,172,8697,29225
2021-03-09,MO,Webster,283,8980,29225
2021-03-10,MO,Webster,130,9110,29225
2021-03-11,MO,Webster,410,9520,29225
2021-03-12,MO,Webster,381,9901,29225
2021-03-13,MO,Webster,71,9972,29225
2021-03-14,MO,Webster,23,9995,29225
2021-03-15,MO,Webster,194,10189,29225
2021-03-16,MO,Webster,164,10353,29225
2021-03-17,MO,Webster,156,10509,29225
2021-03-18,MO,Webster,211,10720,29225
2021-03-19,MO,Webster,412,11132,29225
2021-03-20,MO,Webster,73,11205,29225
2021-03-21,MO,Webster,37,11242,29225
2021-03-22,MO,Webster,296,11538,29225
2021-03-23,MO,Webster,257,11795,29225
2021-03-24,MO,Webster,174,11969,29225
2021-03-25,MO,Webster,168,12137,29225
2021-03-26,MO,Webster,494,12631,29225
2021-03-27,MO,Webster,130,12761,29225
2021-03-28,MO,Webster,25,12786,29225
2021-03-29,MO,Webster,187,12973,29225
2021-03-30,MO,Webster,180,13153,29225
2021-03-31,MO,Webster,210,13363,29225
2021-04-01,MO,Webster,320,13683,29225
2021-04-02,MO,Webster,367,14050,29225
2021-04-03,MO,Webster,170,14220,29225
2021-04-04,MO,Webster,37,14257,29225
2021-04-05,MO,Webster,352,14609,29225
2021-04-06,MO,Webster,340,14949,29225
2021-04-07,MO,Webster,194,15143,29225
2021-04-08,MO,Webster,406,15549,29225
2021-04-09,MO,Webster,436,15985,29225
2021-04-10,MO,Webster,153,16138,29225
2021-04-11,MO,Webster,28,16166,29225
2021-04-12,MO,Webster,230,16396,29225
2021-04-13,MO,Webster,233,16629,29225
2021-04-14,MO,Webster,169,16798,29225
2021-04-15,MO,Webster,134,16932,29225
2021-04-16,MO,Webster,370,17302,29225
2021-04-17,MO,Webster,55,17357,29225
2021-04-18,MO,Webster,21,17378,29225
2021-04-19,MO,Webster,261,17639,29225
2021-04-20,MO,Webster,180,17819,29225
2021-04-21,MO,Webster,93,17912,29225
2021-04-22,MO,Webster,136,18048,29225
2021-04-23,MO,Webster,94,18142,29225
2021-04-24,MO,Webster,101,18243,29225
2021-04-25,MO,Webster,10,18253,29225
2020-12-17,MO,Worth,1,1,29227
2020-12-22,MO,Worth,3,4,29227
2020-12-27,MO,Worth,1,5,29227
2020-12-28,MO,Worth,4,9,29227
2020-12-29,MO,Worth,1,10,29227
2021-01-03,MO,Worth,19,29,29227
2021-01-04,MO,Worth,6,35,29227
2021-01-05,MO,Worth,1,36,29227
2021-01-06,MO,Worth,1,37,29227
2021-01-07,MO,Worth,1,38,29227
2021-01-08,MO,Worth,1,39,29227
2021-01-11,MO,Worth,1,40,29227
2021-01-12,MO,Worth,15,55,29227
2021-01-13,MO,Worth,1,56,29227
2021-01-14,MO,Worth,2,58,29227
2021-01-15,MO,Worth,1,59,29227
2021-01-20,MO,Worth,15,74,29227
2021-01-21,MO,Worth,6,80,29227
2021-01-22,MO,Worth,15,95,29227
2021-01-25,MO,Worth,1,96,29227
2021-01-26,MO,Worth,2,98,29227
2021-01-27,MO,Worth,11,109,29227
2021-01-28,MO,Worth,7,116,29227
2021-01-29,MO,Worth,4,120,29227
2021-01-30,MO,Worth,2,122,29227
2021-02-01,MO,Worth,109,231,29227
2021-02-02,MO,Worth,13,244,29227
2021-02-03,MO,Worth,42,286,29227
2021-02-04,MO,Worth,22,308,29227
2021-02-05,MO,Worth,8,316,29227
2021-02-09,MO,Worth,11,327,29227
2021-02-10,MO,Worth,10,337,29227
2021-02-11,MO,Worth,105,442,29227
2021-02-12,MO,Worth,13,455,29227
2021-02-13,MO,Worth,1,456,29227
2021-02-15,MO,Worth,3,459,29227
2021-02-17,MO,Worth,5,464,29227
2021-02-18,MO,Worth,7,471,29227
2021-02-19,MO,Worth,9,480,29227
2021-02-22,MO,Worth,107,587,29227
2021-02-23,MO,Worth,5,592,29227
2021-02-24,MO,Worth,12,604,29227
2021-02-25,MO,Worth,5,609,29227
2021-02-26,MO,Worth,36,645,29227
2021-02-27,MO,Worth,20,665,29227
2021-03-01,MO,Worth,1,666,29227
2021-03-02,MO,Worth,6,672,29227
2021-03-03,MO,Worth,8,680,29227
2021-03-04,MO,Worth,88,768,29227
2021-03-05,MO,Worth,7,775,29227
2021-03-06,MO,Worth,5,780,29227
2021-03-08,MO,Worth,1,781,29227
2021-03-10,MO,Worth,18,799,29227
2021-03-11,MO,Worth,5,804,29227
2021-03-12,MO,Worth,24,828,29227
2021-03-13,MO,Worth,1,829,29227
2021-03-15,MO,Worth,19,848,29227
2021-03-16,MO,Worth,3,851,29227
2021-03-17,MO,Worth,7,858,29227
2021-03-18,MO,Worth,12,870,29227
2021-03-19,MO,Worth,8,878,29227
2021-03-22,MO,Worth,3,881,29227
2021-03-23,MO,Worth,1,882,29227
2021-03-24,MO,Worth,10,892,29227
2021-03-25,MO,Worth,4,896,29227
2021-03-26,MO,Worth,20,916,29227
2021-03-27,MO,Worth,2,918,29227
2021-03-30,MO,Worth,3,921,29227
2021-03-31,MO,Worth,8,929,29227
2021-04-01,MO,Worth,1,930,29227
2021-04-02,MO,Worth,16,946,29227
2021-04-06,MO,Worth,1,947,29227
2021-04-07,MO,Worth,4,951,29227
2021-04-08,MO,Worth,8,959,29227
2021-04-09,MO,Worth,20,979,29227
2021-04-10,MO,Worth,1,980,29227
2021-04-11,MO,Worth,1,981,29227
2021-04-12,MO,Worth,11,992,29227
2021-04-13,MO,Worth,2,994,29227
2021-04-14,MO,Worth,6,1000,29227
2021-04-15,MO,Worth,8,1008,29227
2021-04-16,MO,Worth,2,1010,29227
2021-04-20,MO,Worth,2,1012,29227
2021-04-21,MO,Worth,1,1013,29227
2021-04-22,MO,Worth,16,1029,29227
2021-04-23,MO,Worth,7,1036,29227
2021-04-24,MO,Worth,1,1037,29227
2020-12-16,MO,Wright,10,10,29229
2020-12-17,MO,Wright,1,11,29229
2020-12-20,MO,Wright,1,12,29229
2020-12-21,MO,Wright,3,15,29229
2020-12-22,MO,Wright,10,25,29229
2020-12-23,MO,Wright,20,45,29229
2020-12-24,MO,Wright,4,49,29229
2020-12-26,MO,Wright,7,56,29229
2020-12-27,MO,Wright,1,57,29229
2020-12-28,MO,Wright,5,62,29229
2020-12-29,MO,Wright,33,95,29229
2020-12-30,MO,Wright,51,146,29229
2020-12-31,MO,Wright,4,150,29229
2021-01-01,MO,Wright,1,151,29229
2021-01-02,MO,Wright,7,158,29229
2021-01-04,MO,Wright,7,165,29229
2021-01-05,MO,Wright,7,172,29229
2021-01-06,MO,Wright,21,193,29229
2021-01-07,MO,Wright,31,224,29229
2021-01-08,MO,Wright,14,238,29229
2021-01-09,MO,Wright,2,240,29229
2021-01-10,MO,Wright,1,241,29229
2021-01-11,MO,Wright,8,249,29229
2021-01-12,MO,Wright,9,258,29229
2021-01-13,MO,Wright,9,267,29229
2021-01-14,MO,Wright,7,274,29229
2021-01-15,MO,Wright,15,289,29229
2021-01-16,MO,Wright,5,294,29229
2021-01-17,MO,Wright,3,297,29229
2021-01-18,MO,Wright,10,307,29229
2021-01-19,MO,Wright,31,338,29229
2021-01-20,MO,Wright,18,356,29229
2021-01-21,MO,Wright,12,368,29229
2021-01-22,MO,Wright,30,398,29229
2021-01-23,MO,Wright,38,436,29229
2021-01-25,MO,Wright,19,455,29229
2021-01-26,MO,Wright,27,482,29229
2021-01-27,MO,Wright,105,587,29229
2021-01-28,MO,Wright,46,633,29229
2021-01-29,MO,Wright,86,719,29229
2021-01-30,MO,Wright,17,736,29229
2021-02-01,MO,Wright,16,752,29229
2021-02-02,MO,Wright,18,770,29229
2021-02-03,MO,Wright,102,872,29229
2021-02-04,MO,Wright,80,952,29229
2021-02-05,MO,Wright,105,1057,29229
2021-02-06,MO,Wright,73,1130,29229
2021-02-07,MO,Wright,1,1131,29229
2021-02-08,MO,Wright,26,1157,29229
2021-02-09,MO,Wright,110,1267,29229
2021-02-10,MO,Wright,72,1339,29229
2021-02-11,MO,Wright,71,1410,29229
2021-02-12,MO,Wright,98,1508,29229
2021-02-13,MO,Wright,107,1615,29229
2021-02-14,MO,Wright,2,1617,29229
2021-02-15,MO,Wright,3,1620,29229
2021-02-16,MO,Wright,28,1648,29229
2021-02-17,MO,Wright,5,1653,29229
2021-02-18,MO,Wright,20,1673,29229
2021-02-19,MO,Wright,67,1740,29229
2021-02-20,MO,Wright,1,1741,29229
2021-02-21,MO,Wright,5,1746,29229
2021-02-22,MO,Wright,20,1766,29229
2021-02-23,MO,Wright,86,1852,29229
2021-02-24,MO,Wright,157,2009,29229
2021-02-25,MO,Wright,50,2059,29229
2021-02-26,MO,Wright,99,2158,29229
2021-02-27,MO,Wright,182,2340,29229
2021-02-28,MO,Wright,3,2343,29229
2021-03-01,MO,Wright,32,2375,29229
2021-03-02,MO,Wright,129,2504,29229
2021-03-03,MO,Wright,166,2670,29229
2021-03-04,MO,Wright,124,2794,29229
2021-03-05,MO,Wright,71,2865,29229
2021-03-06,MO,Wright,33,2898,29229
2021-03-07,MO,Wright,9,2907,29229
2021-03-08,MO,Wright,64,2971,29229
2021-03-09,MO,Wright,137,3108,29229
2021-03-10,MO,Wright,103,3211,29229
2021-03-11,MO,Wright,72,3283,29229
2021-03-12,MO,Wright,64,3347,29229
2021-03-13,MO,Wright,103,3450,29229
2021-03-14,MO,Wright,1,3451,29229
2021-03-15,MO,Wright,53,3504,29229
2021-03-16,MO,Wright,167,3671,29229
2021-03-17,MO,Wright,94,3765,29229
2021-03-18,MO,Wright,74,3839,29229
2021-03-19,MO,Wright,120,3959,29229
2021-03-20,MO,Wright,13,3972,29229
2021-03-21,MO,Wright,5,3977,29229
2021-03-22,MO,Wright,47,4024,29229
2021-03-23,MO,Wright,72,4096,29229
2021-03-24,MO,Wright,169,4265,29229
2021-03-25,MO,Wright,109,4374,29229
2021-03-26,MO,Wright,103,4477,29229
2021-03-27,MO,Wright,152,4629,29229
2021-03-28,MO,Wright,12,4641,29229
2021-03-29,MO,Wright,29,4670,29229
2021-03-30,MO,Wright,99,4769,29229
2021-03-31,MO,Wright,92,4861,29229
2021-04-01,MO,Wright,104,4965,29229
2021-04-02,MO,Wright,41,5006,29229
2021-04-03,MO,Wright,24,5030,29229
2021-04-04,MO,Wright,1,5031,29229
2021-04-05,MO,Wright,39,5070,29229
2021-04-06,MO,Wright,84,5154,29229
2021-04-07,MO,Wright,137,5291,29229
2021-04-08,MO,Wright,90,5381,29229
2021-04-09,MO,Wright,142,5523,29229
2021-04-10,MO,Wright,62,5585,29229
2021-04-11,MO,Wright,16,5601,29229
2021-04-12,MO,Wright,88,5689,29229
2021-04-13,MO,Wright,173,5862,29229
2021-04-14,MO,Wright,107,5969,29229
2021-04-15,MO,Wright,52,6021,29229
2021-04-16,MO,Wright,66,6087,29229
2021-04-17,MO,Wright,15,6102,29229
2021-04-18,MO,Wright,1,6103,29229
2021-04-19,MO,Wright,34,6137,29229
2021-04-20,MO,Wright,61,6198,29229
2021-04-21,MO,Wright,46,6244,29229
2021-04-22,MO,Wright,46,6290,29229
2021-04-23,MO,Wright,64,6354,29229
2021-04-24,MO,Wright,25,6379,29229
2021-04-25,MO,Wright,13,6392,29229
