date,state,county,new doses,cumulative doses,fips
2020-12-14,MO,Adair,1,1,29001
2020-12-15,MO,Adair,4,5,29001
2020-12-16,MO,Adair,8,13,29001
2020-12-17,MO,Adair,16,29,29001
2020-12-18,MO,Adair,13,42,29001
2020-12-19,MO,Adair,3,45,29001
2020-12-20,MO,Adair,1,46,29001
2020-12-21,MO,Adair,444,490,29001
2020-12-22,MO,Adair,11,501,29001
2020-12-23,MO,Adair,368,869,29001
2020-12-24,MO,Adair,1,870,29001
2020-12-26,MO,Adair,1,871,29001
2020-12-27,MO,Adair,3,874,29001
2020-12-28,MO,Adair,13,887,29001
2020-12-29,MO,Adair,7,894,29001
2020-12-30,MO,Adair,12,906,29001
2020-12-31,MO,Adair,7,913,29001
2021-01-02,MO,Adair,1,914,29001
2021-01-03,MO,Adair,3,917,29001
2021-01-04,MO,Adair,15,932,29001
2021-01-05,MO,Adair,8,940,29001
2021-01-06,MO,Adair,15,955,29001
2021-01-07,MO,Adair,10,965,29001
2021-01-08,MO,Adair,15,980,29001
2021-01-09,MO,Adair,18,998,29001
2021-01-10,MO,Adair,3,1001,29001
2021-01-11,MO,Adair,492,1493,29001
2021-01-12,MO,Adair,11,1504,29001
2021-01-13,MO,Adair,369,1873,29001
2021-01-14,MO,Adair,132,2005,29001
2021-01-15,MO,Adair,46,2051,29001
2021-01-16,MO,Adair,3,2054,29001
2021-01-17,MO,Adair,2,2056,29001
2021-01-18,MO,Adair,22,2078,29001
2021-01-19,MO,Adair,20,2098,29001
2021-01-20,MO,Adair,21,2119,29001
2021-01-21,MO,Adair,31,2150,29001
2021-01-22,MO,Adair,42,2192,29001
2021-01-23,MO,Adair,3,2195,29001
2021-01-24,MO,Adair,5,2200,29001
2021-01-25,MO,Adair,16,2216,29001
2021-01-26,MO,Adair,16,2232,29001
2021-01-27,MO,Adair,620,2852,29001
2021-01-28,MO,Adair,73,2925,29001
2021-01-29,MO,Adair,64,2989,29001
2021-01-30,MO,Adair,4,2993,29001
2021-02-01,MO,Adair,5,2998,29001
2021-02-02,MO,Adair,25,3023,29001
2021-02-03,MO,Adair,31,3054,29001
2021-02-04,MO,Adair,43,3097,29001
2021-02-05,MO,Adair,160,3257,29001
2021-02-06,MO,Adair,69,3326,29001
2021-02-08,MO,Adair,158,3484,29001
2021-02-09,MO,Adair,21,3505,29001
2021-02-10,MO,Adair,33,3538,29001
2021-02-11,MO,Adair,123,3661,29001
2021-02-12,MO,Adair,69,3730,29001
2021-02-13,MO,Adair,24,3754,29001
2021-02-14,MO,Adair,4,3758,29001
2021-02-15,MO,Adair,24,3782,29001
2021-02-16,MO,Adair,74,3856,29001
2021-02-17,MO,Adair,43,3899,29001
2021-02-18,MO,Adair,62,3961,29001
2021-02-19,MO,Adair,51,4012,29001
2021-02-20,MO,Adair,2,4014,29001
2021-02-21,MO,Adair,5,4019,29001
2021-02-22,MO,Adair,117,4136,29001
2021-02-23,MO,Adair,107,4243,29001
2021-02-24,MO,Adair,674,4917,29001
2021-02-25,MO,Adair,1359,6276,29001
2021-02-26,MO,Adair,155,6431,29001
2021-02-27,MO,Adair,87,6518,29001
2021-02-28,MO,Adair,50,6568,29001
2021-03-01,MO,Adair,116,6684,29001
2021-03-02,MO,Adair,77,6761,29001
2021-03-03,MO,Adair,113,6874,29001
2021-03-04,MO,Adair,148,7022,29001
2021-03-05,MO,Adair,268,7290,29001
2021-03-06,MO,Adair,82,7372,29001
2021-03-07,MO,Adair,23,7395,29001
2021-03-08,MO,Adair,103,7498,29001
2021-03-09,MO,Adair,56,7554,29001
2021-03-10,MO,Adair,45,7599,29001
2021-03-11,MO,Adair,101,7700,29001
2021-03-12,MO,Adair,194,7894,29001
2021-03-13,MO,Adair,36,7930,29001
2021-03-14,MO,Adair,19,7949,29001
2021-03-15,MO,Adair,117,8066,29001
2021-03-16,MO,Adair,257,8323,29001
2021-03-17,MO,Adair,172,8495,29001
2021-03-18,MO,Adair,155,8650,29001
2021-03-19,MO,Adair,276,8926,29001
2021-03-20,MO,Adair,107,9033,29001
2021-03-21,MO,Adair,55,9088,29001
2021-03-22,MO,Adair,178,9266,29001
2021-03-23,MO,Adair,85,9351,29001
2021-03-24,MO,Adair,89,9440,29001
2021-03-25,MO,Adair,1329,10769,29001
2021-03-26,MO,Adair,300,11069,29001
2021-03-27,MO,Adair,97,11166,29001
2021-03-28,MO,Adair,41,11207,29001
2021-03-29,MO,Adair,170,11377,29001
2021-03-30,MO,Adair,158,11535,29001
2021-03-31,MO,Adair,106,11641,29001
2021-04-01,MO,Adair,131,11772,29001
2021-04-02,MO,Adair,306,12078,29001
2021-04-03,MO,Adair,83,12161,29001
2021-04-04,MO,Adair,15,12176,29001
2021-04-05,MO,Adair,122,12298,29001
2021-04-06,MO,Adair,171,12469,29001
2021-04-07,MO,Adair,139,12608,29001
2021-04-08,MO,Adair,131,12739,29001
2021-04-09,MO,Adair,167,12906,29001
2021-04-10,MO,Adair,133,13039,29001
2021-04-11,MO,Adair,41,13080,29001
2021-04-12,MO,Adair,106,13186,29001
2021-04-13,MO,Adair,165,13351,29001
2021-04-14,MO,Adair,84,13435,29001
2021-04-15,MO,Adair,116,13551,29001
2021-04-16,MO,Adair,139,13690,29001
2021-04-17,MO,Adair,64,13754,29001
2021-04-18,MO,Adair,31,13785,29001
2021-04-19,MO,Adair,82,13867,29001
2021-04-20,MO,Adair,136,14003,29001
2021-04-21,MO,Adair,103,14106,29001
2021-04-22,MO,Adair,72,14178,29001
2021-04-23,MO,Adair,185,14363,29001
2021-04-24,MO,Adair,55,14418,29001
2021-04-25,MO,Adair,20,14438,29001
2021-04-26,MO,Adair,69,14507,29001
2021-04-27,MO,Adair,70,14577,29001
2021-04-28,MO,Adair,105,14682,29001
2021-04-29,MO,Adair,54,14736,29001
2021-04-30,MO,Adair,77,14813,29001
2021-05-01,MO,Adair,42,14855,29001
2021-05-02,MO,Adair,14,14869,29001
2021-05-03,MO,Adair,53,14922,29001
2021-05-04,MO,Adair,24,14946,29001
2021-05-05,MO,Adair,63,15009,29001
2021-05-06,MO,Adair,41,15050,29001
2021-05-07,MO,Adair,45,15095,29001
2021-05-08,MO,Adair,20,15115,29001
2021-05-09,MO,Adair,17,15132,29001
2021-05-10,MO,Adair,29,15161,29001
2021-05-11,MO,Adair,35,15196,29001
2021-05-12,MO,Adair,32,15228,29001
2021-05-13,MO,Adair,78,15306,29001
2021-05-14,MO,Adair,56,15362,29001
2021-05-15,MO,Adair,25,15387,29001
2021-05-16,MO,Adair,27,15414,29001
2021-05-17,MO,Adair,45,15459,29001
2021-05-18,MO,Adair,49,15508,29001
2021-05-19,MO,Adair,35,15543,29001
2021-05-20,MO,Adair,28,15571,29001
2021-05-21,MO,Adair,78,15649,29001
2021-05-22,MO,Adair,43,15692,29001
2021-05-23,MO,Adair,9,15701,29001
2021-05-24,MO,Adair,35,15736,29001
2021-05-25,MO,Adair,23,15759,29001
2021-05-26,MO,Adair,30,15789,29001
2021-05-27,MO,Adair,7,15796,29001
2020-12-18,MO,Andrew,2,2,29003
2020-12-21,MO,Andrew,1,3,29003
2020-12-22,MO,Andrew,17,20,29003
2020-12-23,MO,Andrew,36,56,29003
2020-12-24,MO,Andrew,1,57,29003
2020-12-27,MO,Andrew,35,92,29003
2020-12-28,MO,Andrew,66,158,29003
2020-12-29,MO,Andrew,42,200,29003
2020-12-30,MO,Andrew,13,213,29003
2020-12-31,MO,Andrew,17,230,29003
2021-01-01,MO,Andrew,1,231,29003
2021-01-02,MO,Andrew,3,234,29003
2021-01-03,MO,Andrew,18,252,29003
2021-01-04,MO,Andrew,51,303,29003
2021-01-05,MO,Andrew,46,349,29003
2021-01-06,MO,Andrew,26,375,29003
2021-01-07,MO,Andrew,4,379,29003
2021-01-08,MO,Andrew,9,388,29003
2021-01-09,MO,Andrew,2,390,29003
2021-01-10,MO,Andrew,1,391,29003
2021-01-11,MO,Andrew,4,395,29003
2021-01-12,MO,Andrew,13,408,29003
2021-01-13,MO,Andrew,113,521,29003
2021-01-14,MO,Andrew,37,558,29003
2021-01-15,MO,Andrew,32,590,29003
2021-01-16,MO,Andrew,5,595,29003
2021-01-17,MO,Andrew,9,604,29003
2021-01-18,MO,Andrew,7,611,29003
2021-01-19,MO,Andrew,10,621,29003
2021-01-20,MO,Andrew,73,694,29003
2021-01-21,MO,Andrew,52,746,29003
2021-01-22,MO,Andrew,44,790,29003
2021-01-23,MO,Andrew,5,795,29003
2021-01-25,MO,Andrew,36,831,29003
2021-01-26,MO,Andrew,67,898,29003
2021-01-27,MO,Andrew,65,963,29003
2021-01-28,MO,Andrew,88,1051,29003
2021-01-29,MO,Andrew,636,1687,29003
2021-01-30,MO,Andrew,4,1691,29003
2021-01-31,MO,Andrew,126,1817,29003
2021-02-01,MO,Andrew,32,1849,29003
2021-02-02,MO,Andrew,180,2029,29003
2021-02-03,MO,Andrew,101,2130,29003
2021-02-04,MO,Andrew,72,2202,29003
2021-02-05,MO,Andrew,85,2287,29003
2021-02-06,MO,Andrew,6,2293,29003
2021-02-07,MO,Andrew,4,2297,29003
2021-02-08,MO,Andrew,22,2319,29003
2021-02-09,MO,Andrew,27,2346,29003
2021-02-10,MO,Andrew,83,2429,29003
2021-02-11,MO,Andrew,138,2567,29003
2021-02-12,MO,Andrew,86,2653,29003
2021-02-13,MO,Andrew,19,2672,29003
2021-02-14,MO,Andrew,4,2676,29003
2021-02-15,MO,Andrew,18,2694,29003
2021-02-16,MO,Andrew,26,2720,29003
2021-02-17,MO,Andrew,36,2756,29003
2021-02-18,MO,Andrew,25,2781,29003
2021-02-19,MO,Andrew,26,2807,29003
2021-02-20,MO,Andrew,5,2812,29003
2021-02-21,MO,Andrew,2,2814,29003
2021-02-22,MO,Andrew,690,3504,29003
2021-02-23,MO,Andrew,34,3538,29003
2021-02-24,MO,Andrew,27,3565,29003
2021-02-25,MO,Andrew,66,3631,29003
2021-02-26,MO,Andrew,162,3793,29003
2021-02-27,MO,Andrew,7,3800,29003
2021-02-28,MO,Andrew,1,3801,29003
2021-03-01,MO,Andrew,82,3883,29003
2021-03-02,MO,Andrew,113,3996,29003
2021-03-03,MO,Andrew,92,4088,29003
2021-03-04,MO,Andrew,95,4183,29003
2021-03-05,MO,Andrew,106,4289,29003
2021-03-06,MO,Andrew,26,4315,29003
2021-03-07,MO,Andrew,3,4318,29003
2021-03-08,MO,Andrew,29,4347,29003
2021-03-09,MO,Andrew,139,4486,29003
2021-03-10,MO,Andrew,73,4559,29003
2021-03-11,MO,Andrew,54,4613,29003
2021-03-12,MO,Andrew,151,4764,29003
2021-03-13,MO,Andrew,22,4786,29003
2021-03-14,MO,Andrew,1,4787,29003
2021-03-15,MO,Andrew,55,4842,29003
2021-03-16,MO,Andrew,129,4971,29003
2021-03-17,MO,Andrew,71,5042,29003
2021-03-18,MO,Andrew,104,5146,29003
2021-03-19,MO,Andrew,88,5234,29003
2021-03-20,MO,Andrew,8,5242,29003
2021-03-21,MO,Andrew,1,5243,29003
2021-03-22,MO,Andrew,27,5270,29003
2021-03-23,MO,Andrew,56,5326,29003
2021-03-24,MO,Andrew,75,5401,29003
2021-03-25,MO,Andrew,78,5479,29003
2021-03-26,MO,Andrew,91,5570,29003
2021-03-27,MO,Andrew,18,5588,29003
2021-03-28,MO,Andrew,3,5591,29003
2021-03-29,MO,Andrew,46,5637,29003
2021-03-30,MO,Andrew,112,5749,29003
2021-03-31,MO,Andrew,72,5821,29003
2021-04-01,MO,Andrew,87,5908,29003
2021-04-02,MO,Andrew,157,6065,29003
2021-04-03,MO,Andrew,32,6097,29003
2021-04-05,MO,Andrew,36,6133,29003
2021-04-06,MO,Andrew,108,6241,29003
2021-04-07,MO,Andrew,95,6336,29003
2021-04-08,MO,Andrew,90,6426,29003
2021-04-09,MO,Andrew,126,6552,29003
2021-04-10,MO,Andrew,19,6571,29003
2021-04-11,MO,Andrew,3,6574,29003
2021-04-12,MO,Andrew,58,6632,29003
2021-04-13,MO,Andrew,102,6734,29003
2021-04-14,MO,Andrew,141,6875,29003
2021-04-15,MO,Andrew,90,6965,29003
2021-04-16,MO,Andrew,158,7123,29003
2021-04-17,MO,Andrew,7,7130,29003
2021-04-18,MO,Andrew,1,7131,29003
2021-04-19,MO,Andrew,17,7148,29003
2021-04-20,MO,Andrew,83,7231,29003
2021-04-21,MO,Andrew,27,7258,29003
2021-04-22,MO,Andrew,43,7301,29003
2021-04-23,MO,Andrew,72,7373,29003
2021-04-24,MO,Andrew,10,7383,29003
2021-04-25,MO,Andrew,1,7384,29003
2021-04-26,MO,Andrew,18,7402,29003
2021-04-27,MO,Andrew,56,7458,29003
2021-04-28,MO,Andrew,23,7481,29003
2021-04-29,MO,Andrew,60,7541,29003
2021-04-30,MO,Andrew,65,7606,29003
2021-05-01,MO,Andrew,8,7614,29003
2021-05-02,MO,Andrew,4,7618,29003
2021-05-03,MO,Andrew,21,7639,29003
2021-05-04,MO,Andrew,58,7697,29003
2021-05-05,MO,Andrew,26,7723,29003
2021-05-06,MO,Andrew,19,7742,29003
2021-05-07,MO,Andrew,78,7820,29003
2021-05-08,MO,Andrew,5,7825,29003
2021-05-09,MO,Andrew,5,7830,29003
2021-05-10,MO,Andrew,21,7851,29003
2021-05-11,MO,Andrew,43,7894,29003
2021-05-12,MO,Andrew,12,7906,29003
2021-05-13,MO,Andrew,11,7917,29003
2021-05-14,MO,Andrew,27,7944,29003
2021-05-15,MO,Andrew,9,7953,29003
2021-05-16,MO,Andrew,3,7956,29003
2021-05-17,MO,Andrew,13,7969,29003
2021-05-18,MO,Andrew,16,7985,29003
2021-05-19,MO,Andrew,17,8002,29003
2021-05-20,MO,Andrew,19,8021,29003
2021-05-21,MO,Andrew,42,8063,29003
2021-05-23,MO,Andrew,7,8070,29003
2021-05-24,MO,Andrew,13,8083,29003
2021-05-25,MO,Andrew,19,8102,29003
2021-05-26,MO,Andrew,4,8106,29003
2021-05-27,MO,Andrew,6,8112,29003
2020-12-16,MO,Atchison,1,1,29005
2020-12-17,MO,Atchison,1,2,29005
2020-12-22,MO,Atchison,2,4,29005
2020-12-23,MO,Atchison,32,36,29005
2020-12-27,MO,Atchison,1,37,29005
2020-12-28,MO,Atchison,54,91,29005
2020-12-30,MO,Atchison,2,93,29005
2020-12-31,MO,Atchison,41,134,29005
2021-01-02,MO,Atchison,8,142,29005
2021-01-03,MO,Atchison,1,143,29005
2021-01-05,MO,Atchison,1,144,29005
2021-01-06,MO,Atchison,1,145,29005
2021-01-07,MO,Atchison,6,151,29005
2021-01-08,MO,Atchison,1,152,29005
2021-01-11,MO,Atchison,37,189,29005
2021-01-12,MO,Atchison,3,192,29005
2021-01-13,MO,Atchison,4,196,29005
2021-01-14,MO,Atchison,1,197,29005
2021-01-15,MO,Atchison,2,199,29005
2021-01-19,MO,Atchison,8,207,29005
2021-01-20,MO,Atchison,38,245,29005
2021-01-21,MO,Atchison,2,247,29005
2021-01-26,MO,Atchison,3,250,29005
2021-01-27,MO,Atchison,2,252,29005
2021-01-28,MO,Atchison,151,403,29005
2021-01-29,MO,Atchison,150,553,29005
2021-01-31,MO,Atchison,7,560,29005
2021-02-01,MO,Atchison,1,561,29005
2021-02-02,MO,Atchison,8,569,29005
2021-02-03,MO,Atchison,202,771,29005
2021-02-04,MO,Atchison,161,932,29005
2021-02-05,MO,Atchison,1,933,29005
2021-02-06,MO,Atchison,10,943,29005
2021-02-08,MO,Atchison,93,1036,29005
2021-02-09,MO,Atchison,8,1044,29005
2021-02-10,MO,Atchison,2,1046,29005
2021-02-11,MO,Atchison,180,1226,29005
2021-02-13,MO,Atchison,2,1228,29005
2021-02-15,MO,Atchison,1,1229,29005
2021-02-17,MO,Atchison,9,1238,29005
2021-02-19,MO,Atchison,3,1241,29005
2021-02-22,MO,Atchison,103,1344,29005
2021-02-24,MO,Atchison,3,1347,29005
2021-02-25,MO,Atchison,259,1606,29005
2021-02-26,MO,Atchison,43,1649,29005
2021-02-28,MO,Atchison,1,1650,29005
2021-03-01,MO,Atchison,5,1655,29005
2021-03-02,MO,Atchison,6,1661,29005
2021-03-03,MO,Atchison,73,1734,29005
2021-03-04,MO,Atchison,198,1932,29005
2021-03-05,MO,Atchison,2,1934,29005
2021-03-06,MO,Atchison,12,1946,29005
2021-03-08,MO,Atchison,87,2033,29005
2021-03-09,MO,Atchison,2,2035,29005
2021-03-10,MO,Atchison,2,2037,29005
2021-03-11,MO,Atchison,213,2250,29005
2021-03-12,MO,Atchison,27,2277,29005
2021-03-13,MO,Atchison,1,2278,29005
2021-03-15,MO,Atchison,28,2306,29005
2021-03-16,MO,Atchison,21,2327,29005
2021-03-17,MO,Atchison,23,2350,29005
2021-03-18,MO,Atchison,172,2522,29005
2021-03-19,MO,Atchison,32,2554,29005
2021-03-20,MO,Atchison,8,2562,29005
2021-03-21,MO,Atchison,1,2563,29005
2021-03-22,MO,Atchison,38,2601,29005
2021-03-23,MO,Atchison,28,2629,29005
2021-03-24,MO,Atchison,18,2647,29005
2021-03-25,MO,Atchison,46,2693,29005
2021-03-26,MO,Atchison,16,2709,29005
2021-03-27,MO,Atchison,5,2714,29005
2021-03-29,MO,Atchison,68,2782,29005
2021-03-30,MO,Atchison,16,2798,29005
2021-03-31,MO,Atchison,10,2808,29005
2021-04-01,MO,Atchison,56,2864,29005
2021-04-02,MO,Atchison,4,2868,29005
2021-04-03,MO,Atchison,12,2880,29005
2021-04-05,MO,Atchison,44,2924,29005
2021-04-06,MO,Atchison,13,2937,29005
2021-04-07,MO,Atchison,23,2960,29005
2021-04-08,MO,Atchison,53,3013,29005
2021-04-09,MO,Atchison,12,3025,29005
2021-04-10,MO,Atchison,1,3026,29005
2021-04-12,MO,Atchison,89,3115,29005
2021-04-13,MO,Atchison,21,3136,29005
2021-04-14,MO,Atchison,21,3157,29005
2021-04-15,MO,Atchison,20,3177,29005
2021-04-16,MO,Atchison,37,3214,29005
2021-04-17,MO,Atchison,10,3224,29005
2021-04-19,MO,Atchison,29,3253,29005
2021-04-20,MO,Atchison,21,3274,29005
2021-04-21,MO,Atchison,21,3295,29005
2021-04-22,MO,Atchison,12,3307,29005
2021-04-23,MO,Atchison,9,3316,29005
2021-04-26,MO,Atchison,34,3350,29005
2021-04-27,MO,Atchison,2,3352,29005
2021-04-28,MO,Atchison,6,3358,29005
2021-04-29,MO,Atchison,18,3376,29005
2021-04-30,MO,Atchison,1,3377,29005
2021-05-01,MO,Atchison,11,3388,29005
2021-05-03,MO,Atchison,14,3402,29005
2021-05-04,MO,Atchison,4,3406,29005
2021-05-05,MO,Atchison,3,3409,29005
2021-05-06,MO,Atchison,8,3417,29005
2021-05-07,MO,Atchison,9,3426,29005
2021-05-09,MO,Atchison,1,3427,29005
2021-05-10,MO,Atchison,68,3495,29005
2021-05-11,MO,Atchison,1,3496,29005
2021-05-12,MO,Atchison,2,3498,29005
2021-05-13,MO,Atchison,7,3505,29005
2021-05-14,MO,Atchison,15,3520,29005
2021-05-15,MO,Atchison,2,3522,29005
2021-05-17,MO,Atchison,10,3532,29005
2021-05-18,MO,Atchison,22,3554,29005
2021-05-19,MO,Atchison,5,3559,29005
2021-05-20,MO,Atchison,5,3564,29005
2021-05-21,MO,Atchison,1,3565,29005
2021-05-23,MO,Atchison,2,3567,29005
2021-05-24,MO,Atchison,12,3579,29005
2021-05-25,MO,Atchison,11,3590,29005
2021-05-26,MO,Atchison,8,3598,29005
2021-05-27,MO,Atchison,10,3608,29005
2020-12-16,MO,Audrain,33,33,29007
2020-12-17,MO,Audrain,29,62,29007
2020-12-18,MO,Audrain,30,92,29007
2020-12-19,MO,Audrain,8,100,29007
2020-12-20,MO,Audrain,1,101,29007
2020-12-21,MO,Audrain,21,122,29007
2020-12-22,MO,Audrain,34,156,29007
2020-12-23,MO,Audrain,9,165,29007
2020-12-28,MO,Audrain,21,186,29007
2020-12-29,MO,Audrain,31,217,29007
2020-12-30,MO,Audrain,50,267,29007
2020-12-31,MO,Audrain,10,277,29007
2021-01-01,MO,Audrain,1,278,29007
2021-01-02,MO,Audrain,16,294,29007
2021-01-03,MO,Audrain,5,299,29007
2021-01-04,MO,Audrain,33,332,29007
2021-01-05,MO,Audrain,38,370,29007
2021-01-06,MO,Audrain,31,401,29007
2021-01-07,MO,Audrain,31,432,29007
2021-01-08,MO,Audrain,34,466,29007
2021-01-09,MO,Audrain,17,483,29007
2021-01-10,MO,Audrain,7,490,29007
2021-01-11,MO,Audrain,120,610,29007
2021-01-12,MO,Audrain,25,635,29007
2021-01-13,MO,Audrain,25,660,29007
2021-01-14,MO,Audrain,76,736,29007
2021-01-15,MO,Audrain,21,757,29007
2021-01-16,MO,Audrain,28,785,29007
2021-01-17,MO,Audrain,2,787,29007
2021-01-18,MO,Audrain,80,867,29007
2021-01-19,MO,Audrain,125,992,29007
2021-01-20,MO,Audrain,89,1081,29007
2021-01-21,MO,Audrain,154,1235,29007
2021-01-22,MO,Audrain,161,1396,29007
2021-01-23,MO,Audrain,8,1404,29007
2021-01-24,MO,Audrain,2,1406,29007
2021-01-25,MO,Audrain,13,1419,29007
2021-01-26,MO,Audrain,146,1565,29007
2021-01-27,MO,Audrain,140,1705,29007
2021-01-28,MO,Audrain,64,1769,29007
2021-01-29,MO,Audrain,625,2394,29007
2021-01-30,MO,Audrain,13,2407,29007
2021-01-31,MO,Audrain,9,2416,29007
2021-02-01,MO,Audrain,82,2498,29007
2021-02-02,MO,Audrain,223,2721,29007
2021-02-03,MO,Audrain,83,2804,29007
2021-02-04,MO,Audrain,224,3028,29007
2021-02-05,MO,Audrain,156,3184,29007
2021-02-06,MO,Audrain,20,3204,29007
2021-02-08,MO,Audrain,61,3265,29007
2021-02-09,MO,Audrain,300,3565,29007
2021-02-10,MO,Audrain,49,3614,29007
2021-02-11,MO,Audrain,210,3824,29007
2021-02-12,MO,Audrain,207,4031,29007
2021-02-13,MO,Audrain,41,4072,29007
2021-02-14,MO,Audrain,6,4078,29007
2021-02-15,MO,Audrain,69,4147,29007
2021-02-16,MO,Audrain,219,4366,29007
2021-02-17,MO,Audrain,100,4466,29007
2021-02-18,MO,Audrain,208,4674,29007
2021-02-19,MO,Audrain,228,4902,29007
2021-02-20,MO,Audrain,11,4913,29007
2021-02-21,MO,Audrain,11,4924,29007
2021-02-22,MO,Audrain,42,4966,29007
2021-02-23,MO,Audrain,167,5133,29007
2021-02-24,MO,Audrain,62,5195,29007
2021-02-25,MO,Audrain,768,5963,29007
2021-02-26,MO,Audrain,160,6123,29007
2021-02-27,MO,Audrain,18,6141,29007
2021-02-28,MO,Audrain,1,6142,29007
2021-03-01,MO,Audrain,28,6170,29007
2021-03-02,MO,Audrain,170,6340,29007
2021-03-03,MO,Audrain,108,6448,29007
2021-03-04,MO,Audrain,162,6610,29007
2021-03-05,MO,Audrain,74,6684,29007
2021-03-06,MO,Audrain,19,6703,29007
2021-03-07,MO,Audrain,13,6716,29007
2021-03-08,MO,Audrain,81,6797,29007
2021-03-09,MO,Audrain,112,6909,29007
2021-03-10,MO,Audrain,78,6987,29007
2021-03-11,MO,Audrain,212,7199,29007
2021-03-12,MO,Audrain,148,7347,29007
2021-03-13,MO,Audrain,12,7359,29007
2021-03-14,MO,Audrain,3,7362,29007
2021-03-15,MO,Audrain,196,7558,29007
2021-03-16,MO,Audrain,144,7702,29007
2021-03-17,MO,Audrain,95,7797,29007
2021-03-18,MO,Audrain,127,7924,29007
2021-03-19,MO,Audrain,129,8053,29007
2021-03-20,MO,Audrain,29,8082,29007
2021-03-21,MO,Audrain,19,8101,29007
2021-03-22,MO,Audrain,90,8191,29007
2021-03-23,MO,Audrain,119,8310,29007
2021-03-24,MO,Audrain,72,8382,29007
2021-03-25,MO,Audrain,128,8510,29007
2021-03-26,MO,Audrain,125,8635,29007
2021-03-27,MO,Audrain,14,8649,29007
2021-03-28,MO,Audrain,10,8659,29007
2021-03-29,MO,Audrain,28,8687,29007
2021-03-30,MO,Audrain,139,8826,29007
2021-03-31,MO,Audrain,121,8947,29007
2021-04-01,MO,Audrain,101,9048,29007
2021-04-02,MO,Audrain,150,9198,29007
2021-04-03,MO,Audrain,42,9240,29007
2021-04-04,MO,Audrain,3,9243,29007
2021-04-05,MO,Audrain,95,9338,29007
2021-04-06,MO,Audrain,199,9537,29007
2021-04-07,MO,Audrain,169,9706,29007
2021-04-08,MO,Audrain,88,9794,29007
2021-04-09,MO,Audrain,126,9920,29007
2021-04-10,MO,Audrain,26,9946,29007
2021-04-11,MO,Audrain,16,9962,29007
2021-04-12,MO,Audrain,188,10150,29007
2021-04-13,MO,Audrain,132,10282,29007
2021-04-14,MO,Audrain,87,10369,29007
2021-04-15,MO,Audrain,118,10487,29007
2021-04-16,MO,Audrain,120,10607,29007
2021-04-17,MO,Audrain,25,10632,29007
2021-04-18,MO,Audrain,10,10642,29007
2021-04-19,MO,Audrain,60,10702,29007
2021-04-20,MO,Audrain,122,10824,29007
2021-04-21,MO,Audrain,58,10882,29007
2021-04-22,MO,Audrain,97,10979,29007
2021-04-23,MO,Audrain,124,11103,29007
2021-04-24,MO,Audrain,40,11143,29007
2021-04-25,MO,Audrain,2,11145,29007
2021-04-26,MO,Audrain,74,11219,29007
2021-04-27,MO,Audrain,167,11386,29007
2021-04-28,MO,Audrain,97,11483,29007
2021-04-29,MO,Audrain,86,11569,29007
2021-04-30,MO,Audrain,120,11689,29007
2021-05-01,MO,Audrain,37,11726,29007
2021-05-02,MO,Audrain,14,11740,29007
2021-05-03,MO,Audrain,72,11812,29007
2021-05-04,MO,Audrain,80,11892,29007
2021-05-05,MO,Audrain,76,11968,29007
2021-05-06,MO,Audrain,127,12095,29007
2021-05-07,MO,Audrain,57,12152,29007
2021-05-08,MO,Audrain,24,12176,29007
2021-05-09,MO,Audrain,5,12181,29007
2021-05-10,MO,Audrain,48,12229,29007
2021-05-11,MO,Audrain,49,12278,29007
2021-05-12,MO,Audrain,33,12311,29007
2021-05-13,MO,Audrain,76,12387,29007
2021-05-14,MO,Audrain,99,12486,29007
2021-05-15,MO,Audrain,29,12515,29007
2021-05-16,MO,Audrain,11,12526,29007
2021-05-17,MO,Audrain,67,12593,29007
2021-05-18,MO,Audrain,54,12647,29007
2021-05-19,MO,Audrain,55,12702,29007
2021-05-20,MO,Audrain,60,12762,29007
2021-05-21,MO,Audrain,54,12816,29007
2021-05-22,MO,Audrain,20,12836,29007
2021-05-23,MO,Audrain,11,12847,29007
2021-05-24,MO,Audrain,39,12886,29007
2021-05-25,MO,Audrain,23,12909,29007
2021-05-26,MO,Audrain,46,12955,29007
2021-05-27,MO,Audrain,20,12975,29007
2020-12-15,MO,Barry,4,4,29009
2020-12-16,MO,Barry,1,5,29009
2020-12-17,MO,Barry,21,26,29009
2020-12-18,MO,Barry,4,30,29009
2020-12-19,MO,Barry,3,33,29009
2020-12-20,MO,Barry,1,34,29009
2020-12-21,MO,Barry,25,59,29009
2020-12-22,MO,Barry,49,108,29009
2020-12-23,MO,Barry,38,146,29009
2020-12-24,MO,Barry,8,154,29009
2020-12-26,MO,Barry,3,157,29009
2020-12-27,MO,Barry,1,158,29009
2020-12-28,MO,Barry,37,195,29009
2020-12-29,MO,Barry,60,255,29009
2020-12-30,MO,Barry,37,292,29009
2020-12-31,MO,Barry,13,305,29009
2021-01-03,MO,Barry,1,306,29009
2021-01-04,MO,Barry,12,318,29009
2021-01-05,MO,Barry,10,328,29009
2021-01-06,MO,Barry,11,339,29009
2021-01-07,MO,Barry,59,398,29009
2021-01-08,MO,Barry,104,502,29009
2021-01-09,MO,Barry,2,504,29009
2021-01-10,MO,Barry,3,507,29009
2021-01-11,MO,Barry,61,568,29009
2021-01-12,MO,Barry,39,607,29009
2021-01-13,MO,Barry,22,629,29009
2021-01-14,MO,Barry,22,651,29009
2021-01-15,MO,Barry,12,663,29009
2021-01-16,MO,Barry,7,670,29009
2021-01-17,MO,Barry,28,698,29009
2021-01-18,MO,Barry,5,703,29009
2021-01-19,MO,Barry,75,778,29009
2021-01-20,MO,Barry,92,870,29009
2021-01-21,MO,Barry,74,944,29009
2021-01-22,MO,Barry,12,956,29009
2021-01-23,MO,Barry,12,968,29009
2021-01-24,MO,Barry,1,969,29009
2021-01-25,MO,Barry,49,1018,29009
2021-01-26,MO,Barry,112,1130,29009
2021-01-27,MO,Barry,43,1173,29009
2021-01-28,MO,Barry,38,1211,29009
2021-01-29,MO,Barry,184,1395,29009
2021-01-30,MO,Barry,13,1408,29009
2021-01-31,MO,Barry,1,1409,29009
2021-02-01,MO,Barry,32,1441,29009
2021-02-02,MO,Barry,88,1529,29009
2021-02-03,MO,Barry,53,1582,29009
2021-02-04,MO,Barry,102,1684,29009
2021-02-05,MO,Barry,250,1934,29009
2021-02-06,MO,Barry,32,1966,29009
2021-02-07,MO,Barry,1,1967,29009
2021-02-08,MO,Barry,57,2024,29009
2021-02-09,MO,Barry,91,2115,29009
2021-02-10,MO,Barry,60,2175,29009
2021-02-11,MO,Barry,39,2214,29009
2021-02-12,MO,Barry,133,2347,29009
2021-02-13,MO,Barry,55,2402,29009
2021-02-14,MO,Barry,57,2459,29009
2021-02-15,MO,Barry,194,2653,29009
2021-02-16,MO,Barry,173,2826,29009
2021-02-17,MO,Barry,63,2889,29009
2021-02-18,MO,Barry,314,3203,29009
2021-02-19,MO,Barry,96,3299,29009
2021-02-20,MO,Barry,12,3311,29009
2021-02-21,MO,Barry,1,3312,29009
2021-02-22,MO,Barry,13,3325,29009
2021-02-23,MO,Barry,176,3501,29009
2021-02-24,MO,Barry,296,3797,29009
2021-02-25,MO,Barry,66,3863,29009
2021-02-26,MO,Barry,128,3991,29009
2021-02-27,MO,Barry,40,4031,29009
2021-02-28,MO,Barry,1,4032,29009
2021-03-01,MO,Barry,271,4303,29009
2021-03-02,MO,Barry,272,4575,29009
2021-03-03,MO,Barry,134,4709,29009
2021-03-04,MO,Barry,651,5360,29009
2021-03-05,MO,Barry,714,6074,29009
2021-03-06,MO,Barry,41,6115,29009
2021-03-07,MO,Barry,13,6128,29009
2021-03-08,MO,Barry,242,6370,29009
2021-03-09,MO,Barry,195,6565,29009
2021-03-10,MO,Barry,263,6828,29009
2021-03-11,MO,Barry,216,7044,29009
2021-03-12,MO,Barry,278,7322,29009
2021-03-13,MO,Barry,65,7387,29009
2021-03-14,MO,Barry,27,7414,29009
2021-03-15,MO,Barry,689,8103,29009
2021-03-16,MO,Barry,248,8351,29009
2021-03-17,MO,Barry,146,8497,29009
2021-03-18,MO,Barry,373,8870,29009
2021-03-19,MO,Barry,341,9211,29009
2021-03-20,MO,Barry,189,9400,29009
2021-03-21,MO,Barry,10,9410,29009
2021-03-22,MO,Barry,96,9506,29009
2021-03-23,MO,Barry,322,9828,29009
2021-03-24,MO,Barry,381,10209,29009
2021-03-25,MO,Barry,687,10896,29009
2021-03-26,MO,Barry,655,11551,29009
2021-03-27,MO,Barry,51,11602,29009
2021-03-28,MO,Barry,12,11614,29009
2021-03-29,MO,Barry,305,11919,29009
2021-03-30,MO,Barry,302,12221,29009
2021-03-31,MO,Barry,231,12452,29009
2021-04-01,MO,Barry,330,12782,29009
2021-04-02,MO,Barry,189,12971,29009
2021-04-03,MO,Barry,39,13010,29009
2021-04-04,MO,Barry,19,13029,29009
2021-04-05,MO,Barry,736,13765,29009
2021-04-06,MO,Barry,225,13990,29009
2021-04-07,MO,Barry,189,14179,29009
2021-04-08,MO,Barry,167,14346,29009
2021-04-09,MO,Barry,497,14843,29009
2021-04-10,MO,Barry,118,14961,29009
2021-04-11,MO,Barry,34,14995,29009
2021-04-12,MO,Barry,184,15179,29009
2021-04-13,MO,Barry,289,15468,29009
2021-04-14,MO,Barry,145,15613,29009
2021-04-15,MO,Barry,226,15839,29009
2021-04-16,MO,Barry,190,16029,29009
2021-04-17,MO,Barry,46,16075,29009
2021-04-18,MO,Barry,12,16087,29009
2021-04-19,MO,Barry,118,16205,29009
2021-04-20,MO,Barry,97,16302,29009
2021-04-21,MO,Barry,200,16502,29009
2021-04-22,MO,Barry,283,16785,29009
2021-04-23,MO,Barry,132,16917,29009
2021-04-24,MO,Barry,30,16947,29009
2021-04-25,MO,Barry,5,16952,29009
2021-04-26,MO,Barry,77,17029,29009
2021-04-27,MO,Barry,122,17151,29009
2021-04-28,MO,Barry,226,17377,29009
2021-04-29,MO,Barry,101,17478,29009
2021-04-30,MO,Barry,239,17717,29009
2021-05-01,MO,Barry,51,17768,29009
2021-05-02,MO,Barry,14,17782,29009
2021-05-03,MO,Barry,55,17837,29009
2021-05-04,MO,Barry,71,17908,29009
2021-05-05,MO,Barry,174,18082,29009
2021-05-06,MO,Barry,77,18159,29009
2021-05-07,MO,Barry,116,18275,29009
2021-05-08,MO,Barry,23,18298,29009
2021-05-09,MO,Barry,16,18314,29009
2021-05-10,MO,Barry,65,18379,29009
2021-05-11,MO,Barry,60,18439,29009
2021-05-12,MO,Barry,143,18582,29009
2021-05-13,MO,Barry,100,18682,29009
2021-05-14,MO,Barry,74,18756,29009
2021-05-15,MO,Barry,30,18786,29009
2021-05-16,MO,Barry,26,18812,29009
2021-05-17,MO,Barry,57,18869,29009
2021-05-18,MO,Barry,69,18938,29009
2021-05-19,MO,Barry,159,19097,29009
2021-05-20,MO,Barry,86,19183,29009
2021-05-21,MO,Barry,65,19248,29009
2021-05-22,MO,Barry,26,19274,29009
2021-05-23,MO,Barry,11,19285,29009
2021-05-24,MO,Barry,67,19352,29009
2021-05-25,MO,Barry,37,19389,29009
2021-05-26,MO,Barry,71,19460,29009
2021-05-27,MO,Barry,35,19495,29009
2020-12-18,MO,Barton,7,7,29011
2020-12-20,MO,Barton,2,9,29011
2020-12-21,MO,Barton,3,12,29011
2020-12-22,MO,Barton,1,13,29011
2020-12-23,MO,Barton,28,41,29011
2020-12-24,MO,Barton,1,42,29011
2020-12-28,MO,Barton,3,45,29011
2020-12-29,MO,Barton,22,67,29011
2020-12-30,MO,Barton,4,71,29011
2020-12-31,MO,Barton,8,79,29011
2021-01-04,MO,Barton,1,80,29011
2021-01-05,MO,Barton,50,130,29011
2021-01-06,MO,Barton,9,139,29011
2021-01-07,MO,Barton,7,146,29011
2021-01-08,MO,Barton,29,175,29011
2021-01-09,MO,Barton,1,176,29011
2021-01-10,MO,Barton,1,177,29011
2021-01-11,MO,Barton,5,182,29011
2021-01-12,MO,Barton,9,191,29011
2021-01-13,MO,Barton,4,195,29011
2021-01-14,MO,Barton,5,200,29011
2021-01-15,MO,Barton,2,202,29011
2021-01-16,MO,Barton,1,203,29011
2021-01-17,MO,Barton,1,204,29011
2021-01-19,MO,Barton,4,208,29011
2021-01-20,MO,Barton,9,217,29011
2021-01-21,MO,Barton,46,263,29011
2021-01-22,MO,Barton,5,268,29011
2021-01-23,MO,Barton,3,271,29011
2021-01-25,MO,Barton,12,283,29011
2021-01-26,MO,Barton,42,325,29011
2021-01-27,MO,Barton,12,337,29011
2021-01-28,MO,Barton,12,349,29011
2021-01-29,MO,Barton,9,358,29011
2021-01-30,MO,Barton,11,369,29011
2021-02-01,MO,Barton,23,392,29011
2021-02-02,MO,Barton,80,472,29011
2021-02-03,MO,Barton,24,496,29011
2021-02-04,MO,Barton,121,617,29011
2021-02-05,MO,Barton,97,714,29011
2021-02-06,MO,Barton,3,717,29011
2021-02-08,MO,Barton,54,771,29011
2021-02-09,MO,Barton,24,795,29011
2021-02-10,MO,Barton,40,835,29011
2021-02-11,MO,Barton,17,852,29011
2021-02-12,MO,Barton,38,890,29011
2021-02-13,MO,Barton,21,911,29011
2021-02-14,MO,Barton,8,919,29011
2021-02-15,MO,Barton,21,940,29011
2021-02-16,MO,Barton,27,967,29011
2021-02-17,MO,Barton,11,978,29011
2021-02-18,MO,Barton,60,1038,29011
2021-02-19,MO,Barton,121,1159,29011
2021-02-20,MO,Barton,7,1166,29011
2021-02-22,MO,Barton,7,1173,29011
2021-02-23,MO,Barton,32,1205,29011
2021-02-24,MO,Barton,13,1218,29011
2021-02-25,MO,Barton,26,1244,29011
2021-02-26,MO,Barton,127,1371,29011
2021-02-27,MO,Barton,4,1375,29011
2021-03-01,MO,Barton,37,1412,29011
2021-03-02,MO,Barton,68,1480,29011
2021-03-03,MO,Barton,48,1528,29011
2021-03-04,MO,Barton,211,1739,29011
2021-03-05,MO,Barton,96,1835,29011
2021-03-06,MO,Barton,12,1847,29011
2021-03-07,MO,Barton,7,1854,29011
2021-03-08,MO,Barton,71,1925,29011
2021-03-09,MO,Barton,102,2027,29011
2021-03-10,MO,Barton,81,2108,29011
2021-03-11,MO,Barton,48,2156,29011
2021-03-12,MO,Barton,44,2200,29011
2021-03-13,MO,Barton,21,2221,29011
2021-03-14,MO,Barton,9,2230,29011
2021-03-15,MO,Barton,57,2287,29011
2021-03-16,MO,Barton,58,2345,29011
2021-03-17,MO,Barton,66,2411,29011
2021-03-18,MO,Barton,75,2486,29011
2021-03-19,MO,Barton,130,2616,29011
2021-03-20,MO,Barton,13,2629,29011
2021-03-21,MO,Barton,7,2636,29011
2021-03-22,MO,Barton,105,2741,29011
2021-03-23,MO,Barton,54,2795,29011
2021-03-24,MO,Barton,25,2820,29011
2021-03-25,MO,Barton,28,2848,29011
2021-03-26,MO,Barton,140,2988,29011
2021-03-27,MO,Barton,16,3004,29011
2021-03-28,MO,Barton,12,3016,29011
2021-03-29,MO,Barton,54,3070,29011
2021-03-30,MO,Barton,44,3114,29011
2021-03-31,MO,Barton,56,3170,29011
2021-04-01,MO,Barton,56,3226,29011
2021-04-02,MO,Barton,47,3273,29011
2021-04-03,MO,Barton,20,3293,29011
2021-04-04,MO,Barton,7,3300,29011
2021-04-05,MO,Barton,30,3330,29011
2021-04-06,MO,Barton,51,3381,29011
2021-04-07,MO,Barton,28,3409,29011
2021-04-08,MO,Barton,56,3465,29011
2021-04-09,MO,Barton,175,3640,29011
2021-04-10,MO,Barton,12,3652,29011
2021-04-11,MO,Barton,11,3663,29011
2021-04-12,MO,Barton,91,3754,29011
2021-04-13,MO,Barton,16,3770,29011
2021-04-14,MO,Barton,36,3806,29011
2021-04-15,MO,Barton,35,3841,29011
2021-04-16,MO,Barton,51,3892,29011
2021-04-17,MO,Barton,11,3903,29011
2021-04-18,MO,Barton,7,3910,29011
2021-04-19,MO,Barton,83,3993,29011
2021-04-20,MO,Barton,42,4035,29011
2021-04-21,MO,Barton,32,4067,29011
2021-04-22,MO,Barton,24,4091,29011
2021-04-23,MO,Barton,80,4171,29011
2021-04-24,MO,Barton,17,4188,29011
2021-04-25,MO,Barton,9,4197,29011
2021-04-26,MO,Barton,61,4258,29011
2021-04-27,MO,Barton,32,4290,29011
2021-04-28,MO,Barton,21,4311,29011
2021-04-29,MO,Barton,16,4327,29011
2021-04-30,MO,Barton,36,4363,29011
2021-05-01,MO,Barton,5,4368,29011
2021-05-02,MO,Barton,2,4370,29011
2021-05-03,MO,Barton,10,4380,29011
2021-05-04,MO,Barton,13,4393,29011
2021-05-05,MO,Barton,12,4405,29011
2021-05-06,MO,Barton,14,4419,29011
2021-05-07,MO,Barton,32,4451,29011
2021-05-08,MO,Barton,10,4461,29011
2021-05-09,MO,Barton,1,4462,29011
2021-05-10,MO,Barton,42,4504,29011
2021-05-11,MO,Barton,10,4514,29011
2021-05-12,MO,Barton,11,4525,29011
2021-05-13,MO,Barton,21,4546,29011
2021-05-14,MO,Barton,40,4586,29011
2021-05-15,MO,Barton,4,4590,29011
2021-05-16,MO,Barton,6,4596,29011
2021-05-17,MO,Barton,30,4626,29011
2021-05-18,MO,Barton,16,4642,29011
2021-05-19,MO,Barton,14,4656,29011
2021-05-20,MO,Barton,12,4668,29011
2021-05-21,MO,Barton,18,4686,29011
2021-05-22,MO,Barton,6,4692,29011
2021-05-23,MO,Barton,3,4695,29011
2021-05-24,MO,Barton,20,4715,29011
2021-05-25,MO,Barton,14,4729,29011
2021-05-26,MO,Barton,10,4739,29011
2021-05-27,MO,Barton,4,4743,29011
2020-12-18,MO,Bates,2,2,29013
2020-12-19,MO,Bates,2,4,29013
2020-12-21,MO,Bates,3,7,29013
2020-12-22,MO,Bates,3,10,29013
2020-12-23,MO,Bates,5,15,29013
2020-12-24,MO,Bates,4,19,29013
2020-12-26,MO,Bates,5,24,29013
2020-12-28,MO,Bates,10,34,29013
2020-12-29,MO,Bates,9,43,29013
2020-12-30,MO,Bates,8,51,29013
2020-12-31,MO,Bates,87,138,29013
2021-01-03,MO,Bates,2,140,29013
2021-01-04,MO,Bates,8,148,29013
2021-01-05,MO,Bates,7,155,29013
2021-01-06,MO,Bates,61,216,29013
2021-01-07,MO,Bates,16,232,29013
2021-01-08,MO,Bates,65,297,29013
2021-01-09,MO,Bates,1,298,29013
2021-01-11,MO,Bates,23,321,29013
2021-01-12,MO,Bates,35,356,29013
2021-01-13,MO,Bates,26,382,29013
2021-01-14,MO,Bates,14,396,29013
2021-01-15,MO,Bates,61,457,29013
2021-01-16,MO,Bates,2,459,29013
2021-01-17,MO,Bates,1,460,29013
2021-01-18,MO,Bates,1,461,29013
2021-01-19,MO,Bates,3,464,29013
2021-01-20,MO,Bates,15,479,29013
2021-01-21,MO,Bates,7,486,29013
2021-01-22,MO,Bates,17,503,29013
2021-01-23,MO,Bates,16,519,29013
2021-01-25,MO,Bates,6,525,29013
2021-01-26,MO,Bates,119,644,29013
2021-01-27,MO,Bates,41,685,29013
2021-01-28,MO,Bates,116,801,29013
2021-01-29,MO,Bates,113,914,29013
2021-01-30,MO,Bates,22,936,29013
2021-01-31,MO,Bates,2,938,29013
2021-02-01,MO,Bates,66,1004,29013
2021-02-02,MO,Bates,105,1109,29013
2021-02-03,MO,Bates,48,1157,29013
2021-02-04,MO,Bates,37,1194,29013
2021-02-05,MO,Bates,96,1290,29013
2021-02-06,MO,Bates,2,1292,29013
2021-02-08,MO,Bates,69,1361,29013
2021-02-09,MO,Bates,52,1413,29013
2021-02-10,MO,Bates,77,1490,29013
2021-02-11,MO,Bates,234,1724,29013
2021-02-12,MO,Bates,198,1922,29013
2021-02-13,MO,Bates,29,1951,29013
2021-02-14,MO,Bates,12,1963,29013
2021-02-15,MO,Bates,32,1995,29013
2021-02-16,MO,Bates,41,2036,29013
2021-02-17,MO,Bates,22,2058,29013
2021-02-18,MO,Bates,44,2102,29013
2021-02-19,MO,Bates,37,2139,29013
2021-02-20,MO,Bates,8,2147,29013
2021-02-21,MO,Bates,2,2149,29013
2021-02-22,MO,Bates,11,2160,29013
2021-02-23,MO,Bates,97,2257,29013
2021-02-24,MO,Bates,27,2284,29013
2021-02-25,MO,Bates,298,2582,29013
2021-02-26,MO,Bates,94,2676,29013
2021-02-27,MO,Bates,12,2688,29013
2021-02-28,MO,Bates,12,2700,29013
2021-03-01,MO,Bates,62,2762,29013
2021-03-02,MO,Bates,87,2849,29013
2021-03-03,MO,Bates,104,2953,29013
2021-03-04,MO,Bates,75,3028,29013
2021-03-05,MO,Bates,64,3092,29013
2021-03-06,MO,Bates,9,3101,29013
2021-03-07,MO,Bates,8,3109,29013
2021-03-08,MO,Bates,97,3206,29013
2021-03-09,MO,Bates,76,3282,29013
2021-03-10,MO,Bates,199,3481,29013
2021-03-11,MO,Bates,241,3722,29013
2021-03-12,MO,Bates,186,3908,29013
2021-03-13,MO,Bates,26,3934,29013
2021-03-14,MO,Bates,11,3945,29013
2021-03-15,MO,Bates,26,3971,29013
2021-03-16,MO,Bates,152,4123,29013
2021-03-17,MO,Bates,56,4179,29013
2021-03-18,MO,Bates,281,4460,29013
2021-03-19,MO,Bates,89,4549,29013
2021-03-20,MO,Bates,15,4564,29013
2021-03-21,MO,Bates,8,4572,29013
2021-03-22,MO,Bates,97,4669,29013
2021-03-23,MO,Bates,26,4695,29013
2021-03-24,MO,Bates,58,4753,29013
2021-03-25,MO,Bates,151,4904,29013
2021-03-26,MO,Bates,88,4992,29013
2021-03-27,MO,Bates,19,5011,29013
2021-03-28,MO,Bates,12,5023,29013
2021-03-29,MO,Bates,45,5068,29013
2021-03-30,MO,Bates,60,5128,29013
2021-03-31,MO,Bates,83,5211,29013
2021-04-01,MO,Bates,181,5392,29013
2021-04-02,MO,Bates,109,5501,29013
2021-04-03,MO,Bates,13,5514,29013
2021-04-04,MO,Bates,5,5519,29013
2021-04-05,MO,Bates,45,5564,29013
2021-04-06,MO,Bates,124,5688,29013
2021-04-07,MO,Bates,48,5736,29013
2021-04-08,MO,Bates,41,5777,29013
2021-04-09,MO,Bates,64,5841,29013
2021-04-10,MO,Bates,44,5885,29013
2021-04-11,MO,Bates,6,5891,29013
2021-04-12,MO,Bates,50,5941,29013
2021-04-13,MO,Bates,160,6101,29013
2021-04-14,MO,Bates,51,6152,29013
2021-04-15,MO,Bates,154,6306,29013
2021-04-16,MO,Bates,68,6374,29013
2021-04-17,MO,Bates,14,6388,29013
2021-04-18,MO,Bates,7,6395,29013
2021-04-19,MO,Bates,64,6459,29013
2021-04-20,MO,Bates,48,6507,29013
2021-04-21,MO,Bates,52,6559,29013
2021-04-22,MO,Bates,32,6591,29013
2021-04-23,MO,Bates,62,6653,29013
2021-04-24,MO,Bates,20,6673,29013
2021-04-25,MO,Bates,3,6676,29013
2021-04-26,MO,Bates,11,6687,29013
2021-04-27,MO,Bates,36,6723,29013
2021-04-28,MO,Bates,49,6772,29013
2021-04-29,MO,Bates,42,6814,29013
2021-04-30,MO,Bates,49,6863,29013
2021-05-01,MO,Bates,19,6882,29013
2021-05-02,MO,Bates,4,6886,29013
2021-05-03,MO,Bates,29,6915,29013
2021-05-04,MO,Bates,157,7072,29013
2021-05-05,MO,Bates,56,7128,29013
2021-05-06,MO,Bates,32,7160,29013
2021-05-07,MO,Bates,16,7176,29013
2021-05-08,MO,Bates,18,7194,29013
2021-05-09,MO,Bates,2,7196,29013
2021-05-10,MO,Bates,31,7227,29013
2021-05-11,MO,Bates,13,7240,29013
2021-05-12,MO,Bates,24,7264,29013
2021-05-13,MO,Bates,33,7297,29013
2021-05-14,MO,Bates,25,7322,29013
2021-05-15,MO,Bates,28,7350,29013
2021-05-16,MO,Bates,12,7362,29013
2021-05-17,MO,Bates,32,7394,29013
2021-05-18,MO,Bates,17,7411,29013
2021-05-19,MO,Bates,65,7476,29013
2021-05-20,MO,Bates,25,7501,29013
2021-05-21,MO,Bates,36,7537,29013
2021-05-22,MO,Bates,14,7551,29013
2021-05-23,MO,Bates,1,7552,29013
2021-05-24,MO,Bates,13,7565,29013
2021-05-25,MO,Bates,9,7574,29013
2021-05-26,MO,Bates,41,7615,29013
2021-05-27,MO,Bates,4,7619,29013
2020-12-17,MO,Benton,1,1,29015
2020-12-18,MO,Benton,7,8,29015
2020-12-19,MO,Benton,7,15,29015
2020-12-21,MO,Benton,39,54,29015
2020-12-22,MO,Benton,20,74,29015
2020-12-23,MO,Benton,54,128,29015
2020-12-24,MO,Benton,8,136,29015
2020-12-28,MO,Benton,10,146,29015
2020-12-29,MO,Benton,49,195,29015
2020-12-30,MO,Benton,18,213,29015
2020-12-31,MO,Benton,9,222,29015
2021-01-02,MO,Benton,1,223,29015
2021-01-03,MO,Benton,2,225,29015
2021-01-04,MO,Benton,5,230,29015
2021-01-05,MO,Benton,2,232,29015
2021-01-06,MO,Benton,28,260,29015
2021-01-07,MO,Benton,8,268,29015
2021-01-08,MO,Benton,65,333,29015
2021-01-09,MO,Benton,3,336,29015
2021-01-11,MO,Benton,50,386,29015
2021-01-12,MO,Benton,26,412,29015
2021-01-13,MO,Benton,87,499,29015
2021-01-14,MO,Benton,34,533,29015
2021-01-15,MO,Benton,27,560,29015
2021-01-16,MO,Benton,4,564,29015
2021-01-18,MO,Benton,13,577,29015
2021-01-19,MO,Benton,34,611,29015
2021-01-20,MO,Benton,17,628,29015
2021-01-21,MO,Benton,19,647,29015
2021-01-22,MO,Benton,24,671,29015
2021-01-23,MO,Benton,97,768,29015
2021-01-25,MO,Benton,9,777,29015
2021-01-26,MO,Benton,109,886,29015
2021-01-27,MO,Benton,63,949,29015
2021-01-28,MO,Benton,167,1116,29015
2021-01-29,MO,Benton,222,1338,29015
2021-01-30,MO,Benton,52,1390,29015
2021-01-31,MO,Benton,9,1399,29015
2021-02-01,MO,Benton,71,1470,29015
2021-02-02,MO,Benton,146,1616,29015
2021-02-03,MO,Benton,323,1939,29015
2021-02-04,MO,Benton,59,1998,29015
2021-02-05,MO,Benton,543,2541,29015
2021-02-06,MO,Benton,14,2555,29015
2021-02-07,MO,Benton,1,2556,29015
2021-02-08,MO,Benton,26,2582,29015
2021-02-09,MO,Benton,43,2625,29015
2021-02-10,MO,Benton,82,2707,29015
2021-02-11,MO,Benton,34,2741,29015
2021-02-12,MO,Benton,518,3259,29015
2021-02-13,MO,Benton,202,3461,29015
2021-02-14,MO,Benton,48,3509,29015
2021-02-15,MO,Benton,18,3527,29015
2021-02-16,MO,Benton,35,3562,29015
2021-02-17,MO,Benton,38,3600,29015
2021-02-18,MO,Benton,74,3674,29015
2021-02-19,MO,Benton,134,3808,29015
2021-02-20,MO,Benton,8,3816,29015
2021-02-21,MO,Benton,7,3823,29015
2021-02-22,MO,Benton,23,3846,29015
2021-02-23,MO,Benton,734,4580,29015
2021-02-24,MO,Benton,230,4810,29015
2021-02-25,MO,Benton,141,4951,29015
2021-02-26,MO,Benton,201,5152,29015
2021-02-27,MO,Benton,97,5249,29015
2021-02-28,MO,Benton,29,5278,29015
2021-03-01,MO,Benton,54,5332,29015
2021-03-02,MO,Benton,168,5500,29015
2021-03-03,MO,Benton,288,5788,29015
2021-03-04,MO,Benton,57,5845,29015
2021-03-05,MO,Benton,508,6353,29015
2021-03-06,MO,Benton,21,6374,29015
2021-03-07,MO,Benton,15,6389,29015
2021-03-08,MO,Benton,31,6420,29015
2021-03-09,MO,Benton,47,6467,29015
2021-03-10,MO,Benton,71,6538,29015
2021-03-11,MO,Benton,46,6584,29015
2021-03-12,MO,Benton,556,7140,29015
2021-03-13,MO,Benton,114,7254,29015
2021-03-14,MO,Benton,49,7303,29015
2021-03-15,MO,Benton,441,7744,29015
2021-03-16,MO,Benton,55,7799,29015
2021-03-17,MO,Benton,644,8443,29015
2021-03-18,MO,Benton,204,8647,29015
2021-03-19,MO,Benton,209,8856,29015
2021-03-20,MO,Benton,15,8871,29015
2021-03-21,MO,Benton,5,8876,29015
2021-03-22,MO,Benton,43,8919,29015
2021-03-23,MO,Benton,47,8966,29015
2021-03-24,MO,Benton,58,9024,29015
2021-03-25,MO,Benton,90,9114,29015
2021-03-26,MO,Benton,73,9187,29015
2021-03-27,MO,Benton,98,9285,29015
2021-03-28,MO,Benton,32,9317,29015
2021-03-29,MO,Benton,51,9368,29015
2021-03-30,MO,Benton,240,9608,29015
2021-03-31,MO,Benton,63,9671,29015
2021-04-01,MO,Benton,86,9757,29015
2021-04-02,MO,Benton,33,9790,29015
2021-04-03,MO,Benton,11,9801,29015
2021-04-04,MO,Benton,2,9803,29015
2021-04-05,MO,Benton,375,10178,29015
2021-04-06,MO,Benton,90,10268,29015
2021-04-07,MO,Benton,66,10334,29015
2021-04-08,MO,Benton,30,10364,29015
2021-04-09,MO,Benton,161,10525,29015
2021-04-10,MO,Benton,28,10553,29015
2021-04-11,MO,Benton,7,10560,29015
2021-04-12,MO,Benton,131,10691,29015
2021-04-13,MO,Benton,30,10721,29015
2021-04-14,MO,Benton,73,10794,29015
2021-04-15,MO,Benton,79,10873,29015
2021-04-16,MO,Benton,137,11010,29015
2021-04-17,MO,Benton,13,11023,29015
2021-04-18,MO,Benton,3,11026,29015
2021-04-19,MO,Benton,42,11068,29015
2021-04-20,MO,Benton,33,11101,29015
2021-04-21,MO,Benton,57,11158,29015
2021-04-22,MO,Benton,79,11237,29015
2021-04-23,MO,Benton,49,11286,29015
2021-04-24,MO,Benton,22,11308,29015
2021-04-25,MO,Benton,1,11309,29015
2021-04-26,MO,Benton,34,11343,29015
2021-04-27,MO,Benton,279,11622,29015
2021-04-28,MO,Benton,23,11645,29015
2021-04-29,MO,Benton,55,11700,29015
2021-04-30,MO,Benton,56,11756,29015
2021-05-01,MO,Benton,10,11766,29015
2021-05-02,MO,Benton,10,11776,29015
2021-05-03,MO,Benton,30,11806,29015
2021-05-04,MO,Benton,28,11834,29015
2021-05-05,MO,Benton,54,11888,29015
2021-05-06,MO,Benton,22,11910,29015
2021-05-07,MO,Benton,34,11944,29015
2021-05-08,MO,Benton,10,11954,29015
2021-05-09,MO,Benton,5,11959,29015
2021-05-10,MO,Benton,33,11992,29015
2021-05-11,MO,Benton,25,12017,29015
2021-05-12,MO,Benton,57,12074,29015
2021-05-13,MO,Benton,29,12103,29015
2021-05-14,MO,Benton,37,12140,29015
2021-05-15,MO,Benton,8,12148,29015
2021-05-16,MO,Benton,6,12154,29015
2021-05-17,MO,Benton,33,12187,29015
2021-05-18,MO,Benton,20,12207,29015
2021-05-19,MO,Benton,66,12273,29015
2021-05-20,MO,Benton,43,12316,29015
2021-05-21,MO,Benton,30,12346,29015
2021-05-22,MO,Benton,8,12354,29015
2021-05-23,MO,Benton,4,12358,29015
2021-05-24,MO,Benton,24,12382,29015
2021-05-25,MO,Benton,91,12473,29015
2021-05-26,MO,Benton,10,12483,29015
2021-05-27,MO,Benton,18,12501,29015
2020-12-16,MO,Bollinger,1,1,29017
2020-12-17,MO,Bollinger,12,13,29017
2020-12-18,MO,Bollinger,2,15,29017
2020-12-21,MO,Bollinger,26,41,29017
2020-12-22,MO,Bollinger,25,66,29017
2020-12-23,MO,Bollinger,13,79,29017
2020-12-24,MO,Bollinger,3,82,29017
2020-12-26,MO,Bollinger,1,83,29017
2020-12-28,MO,Bollinger,3,86,29017
2020-12-29,MO,Bollinger,5,91,29017
2020-12-30,MO,Bollinger,31,122,29017
2020-12-31,MO,Bollinger,5,127,29017
2021-01-02,MO,Bollinger,2,129,29017
2021-01-05,MO,Bollinger,24,153,29017
2021-01-06,MO,Bollinger,11,164,29017
2021-01-07,MO,Bollinger,7,171,29017
2021-01-08,MO,Bollinger,43,214,29017
2021-01-09,MO,Bollinger,57,271,29017
2021-01-11,MO,Bollinger,32,303,29017
2021-01-12,MO,Bollinger,22,325,29017
2021-01-13,MO,Bollinger,30,355,29017
2021-01-14,MO,Bollinger,9,364,29017
2021-01-15,MO,Bollinger,21,385,29017
2021-01-16,MO,Bollinger,6,391,29017
2021-01-17,MO,Bollinger,1,392,29017
2021-01-18,MO,Bollinger,32,424,29017
2021-01-19,MO,Bollinger,61,485,29017
2021-01-20,MO,Bollinger,103,588,29017
2021-01-21,MO,Bollinger,42,630,29017
2021-01-22,MO,Bollinger,102,732,29017
2021-01-24,MO,Bollinger,1,733,29017
2021-01-25,MO,Bollinger,56,789,29017
2021-01-26,MO,Bollinger,33,822,29017
2021-01-27,MO,Bollinger,43,865,29017
2021-01-28,MO,Bollinger,183,1048,29017
2021-01-29,MO,Bollinger,61,1109,29017
2021-01-30,MO,Bollinger,1,1110,29017
2021-02-01,MO,Bollinger,7,1117,29017
2021-02-02,MO,Bollinger,43,1160,29017
2021-02-03,MO,Bollinger,178,1338,29017
2021-02-04,MO,Bollinger,21,1359,29017
2021-02-05,MO,Bollinger,113,1472,29017
2021-02-06,MO,Bollinger,59,1531,29017
2021-02-08,MO,Bollinger,57,1588,29017
2021-02-09,MO,Bollinger,90,1678,29017
2021-02-10,MO,Bollinger,75,1753,29017
2021-02-11,MO,Bollinger,36,1789,29017
2021-02-12,MO,Bollinger,107,1896,29017
2021-02-13,MO,Bollinger,2,1898,29017
2021-02-14,MO,Bollinger,2,1900,29017
2021-02-15,MO,Bollinger,26,1926,29017
2021-02-16,MO,Bollinger,10,1936,29017
2021-02-17,MO,Bollinger,9,1945,29017
2021-02-18,MO,Bollinger,5,1950,29017
2021-02-19,MO,Bollinger,124,2074,29017
2021-02-20,MO,Bollinger,14,2088,29017
2021-02-21,MO,Bollinger,1,2089,29017
2021-02-22,MO,Bollinger,118,2207,29017
2021-02-23,MO,Bollinger,83,2290,29017
2021-02-24,MO,Bollinger,59,2349,29017
2021-02-25,MO,Bollinger,7,2356,29017
2021-02-26,MO,Bollinger,52,2408,29017
2021-02-27,MO,Bollinger,17,2425,29017
2021-03-01,MO,Bollinger,7,2432,29017
2021-03-02,MO,Bollinger,197,2629,29017
2021-03-03,MO,Bollinger,184,2813,29017
2021-03-04,MO,Bollinger,21,2834,29017
2021-03-05,MO,Bollinger,133,2967,29017
2021-03-06,MO,Bollinger,2,2969,29017
2021-03-07,MO,Bollinger,1,2970,29017
2021-03-08,MO,Bollinger,61,3031,29017
2021-03-09,MO,Bollinger,36,3067,29017
2021-03-10,MO,Bollinger,32,3099,29017
2021-03-11,MO,Bollinger,23,3122,29017
2021-03-12,MO,Bollinger,47,3169,29017
2021-03-13,MO,Bollinger,1,3170,29017
2021-03-15,MO,Bollinger,43,3213,29017
2021-03-16,MO,Bollinger,17,3230,29017
2021-03-17,MO,Bollinger,119,3349,29017
2021-03-18,MO,Bollinger,10,3359,29017
2021-03-19,MO,Bollinger,137,3496,29017
2021-03-20,MO,Bollinger,3,3499,29017
2021-03-21,MO,Bollinger,2,3501,29017
2021-03-22,MO,Bollinger,42,3543,29017
2021-03-23,MO,Bollinger,10,3553,29017
2021-03-24,MO,Bollinger,66,3619,29017
2021-03-25,MO,Bollinger,132,3751,29017
2021-03-26,MO,Bollinger,18,3769,29017
2021-03-27,MO,Bollinger,5,3774,29017
2021-03-28,MO,Bollinger,1,3775,29017
2021-03-29,MO,Bollinger,37,3812,29017
2021-03-30,MO,Bollinger,47,3859,29017
2021-03-31,MO,Bollinger,111,3970,29017
2021-04-01,MO,Bollinger,32,4002,29017
2021-04-02,MO,Bollinger,54,4056,29017
2021-04-03,MO,Bollinger,4,4060,29017
2021-04-05,MO,Bollinger,36,4096,29017
2021-04-06,MO,Bollinger,40,4136,29017
2021-04-07,MO,Bollinger,49,4185,29017
2021-04-08,MO,Bollinger,21,4206,29017
2021-04-09,MO,Bollinger,110,4316,29017
2021-04-10,MO,Bollinger,6,4322,29017
2021-04-11,MO,Bollinger,4,4326,29017
2021-04-12,MO,Bollinger,41,4367,29017
2021-04-13,MO,Bollinger,19,4386,29017
2021-04-14,MO,Bollinger,43,4429,29017
2021-04-15,MO,Bollinger,8,4437,29017
2021-04-16,MO,Bollinger,62,4499,29017
2021-04-17,MO,Bollinger,7,4506,29017
2021-04-19,MO,Bollinger,35,4541,29017
2021-04-20,MO,Bollinger,17,4558,29017
2021-04-21,MO,Bollinger,61,4619,29017
2021-04-22,MO,Bollinger,19,4638,29017
2021-04-23,MO,Bollinger,27,4665,29017
2021-04-24,MO,Bollinger,12,4677,29017
2021-04-26,MO,Bollinger,36,4713,29017
2021-04-27,MO,Bollinger,11,4724,29017
2021-04-28,MO,Bollinger,98,4822,29017
2021-04-29,MO,Bollinger,19,4841,29017
2021-04-30,MO,Bollinger,46,4887,29017
2021-05-01,MO,Bollinger,2,4889,29017
2021-05-02,MO,Bollinger,1,4890,29017
2021-05-03,MO,Bollinger,28,4918,29017
2021-05-04,MO,Bollinger,13,4931,29017
2021-05-05,MO,Bollinger,22,4953,29017
2021-05-06,MO,Bollinger,16,4969,29017
2021-05-07,MO,Bollinger,29,4998,29017
2021-05-08,MO,Bollinger,8,5006,29017
2021-05-09,MO,Bollinger,1,5007,29017
2021-05-10,MO,Bollinger,14,5021,29017
2021-05-11,MO,Bollinger,9,5030,29017
2021-05-12,MO,Bollinger,58,5088,29017
2021-05-13,MO,Bollinger,6,5094,29017
2021-05-14,MO,Bollinger,40,5134,29017
2021-05-15,MO,Bollinger,12,5146,29017
2021-05-16,MO,Bollinger,8,5154,29017
2021-05-17,MO,Bollinger,17,5171,29017
2021-05-18,MO,Bollinger,8,5179,29017
2021-05-19,MO,Bollinger,30,5209,29017
2021-05-20,MO,Bollinger,3,5212,29017
2021-05-21,MO,Bollinger,13,5225,29017
2021-05-22,MO,Bollinger,4,5229,29017
2021-05-23,MO,Bollinger,1,5230,29017
2021-05-24,MO,Bollinger,11,5241,29017
2021-05-25,MO,Bollinger,8,5249,29017
2021-05-26,MO,Bollinger,48,5297,29017
2021-05-27,MO,Bollinger,3,5300,29017
2020-12-14,MO,Boone,1,1,29019
2020-12-15,MO,Boone,27,28,29019
2020-12-16,MO,Boone,352,380,29019
2020-12-17,MO,Boone,540,920,29019
2020-12-18,MO,Boone,696,1616,29019
2020-12-19,MO,Boone,536,2152,29019
2020-12-20,MO,Boone,353,2505,29019
2020-12-21,MO,Boone,509,3014,29019
2020-12-22,MO,Boone,621,3635,29019
2020-12-23,MO,Boone,248,3883,29019
2020-12-24,MO,Boone,16,3899,29019
2020-12-26,MO,Boone,14,3913,29019
2020-12-27,MO,Boone,9,3922,29019
2020-12-28,MO,Boone,631,4553,29019
2020-12-29,MO,Boone,573,5126,29019
2020-12-30,MO,Boone,699,5825,29019
2020-12-31,MO,Boone,349,6174,29019
2021-01-01,MO,Boone,8,6182,29019
2021-01-02,MO,Boone,172,6354,29019
2021-01-03,MO,Boone,166,6520,29019
2021-01-04,MO,Boone,180,6700,29019
2021-01-05,MO,Boone,276,6976,29019
2021-01-06,MO,Boone,578,7554,29019
2021-01-07,MO,Boone,794,8348,29019
2021-01-08,MO,Boone,856,9204,29019
2021-01-09,MO,Boone,523,9727,29019
2021-01-10,MO,Boone,470,10197,29019
2021-01-11,MO,Boone,746,10943,29019
2021-01-12,MO,Boone,692,11635,29019
2021-01-13,MO,Boone,407,12042,29019
2021-01-14,MO,Boone,423,12465,29019
2021-01-15,MO,Boone,409,12874,29019
2021-01-16,MO,Boone,380,13254,29019
2021-01-17,MO,Boone,124,13378,29019
2021-01-18,MO,Boone,758,14136,29019
2021-01-19,MO,Boone,701,14837,29019
2021-01-20,MO,Boone,994,15831,29019
2021-01-21,MO,Boone,1209,17040,29019
2021-01-22,MO,Boone,556,17596,29019
2021-01-23,MO,Boone,411,18007,29019
2021-01-24,MO,Boone,158,18165,29019
2021-01-25,MO,Boone,640,18805,29019
2021-01-26,MO,Boone,903,19708,29019
2021-01-27,MO,Boone,865,20573,29019
2021-01-28,MO,Boone,1014,21587,29019
2021-01-29,MO,Boone,1719,23306,29019
2021-01-30,MO,Boone,743,24049,29019
2021-01-31,MO,Boone,213,24262,29019
2021-02-01,MO,Boone,326,24588,29019
2021-02-02,MO,Boone,628,25216,29019
2021-02-03,MO,Boone,621,25837,29019
2021-02-04,MO,Boone,2391,28228,29019
2021-02-05,MO,Boone,944,29172,29019
2021-02-06,MO,Boone,1968,31140,29019
2021-02-07,MO,Boone,2,31142,29019
2021-02-08,MO,Boone,320,31462,29019
2021-02-09,MO,Boone,552,32014,29019
2021-02-10,MO,Boone,596,32610,29019
2021-02-11,MO,Boone,670,33280,29019
2021-02-12,MO,Boone,862,34142,29019
2021-02-13,MO,Boone,335,34477,29019
2021-02-14,MO,Boone,83,34560,29019
2021-02-15,MO,Boone,968,35528,29019
2021-02-16,MO,Boone,1025,36553,29019
2021-02-17,MO,Boone,925,37478,29019
2021-02-18,MO,Boone,1343,38821,29019
2021-02-19,MO,Boone,1266,40087,29019
2021-02-20,MO,Boone,148,40235,29019
2021-02-21,MO,Boone,7,40242,29019
2021-02-22,MO,Boone,833,41075,29019
2021-02-23,MO,Boone,803,41878,29019
2021-02-24,MO,Boone,944,42822,29019
2021-02-25,MO,Boone,3139,45961,29019
2021-02-26,MO,Boone,992,46953,29019
2021-02-27,MO,Boone,2631,49584,29019
2021-02-28,MO,Boone,220,49804,29019
2021-03-01,MO,Boone,678,50482,29019
2021-03-02,MO,Boone,793,51275,29019
2021-03-03,MO,Boone,879,52154,29019
2021-03-04,MO,Boone,3359,55513,29019
2021-03-05,MO,Boone,2301,57814,29019
2021-03-06,MO,Boone,2378,60192,29019
2021-03-07,MO,Boone,549,60741,29019
2021-03-08,MO,Boone,714,61455,29019
2021-03-09,MO,Boone,944,62399,29019
2021-03-10,MO,Boone,731,63130,29019
2021-03-11,MO,Boone,740,63870,29019
2021-03-12,MO,Boone,1408,65278,29019
2021-03-13,MO,Boone,255,65533,29019
2021-03-14,MO,Boone,175,65708,29019
2021-03-15,MO,Boone,1252,66960,29019
2021-03-16,MO,Boone,1701,68661,29019
2021-03-17,MO,Boone,1461,70122,29019
2021-03-18,MO,Boone,1173,71295,29019
2021-03-19,MO,Boone,3319,74614,29019
2021-03-20,MO,Boone,469,75083,29019
2021-03-21,MO,Boone,1687,76770,29019
2021-03-22,MO,Boone,1482,78252,29019
2021-03-23,MO,Boone,1208,79460,29019
2021-03-24,MO,Boone,1065,80525,29019
2021-03-25,MO,Boone,3243,83768,29019
2021-03-26,MO,Boone,1421,85189,29019
2021-03-27,MO,Boone,2214,87403,29019
2021-03-28,MO,Boone,659,88062,29019
2021-03-29,MO,Boone,970,89032,29019
2021-03-30,MO,Boone,1225,90257,29019
2021-03-31,MO,Boone,1816,92073,29019
2021-04-01,MO,Boone,1852,93925,29019
2021-04-02,MO,Boone,2856,96781,29019
2021-04-03,MO,Boone,886,97667,29019
2021-04-04,MO,Boone,180,97847,29019
2021-04-05,MO,Boone,3436,101283,29019
2021-04-06,MO,Boone,3918,105201,29019
2021-04-07,MO,Boone,1261,106462,29019
2021-04-08,MO,Boone,1084,107546,29019
2021-04-09,MO,Boone,3904,111450,29019
2021-04-10,MO,Boone,603,112053,29019
2021-04-11,MO,Boone,1766,113819,29019
2021-04-12,MO,Boone,1083,114902,29019
2021-04-13,MO,Boone,1365,116267,29019
2021-04-14,MO,Boone,1076,117343,29019
2021-04-15,MO,Boone,2868,120211,29019
2021-04-16,MO,Boone,2250,122461,29019
2021-04-17,MO,Boone,1681,124142,29019
2021-04-18,MO,Boone,313,124455,29019
2021-04-19,MO,Boone,850,125305,29019
2021-04-20,MO,Boone,1223,126528,29019
2021-04-21,MO,Boone,1000,127528,29019
2021-04-22,MO,Boone,1056,128584,29019
2021-04-23,MO,Boone,1110,129694,29019
2021-04-24,MO,Boone,455,130149,29019
2021-04-25,MO,Boone,291,130440,29019
2021-04-26,MO,Boone,3109,133549,29019
2021-04-27,MO,Boone,3501,137050,29019
2021-04-28,MO,Boone,751,137801,29019
2021-04-29,MO,Boone,1105,138906,29019
2021-04-30,MO,Boone,980,139886,29019
2021-05-01,MO,Boone,814,140700,29019
2021-05-02,MO,Boone,302,141002,29019
2021-05-03,MO,Boone,581,141583,29019
2021-05-04,MO,Boone,927,142510,29019
2021-05-05,MO,Boone,812,143322,29019
2021-05-06,MO,Boone,2429,145751,29019
2021-05-07,MO,Boone,2212,147963,29019
2021-05-08,MO,Boone,1348,149311,29019
2021-05-09,MO,Boone,152,149463,29019
2021-05-10,MO,Boone,533,149996,29019
2021-05-11,MO,Boone,558,150554,29019
2021-05-12,MO,Boone,499,151053,29019
2021-05-13,MO,Boone,506,151559,29019
2021-05-14,MO,Boone,934,152493,29019
2021-05-15,MO,Boone,535,153028,29019
2021-05-16,MO,Boone,240,153268,29019
2021-05-17,MO,Boone,768,154036,29019
2021-05-18,MO,Boone,417,154453,29019
2021-05-19,MO,Boone,472,154925,29019
2021-05-20,MO,Boone,800,155725,29019
2021-05-21,MO,Boone,617,156342,29019
2021-05-22,MO,Boone,700,157042,29019
2021-05-23,MO,Boone,94,157136,29019
2021-05-24,MO,Boone,474,157610,29019
2021-05-25,MO,Boone,403,158013,29019
2021-05-26,MO,Boone,278,158291,29019
2021-05-27,MO,Boone,114,158405,29019
2020-12-16,MO,Buchanan,1,1,29021
2020-12-17,MO,Buchanan,1,2,29021
2020-12-18,MO,Buchanan,6,8,29021
2020-12-19,MO,Buchanan,3,11,29021
2020-12-20,MO,Buchanan,2,13,29021
2020-12-21,MO,Buchanan,8,21,29021
2020-12-22,MO,Buchanan,48,69,29021
2020-12-23,MO,Buchanan,136,205,29021
2020-12-24,MO,Buchanan,4,209,29021
2020-12-26,MO,Buchanan,2,211,29021
2020-12-27,MO,Buchanan,145,356,29021
2020-12-28,MO,Buchanan,162,518,29021
2020-12-29,MO,Buchanan,148,666,29021
2020-12-30,MO,Buchanan,47,713,29021
2020-12-31,MO,Buchanan,30,743,29021
2021-01-01,MO,Buchanan,1,744,29021
2021-01-02,MO,Buchanan,14,758,29021
2021-01-03,MO,Buchanan,140,898,29021
2021-01-04,MO,Buchanan,242,1140,29021
2021-01-05,MO,Buchanan,200,1340,29021
2021-01-06,MO,Buchanan,154,1494,29021
2021-01-07,MO,Buchanan,44,1538,29021
2021-01-08,MO,Buchanan,56,1594,29021
2021-01-09,MO,Buchanan,6,1600,29021
2021-01-10,MO,Buchanan,3,1603,29021
2021-01-11,MO,Buchanan,21,1624,29021
2021-01-12,MO,Buchanan,34,1658,29021
2021-01-13,MO,Buchanan,279,1937,29021
2021-01-14,MO,Buchanan,258,2195,29021
2021-01-15,MO,Buchanan,171,2366,29021
2021-01-16,MO,Buchanan,15,2381,29021
2021-01-17,MO,Buchanan,34,2415,29021
2021-01-18,MO,Buchanan,27,2442,29021
2021-01-19,MO,Buchanan,33,2475,29021
2021-01-20,MO,Buchanan,316,2791,29021
2021-01-21,MO,Buchanan,165,2956,29021
2021-01-22,MO,Buchanan,175,3131,29021
2021-01-23,MO,Buchanan,12,3143,29021
2021-01-24,MO,Buchanan,13,3156,29021
2021-01-25,MO,Buchanan,83,3239,29021
2021-01-26,MO,Buchanan,469,3708,29021
2021-01-27,MO,Buchanan,324,4032,29021
2021-01-28,MO,Buchanan,427,4459,29021
2021-01-29,MO,Buchanan,413,4872,29021
2021-01-30,MO,Buchanan,15,4887,29021
2021-01-31,MO,Buchanan,63,4950,29021
2021-02-01,MO,Buchanan,166,5116,29021
2021-02-02,MO,Buchanan,299,5415,29021
2021-02-03,MO,Buchanan,418,5833,29021
2021-02-04,MO,Buchanan,504,6337,29021
2021-02-05,MO,Buchanan,546,6883,29021
2021-02-06,MO,Buchanan,8,6891,29021
2021-02-07,MO,Buchanan,2,6893,29021
2021-02-08,MO,Buchanan,283,7176,29021
2021-02-09,MO,Buchanan,315,7491,29021
2021-02-10,MO,Buchanan,172,7663,29021
2021-02-11,MO,Buchanan,473,8136,29021
2021-02-12,MO,Buchanan,367,8503,29021
2021-02-13,MO,Buchanan,29,8532,29021
2021-02-14,MO,Buchanan,19,8551,29021
2021-02-15,MO,Buchanan,75,8626,29021
2021-02-16,MO,Buchanan,220,8846,29021
2021-02-17,MO,Buchanan,312,9158,29021
2021-02-18,MO,Buchanan,221,9379,29021
2021-02-19,MO,Buchanan,203,9582,29021
2021-02-20,MO,Buchanan,20,9602,29021
2021-02-21,MO,Buchanan,3,9605,29021
2021-02-22,MO,Buchanan,339,9944,29021
2021-02-23,MO,Buchanan,161,10105,29021
2021-02-24,MO,Buchanan,79,10184,29021
2021-02-25,MO,Buchanan,559,10743,29021
2021-02-26,MO,Buchanan,428,11171,29021
2021-02-27,MO,Buchanan,14,11185,29021
2021-02-28,MO,Buchanan,15,11200,29021
2021-03-01,MO,Buchanan,447,11647,29021
2021-03-02,MO,Buchanan,540,12187,29021
2021-03-03,MO,Buchanan,496,12683,29021
2021-03-04,MO,Buchanan,466,13149,29021
2021-03-05,MO,Buchanan,279,13428,29021
2021-03-06,MO,Buchanan,27,13455,29021
2021-03-07,MO,Buchanan,7,13462,29021
2021-03-08,MO,Buchanan,52,13514,29021
2021-03-09,MO,Buchanan,615,14129,29021
2021-03-10,MO,Buchanan,473,14602,29021
2021-03-11,MO,Buchanan,470,15072,29021
2021-03-12,MO,Buchanan,371,15443,29021
2021-03-13,MO,Buchanan,42,15485,29021
2021-03-14,MO,Buchanan,10,15495,29021
2021-03-15,MO,Buchanan,103,15598,29021
2021-03-16,MO,Buchanan,584,16182,29021
2021-03-17,MO,Buchanan,407,16589,29021
2021-03-18,MO,Buchanan,494,17083,29021
2021-03-19,MO,Buchanan,392,17475,29021
2021-03-20,MO,Buchanan,28,17503,29021
2021-03-21,MO,Buchanan,10,17513,29021
2021-03-22,MO,Buchanan,30,17543,29021
2021-03-23,MO,Buchanan,130,17673,29021
2021-03-24,MO,Buchanan,422,18095,29021
2021-03-25,MO,Buchanan,549,18644,29021
2021-03-26,MO,Buchanan,601,19245,29021
2021-03-27,MO,Buchanan,29,19274,29021
2021-03-28,MO,Buchanan,8,19282,29021
2021-03-29,MO,Buchanan,69,19351,29021
2021-03-30,MO,Buchanan,635,19986,29021
2021-03-31,MO,Buchanan,740,20726,29021
2021-04-01,MO,Buchanan,738,21464,29021
2021-04-02,MO,Buchanan,397,21861,29021
2021-04-03,MO,Buchanan,30,21891,29021
2021-04-04,MO,Buchanan,11,21902,29021
2021-04-05,MO,Buchanan,66,21968,29021
2021-04-06,MO,Buchanan,465,22433,29021
2021-04-07,MO,Buchanan,495,22928,29021
2021-04-08,MO,Buchanan,513,23441,29021
2021-04-09,MO,Buchanan,514,23955,29021
2021-04-10,MO,Buchanan,52,24007,29021
2021-04-11,MO,Buchanan,12,24019,29021
2021-04-12,MO,Buchanan,82,24101,29021
2021-04-13,MO,Buchanan,449,24550,29021
2021-04-14,MO,Buchanan,804,25354,29021
2021-04-15,MO,Buchanan,570,25924,29021
2021-04-16,MO,Buchanan,695,26619,29021
2021-04-17,MO,Buchanan,22,26641,29021
2021-04-18,MO,Buchanan,15,26656,29021
2021-04-19,MO,Buchanan,43,26699,29021
2021-04-20,MO,Buchanan,474,27173,29021
2021-04-21,MO,Buchanan,200,27373,29021
2021-04-22,MO,Buchanan,205,27578,29021
2021-04-23,MO,Buchanan,285,27863,29021
2021-04-24,MO,Buchanan,38,27901,29021
2021-04-25,MO,Buchanan,10,27911,29021
2021-04-26,MO,Buchanan,92,28003,29021
2021-04-27,MO,Buchanan,220,28223,29021
2021-04-28,MO,Buchanan,109,28332,29021
2021-04-29,MO,Buchanan,555,28887,29021
2021-04-30,MO,Buchanan,532,29419,29021
2021-05-01,MO,Buchanan,48,29467,29021
2021-05-02,MO,Buchanan,25,29492,29021
2021-05-03,MO,Buchanan,59,29551,29021
2021-05-04,MO,Buchanan,386,29937,29021
2021-05-05,MO,Buchanan,67,30004,29021
2021-05-06,MO,Buchanan,88,30092,29021
2021-05-07,MO,Buchanan,379,30471,29021
2021-05-08,MO,Buchanan,24,30495,29021
2021-05-09,MO,Buchanan,22,30517,29021
2021-05-10,MO,Buchanan,34,30551,29021
2021-05-11,MO,Buchanan,197,30748,29021
2021-05-12,MO,Buchanan,58,30806,29021
2021-05-13,MO,Buchanan,56,30862,29021
2021-05-14,MO,Buchanan,79,30941,29021
2021-05-15,MO,Buchanan,59,31000,29021
2021-05-16,MO,Buchanan,38,31038,29021
2021-05-17,MO,Buchanan,89,31127,29021
2021-05-18,MO,Buchanan,131,31258,29021
2021-05-19,MO,Buchanan,74,31332,29021
2021-05-20,MO,Buchanan,57,31389,29021
2021-05-21,MO,Buchanan,81,31470,29021
2021-05-22,MO,Buchanan,44,31514,29021
2021-05-23,MO,Buchanan,19,31533,29021
2021-05-24,MO,Buchanan,89,31622,29021
2021-05-25,MO,Buchanan,103,31725,29021
2021-05-26,MO,Buchanan,93,31818,29021
2021-05-27,MO,Buchanan,20,31838,29021
2020-12-14,MO,Butler,1,1,29023
2020-12-15,MO,Butler,3,4,29023
2020-12-16,MO,Butler,2,6,29023
2020-12-17,MO,Butler,6,12,29023
2020-12-18,MO,Butler,14,26,29023
2020-12-19,MO,Butler,1,27,29023
2020-12-20,MO,Butler,1,28,29023
2020-12-21,MO,Butler,5,33,29023
2020-12-22,MO,Butler,15,48,29023
2020-12-23,MO,Butler,72,120,29023
2020-12-26,MO,Butler,1,121,29023
2020-12-27,MO,Butler,1,122,29023
2020-12-28,MO,Butler,41,163,29023
2020-12-29,MO,Butler,12,175,29023
2020-12-30,MO,Butler,42,217,29023
2020-12-31,MO,Butler,39,256,29023
2021-01-01,MO,Butler,3,259,29023
2021-01-02,MO,Butler,2,261,29023
2021-01-03,MO,Butler,11,272,29023
2021-01-04,MO,Butler,28,300,29023
2021-01-05,MO,Butler,208,508,29023
2021-01-06,MO,Butler,147,655,29023
2021-01-07,MO,Butler,103,758,29023
2021-01-08,MO,Butler,56,814,29023
2021-01-09,MO,Butler,5,819,29023
2021-01-10,MO,Butler,1,820,29023
2021-01-11,MO,Butler,67,887,29023
2021-01-12,MO,Butler,15,902,29023
2021-01-13,MO,Butler,11,913,29023
2021-01-14,MO,Butler,125,1038,29023
2021-01-15,MO,Butler,10,1048,29023
2021-01-16,MO,Butler,6,1054,29023
2021-01-18,MO,Butler,17,1071,29023
2021-01-19,MO,Butler,134,1205,29023
2021-01-20,MO,Butler,60,1265,29023
2021-01-21,MO,Butler,66,1331,29023
2021-01-22,MO,Butler,1257,2588,29023
2021-01-23,MO,Butler,274,2862,29023
2021-01-24,MO,Butler,19,2881,29023
2021-01-25,MO,Butler,83,2964,29023
2021-01-26,MO,Butler,234,3198,29023
2021-01-27,MO,Butler,117,3315,29023
2021-01-28,MO,Butler,99,3414,29023
2021-01-29,MO,Butler,102,3516,29023
2021-01-30,MO,Butler,3,3519,29023
2021-02-01,MO,Butler,51,3570,29023
2021-02-02,MO,Butler,24,3594,29023
2021-02-03,MO,Butler,117,3711,29023
2021-02-04,MO,Butler,190,3901,29023
2021-02-05,MO,Butler,197,4098,29023
2021-02-06,MO,Butler,19,4117,29023
2021-02-07,MO,Butler,1,4118,29023
2021-02-08,MO,Butler,99,4217,29023
2021-02-09,MO,Butler,225,4442,29023
2021-02-10,MO,Butler,158,4600,29023
2021-02-11,MO,Butler,23,4623,29023
2021-02-12,MO,Butler,1380,6003,29023
2021-02-13,MO,Butler,36,6039,29023
2021-02-14,MO,Butler,18,6057,29023
2021-02-15,MO,Butler,33,6090,29023
2021-02-16,MO,Butler,90,6180,29023
2021-02-17,MO,Butler,18,6198,29023
2021-02-18,MO,Butler,74,6272,29023
2021-02-19,MO,Butler,145,6417,29023
2021-02-20,MO,Butler,139,6556,29023
2021-02-21,MO,Butler,7,6563,29023
2021-02-22,MO,Butler,112,6675,29023
2021-02-23,MO,Butler,41,6716,29023
2021-02-24,MO,Butler,110,6826,29023
2021-02-25,MO,Butler,67,6893,29023
2021-02-26,MO,Butler,248,7141,29023
2021-02-27,MO,Butler,23,7164,29023
2021-02-28,MO,Butler,8,7172,29023
2021-03-01,MO,Butler,35,7207,29023
2021-03-02,MO,Butler,120,7327,29023
2021-03-03,MO,Butler,115,7442,29023
2021-03-04,MO,Butler,201,7643,29023
2021-03-05,MO,Butler,378,8021,29023
2021-03-06,MO,Butler,31,8052,29023
2021-03-07,MO,Butler,14,8066,29023
2021-03-08,MO,Butler,123,8189,29023
2021-03-09,MO,Butler,343,8532,29023
2021-03-10,MO,Butler,126,8658,29023
2021-03-11,MO,Butler,172,8830,29023
2021-03-12,MO,Butler,119,8949,29023
2021-03-13,MO,Butler,41,8990,29023
2021-03-14,MO,Butler,45,9035,29023
2021-03-15,MO,Butler,67,9102,29023
2021-03-16,MO,Butler,92,9194,29023
2021-03-17,MO,Butler,86,9280,29023
2021-03-18,MO,Butler,504,9784,29023
2021-03-19,MO,Butler,247,10031,29023
2021-03-20,MO,Butler,45,10076,29023
2021-03-21,MO,Butler,45,10121,29023
2021-03-22,MO,Butler,68,10189,29023
2021-03-23,MO,Butler,137,10326,29023
2021-03-24,MO,Butler,133,10459,29023
2021-03-25,MO,Butler,117,10576,29023
2021-03-26,MO,Butler,157,10733,29023
2021-03-27,MO,Butler,23,10756,29023
2021-03-28,MO,Butler,28,10784,29023
2021-03-29,MO,Butler,104,10888,29023
2021-03-30,MO,Butler,341,11229,29023
2021-03-31,MO,Butler,158,11387,29023
2021-04-01,MO,Butler,193,11580,29023
2021-04-02,MO,Butler,331,11911,29023
2021-04-03,MO,Butler,26,11937,29023
2021-04-04,MO,Butler,62,11999,29023
2021-04-05,MO,Butler,148,12147,29023
2021-04-06,MO,Butler,131,12278,29023
2021-04-07,MO,Butler,112,12390,29023
2021-04-08,MO,Butler,102,12492,29023
2021-04-09,MO,Butler,549,13041,29023
2021-04-10,MO,Butler,45,13086,29023
2021-04-11,MO,Butler,48,13134,29023
2021-04-12,MO,Butler,102,13236,29023
2021-04-13,MO,Butler,93,13329,29023
2021-04-14,MO,Butler,79,13408,29023
2021-04-15,MO,Butler,129,13537,29023
2021-04-16,MO,Butler,171,13708,29023
2021-04-17,MO,Butler,29,13737,29023
2021-04-18,MO,Butler,30,13767,29023
2021-04-19,MO,Butler,90,13857,29023
2021-04-20,MO,Butler,110,13967,29023
2021-04-21,MO,Butler,85,14052,29023
2021-04-22,MO,Butler,117,14169,29023
2021-04-23,MO,Butler,185,14354,29023
2021-04-24,MO,Butler,51,14405,29023
2021-04-25,MO,Butler,43,14448,29023
2021-04-26,MO,Butler,48,14496,29023
2021-04-27,MO,Butler,61,14557,29023
2021-04-28,MO,Butler,54,14611,29023
2021-04-29,MO,Butler,88,14699,29023
2021-04-30,MO,Butler,128,14827,29023
2021-05-01,MO,Butler,36,14863,29023
2021-05-02,MO,Butler,39,14902,29023
2021-05-03,MO,Butler,54,14956,29023
2021-05-04,MO,Butler,50,15006,29023
2021-05-05,MO,Butler,73,15079,29023
2021-05-06,MO,Butler,118,15197,29023
2021-05-07,MO,Butler,56,15253,29023
2021-05-08,MO,Butler,24,15277,29023
2021-05-09,MO,Butler,25,15302,29023
2021-05-10,MO,Butler,46,15348,29023
2021-05-11,MO,Butler,68,15416,29023
2021-05-12,MO,Butler,52,15468,29023
2021-05-13,MO,Butler,61,15529,29023
2021-05-14,MO,Butler,177,15706,29023
2021-05-15,MO,Butler,41,15747,29023
2021-05-16,MO,Butler,34,15781,29023
2021-05-17,MO,Butler,49,15830,29023
2021-05-18,MO,Butler,60,15890,29023
2021-05-19,MO,Butler,64,15954,29023
2021-05-20,MO,Butler,51,16005,29023
2021-05-21,MO,Butler,51,16056,29023
2021-05-22,MO,Butler,22,16078,29023
2021-05-23,MO,Butler,13,16091,29023
2021-05-24,MO,Butler,85,16176,29023
2021-05-25,MO,Butler,48,16224,29023
2021-05-26,MO,Butler,38,16262,29023
2021-05-27,MO,Butler,7,16269,29023
2020-12-16,MO,Caldwell,1,1,29025
2020-12-17,MO,Caldwell,2,3,29025
2020-12-19,MO,Caldwell,1,4,29025
2020-12-21,MO,Caldwell,3,7,29025
2020-12-22,MO,Caldwell,2,9,29025
2020-12-23,MO,Caldwell,3,12,29025
2020-12-24,MO,Caldwell,3,15,29025
2020-12-28,MO,Caldwell,10,25,29025
2020-12-29,MO,Caldwell,23,48,29025
2020-12-30,MO,Caldwell,8,56,29025
2020-12-31,MO,Caldwell,12,68,29025
2021-01-02,MO,Caldwell,4,72,29025
2021-01-03,MO,Caldwell,1,73,29025
2021-01-04,MO,Caldwell,6,79,29025
2021-01-05,MO,Caldwell,22,101,29025
2021-01-06,MO,Caldwell,6,107,29025
2021-01-07,MO,Caldwell,10,117,29025
2021-01-08,MO,Caldwell,9,126,29025
2021-01-09,MO,Caldwell,5,131,29025
2021-01-10,MO,Caldwell,1,132,29025
2021-01-11,MO,Caldwell,9,141,29025
2021-01-12,MO,Caldwell,9,150,29025
2021-01-13,MO,Caldwell,61,211,29025
2021-01-14,MO,Caldwell,38,249,29025
2021-01-15,MO,Caldwell,17,266,29025
2021-01-16,MO,Caldwell,7,273,29025
2021-01-18,MO,Caldwell,7,280,29025
2021-01-19,MO,Caldwell,9,289,29025
2021-01-20,MO,Caldwell,8,297,29025
2021-01-21,MO,Caldwell,29,326,29025
2021-01-22,MO,Caldwell,19,345,29025
2021-01-23,MO,Caldwell,1,346,29025
2021-01-25,MO,Caldwell,14,360,29025
2021-01-26,MO,Caldwell,18,378,29025
2021-01-27,MO,Caldwell,23,401,29025
2021-01-28,MO,Caldwell,24,425,29025
2021-01-29,MO,Caldwell,39,464,29025
2021-01-30,MO,Caldwell,26,490,29025
2021-01-31,MO,Caldwell,6,496,29025
2021-02-01,MO,Caldwell,11,507,29025
2021-02-02,MO,Caldwell,31,538,29025
2021-02-03,MO,Caldwell,77,615,29025
2021-02-04,MO,Caldwell,56,671,29025
2021-02-05,MO,Caldwell,56,727,29025
2021-02-06,MO,Caldwell,6,733,29025
2021-02-08,MO,Caldwell,28,761,29025
2021-02-09,MO,Caldwell,33,794,29025
2021-02-10,MO,Caldwell,33,827,29025
2021-02-11,MO,Caldwell,40,867,29025
2021-02-12,MO,Caldwell,33,900,29025
2021-02-13,MO,Caldwell,61,961,29025
2021-02-14,MO,Caldwell,8,969,29025
2021-02-15,MO,Caldwell,6,975,29025
2021-02-16,MO,Caldwell,6,981,29025
2021-02-17,MO,Caldwell,11,992,29025
2021-02-18,MO,Caldwell,32,1024,29025
2021-02-19,MO,Caldwell,13,1037,29025
2021-02-20,MO,Caldwell,424,1461,29025
2021-02-21,MO,Caldwell,3,1464,29025
2021-02-22,MO,Caldwell,26,1490,29025
2021-02-23,MO,Caldwell,31,1521,29025
2021-02-24,MO,Caldwell,27,1548,29025
2021-02-25,MO,Caldwell,59,1607,29025
2021-02-26,MO,Caldwell,42,1649,29025
2021-02-27,MO,Caldwell,26,1675,29025
2021-02-28,MO,Caldwell,3,1678,29025
2021-03-01,MO,Caldwell,28,1706,29025
2021-03-02,MO,Caldwell,49,1755,29025
2021-03-03,MO,Caldwell,59,1814,29025
2021-03-04,MO,Caldwell,42,1856,29025
2021-03-05,MO,Caldwell,56,1912,29025
2021-03-06,MO,Caldwell,14,1926,29025
2021-03-07,MO,Caldwell,3,1929,29025
2021-03-08,MO,Caldwell,14,1943,29025
2021-03-09,MO,Caldwell,35,1978,29025
2021-03-10,MO,Caldwell,11,1989,29025
2021-03-11,MO,Caldwell,22,2011,29025
2021-03-12,MO,Caldwell,35,2046,29025
2021-03-13,MO,Caldwell,54,2100,29025
2021-03-14,MO,Caldwell,3,2103,29025
2021-03-15,MO,Caldwell,29,2132,29025
2021-03-16,MO,Caldwell,34,2166,29025
2021-03-17,MO,Caldwell,37,2203,29025
2021-03-18,MO,Caldwell,71,2274,29025
2021-03-19,MO,Caldwell,43,2317,29025
2021-03-20,MO,Caldwell,437,2754,29025
2021-03-21,MO,Caldwell,2,2756,29025
2021-03-22,MO,Caldwell,17,2773,29025
2021-03-23,MO,Caldwell,26,2799,29025
2021-03-24,MO,Caldwell,50,2849,29025
2021-03-25,MO,Caldwell,49,2898,29025
2021-03-26,MO,Caldwell,41,2939,29025
2021-03-27,MO,Caldwell,4,2943,29025
2021-03-28,MO,Caldwell,1,2944,29025
2021-03-29,MO,Caldwell,19,2963,29025
2021-03-30,MO,Caldwell,29,2992,29025
2021-03-31,MO,Caldwell,21,3013,29025
2021-04-01,MO,Caldwell,25,3038,29025
2021-04-02,MO,Caldwell,30,3068,29025
2021-04-03,MO,Caldwell,5,3073,29025
2021-04-04,MO,Caldwell,1,3074,29025
2021-04-05,MO,Caldwell,13,3087,29025
2021-04-06,MO,Caldwell,31,3118,29025
2021-04-07,MO,Caldwell,33,3151,29025
2021-04-08,MO,Caldwell,49,3200,29025
2021-04-09,MO,Caldwell,62,3262,29025
2021-04-10,MO,Caldwell,36,3298,29025
2021-04-11,MO,Caldwell,3,3301,29025
2021-04-12,MO,Caldwell,46,3347,29025
2021-04-13,MO,Caldwell,29,3376,29025
2021-04-14,MO,Caldwell,59,3435,29025
2021-04-15,MO,Caldwell,69,3504,29025
2021-04-16,MO,Caldwell,56,3560,29025
2021-04-17,MO,Caldwell,6,3566,29025
2021-04-18,MO,Caldwell,4,3570,29025
2021-04-19,MO,Caldwell,9,3579,29025
2021-04-20,MO,Caldwell,28,3607,29025
2021-04-21,MO,Caldwell,23,3630,29025
2021-04-22,MO,Caldwell,45,3675,29025
2021-04-23,MO,Caldwell,20,3695,29025
2021-04-24,MO,Caldwell,8,3703,29025
2021-04-25,MO,Caldwell,2,3705,29025
2021-04-26,MO,Caldwell,6,3711,29025
2021-04-27,MO,Caldwell,25,3736,29025
2021-04-28,MO,Caldwell,21,3757,29025
2021-04-29,MO,Caldwell,29,3786,29025
2021-04-30,MO,Caldwell,26,3812,29025
2021-05-01,MO,Caldwell,21,3833,29025
2021-05-02,MO,Caldwell,3,3836,29025
2021-05-03,MO,Caldwell,9,3845,29025
2021-05-04,MO,Caldwell,13,3858,29025
2021-05-05,MO,Caldwell,21,3879,29025
2021-05-06,MO,Caldwell,39,3918,29025
2021-05-07,MO,Caldwell,15,3933,29025
2021-05-08,MO,Caldwell,14,3947,29025
2021-05-09,MO,Caldwell,1,3948,29025
2021-05-10,MO,Caldwell,5,3953,29025
2021-05-11,MO,Caldwell,29,3982,29025
2021-05-12,MO,Caldwell,27,4009,29025
2021-05-13,MO,Caldwell,26,4035,29025
2021-05-14,MO,Caldwell,30,4065,29025
2021-05-15,MO,Caldwell,29,4094,29025
2021-05-16,MO,Caldwell,6,4100,29025
2021-05-17,MO,Caldwell,16,4116,29025
2021-05-18,MO,Caldwell,25,4141,29025
2021-05-19,MO,Caldwell,28,4169,29025
2021-05-20,MO,Caldwell,25,4194,29025
2021-05-21,MO,Caldwell,14,4208,29025
2021-05-22,MO,Caldwell,7,4215,29025
2021-05-23,MO,Caldwell,2,4217,29025
2021-05-24,MO,Caldwell,5,4222,29025
2021-05-25,MO,Caldwell,23,4245,29025
2021-05-26,MO,Caldwell,14,4259,29025
2021-05-27,MO,Caldwell,21,4280,29025
2020-12-15,MO,Callaway,8,8,29027
2020-12-16,MO,Callaway,23,31,29027
2020-12-17,MO,Callaway,44,75,29027
2020-12-18,MO,Callaway,74,149,29027
2020-12-19,MO,Callaway,27,176,29027
2020-12-20,MO,Callaway,22,198,29027
2020-12-21,MO,Callaway,45,243,29027
2020-12-22,MO,Callaway,51,294,29027
2020-12-23,MO,Callaway,36,330,29027
2020-12-24,MO,Callaway,3,333,29027
2020-12-27,MO,Callaway,4,337,29027
2020-12-28,MO,Callaway,79,416,29027
2020-12-29,MO,Callaway,422,838,29027
2020-12-30,MO,Callaway,145,983,29027
2020-12-31,MO,Callaway,54,1037,29027
2021-01-01,MO,Callaway,1,1038,29027
2021-01-02,MO,Callaway,54,1092,29027
2021-01-03,MO,Callaway,11,1103,29027
2021-01-04,MO,Callaway,83,1186,29027
2021-01-05,MO,Callaway,64,1250,29027
2021-01-06,MO,Callaway,54,1304,29027
2021-01-07,MO,Callaway,78,1382,29027
2021-01-08,MO,Callaway,91,1473,29027
2021-01-09,MO,Callaway,87,1560,29027
2021-01-10,MO,Callaway,25,1585,29027
2021-01-11,MO,Callaway,84,1669,29027
2021-01-12,MO,Callaway,59,1728,29027
2021-01-13,MO,Callaway,43,1771,29027
2021-01-14,MO,Callaway,92,1863,29027
2021-01-15,MO,Callaway,50,1913,29027
2021-01-16,MO,Callaway,16,1929,29027
2021-01-17,MO,Callaway,12,1941,29027
2021-01-18,MO,Callaway,145,2086,29027
2021-01-19,MO,Callaway,418,2504,29027
2021-01-20,MO,Callaway,138,2642,29027
2021-01-21,MO,Callaway,192,2834,29027
2021-01-22,MO,Callaway,159,2993,29027
2021-01-23,MO,Callaway,130,3123,29027
2021-01-24,MO,Callaway,9,3132,29027
2021-01-25,MO,Callaway,129,3261,29027
2021-01-26,MO,Callaway,205,3466,29027
2021-01-27,MO,Callaway,168,3634,29027
2021-01-28,MO,Callaway,226,3860,29027
2021-01-29,MO,Callaway,439,4299,29027
2021-01-30,MO,Callaway,120,4419,29027
2021-01-31,MO,Callaway,25,4444,29027
2021-02-01,MO,Callaway,116,4560,29027
2021-02-02,MO,Callaway,154,4714,29027
2021-02-03,MO,Callaway,247,4961,29027
2021-02-04,MO,Callaway,377,5338,29027
2021-02-05,MO,Callaway,308,5646,29027
2021-02-06,MO,Callaway,218,5864,29027
2021-02-08,MO,Callaway,73,5937,29027
2021-02-09,MO,Callaway,109,6046,29027
2021-02-10,MO,Callaway,351,6397,29027
2021-02-11,MO,Callaway,388,6785,29027
2021-02-12,MO,Callaway,185,6970,29027
2021-02-13,MO,Callaway,131,7101,29027
2021-02-14,MO,Callaway,21,7122,29027
2021-02-15,MO,Callaway,39,7161,29027
2021-02-16,MO,Callaway,143,7304,29027
2021-02-17,MO,Callaway,74,7378,29027
2021-02-18,MO,Callaway,221,7599,29027
2021-02-19,MO,Callaway,296,7895,29027
2021-02-20,MO,Callaway,80,7975,29027
2021-02-21,MO,Callaway,2,7977,29027
2021-02-22,MO,Callaway,298,8275,29027
2021-02-23,MO,Callaway,379,8654,29027
2021-02-24,MO,Callaway,177,8831,29027
2021-02-25,MO,Callaway,499,9330,29027
2021-02-26,MO,Callaway,394,9724,29027
2021-02-27,MO,Callaway,202,9926,29027
2021-02-28,MO,Callaway,10,9936,29027
2021-03-01,MO,Callaway,121,10057,29027
2021-03-02,MO,Callaway,298,10355,29027
2021-03-03,MO,Callaway,357,10712,29027
2021-03-04,MO,Callaway,424,11136,29027
2021-03-05,MO,Callaway,213,11349,29027
2021-03-06,MO,Callaway,185,11534,29027
2021-03-07,MO,Callaway,62,11596,29027
2021-03-08,MO,Callaway,81,11677,29027
2021-03-09,MO,Callaway,229,11906,29027
2021-03-10,MO,Callaway,397,12303,29027
2021-03-11,MO,Callaway,413,12716,29027
2021-03-12,MO,Callaway,284,13000,29027
2021-03-13,MO,Callaway,32,13032,29027
2021-03-14,MO,Callaway,11,13043,29027
2021-03-15,MO,Callaway,121,13164,29027
2021-03-16,MO,Callaway,675,13839,29027
2021-03-17,MO,Callaway,128,13967,29027
2021-03-18,MO,Callaway,186,14153,29027
2021-03-19,MO,Callaway,548,14701,29027
2021-03-20,MO,Callaway,53,14754,29027
2021-03-21,MO,Callaway,52,14806,29027
2021-03-22,MO,Callaway,563,15369,29027
2021-03-23,MO,Callaway,126,15495,29027
2021-03-24,MO,Callaway,173,15668,29027
2021-03-25,MO,Callaway,215,15883,29027
2021-03-26,MO,Callaway,586,16469,29027
2021-03-27,MO,Callaway,172,16641,29027
2021-03-28,MO,Callaway,55,16696,29027
2021-03-29,MO,Callaway,144,16840,29027
2021-03-30,MO,Callaway,152,16992,29027
2021-03-31,MO,Callaway,191,17183,29027
2021-04-01,MO,Callaway,369,17552,29027
2021-04-02,MO,Callaway,399,17951,29027
2021-04-03,MO,Callaway,92,18043,29027
2021-04-04,MO,Callaway,24,18067,29027
2021-04-05,MO,Callaway,199,18266,29027
2021-04-06,MO,Callaway,758,19024,29027
2021-04-07,MO,Callaway,171,19195,29027
2021-04-08,MO,Callaway,224,19419,29027
2021-04-09,MO,Callaway,413,19832,29027
2021-04-10,MO,Callaway,127,19959,29027
2021-04-11,MO,Callaway,47,20006,29027
2021-04-12,MO,Callaway,224,20230,29027
2021-04-13,MO,Callaway,245,20475,29027
2021-04-14,MO,Callaway,228,20703,29027
2021-04-15,MO,Callaway,247,20950,29027
2021-04-16,MO,Callaway,647,21597,29027
2021-04-17,MO,Callaway,127,21724,29027
2021-04-18,MO,Callaway,24,21748,29027
2021-04-19,MO,Callaway,117,21865,29027
2021-04-20,MO,Callaway,161,22026,29027
2021-04-21,MO,Callaway,90,22116,29027
2021-04-22,MO,Callaway,153,22269,29027
2021-04-23,MO,Callaway,154,22423,29027
2021-04-24,MO,Callaway,42,22465,29027
2021-04-25,MO,Callaway,14,22479,29027
2021-04-26,MO,Callaway,164,22643,29027
2021-04-27,MO,Callaway,204,22847,29027
2021-04-28,MO,Callaway,215,23062,29027
2021-04-29,MO,Callaway,146,23208,29027
2021-04-30,MO,Callaway,116,23324,29027
2021-05-01,MO,Callaway,94,23418,29027
2021-05-02,MO,Callaway,45,23463,29027
2021-05-03,MO,Callaway,139,23602,29027
2021-05-04,MO,Callaway,212,23814,29027
2021-05-05,MO,Callaway,147,23961,29027
2021-05-06,MO,Callaway,214,24175,29027
2021-05-07,MO,Callaway,146,24321,29027
2021-05-08,MO,Callaway,92,24413,29027
2021-05-09,MO,Callaway,21,24434,29027
2021-05-10,MO,Callaway,98,24532,29027
2021-05-11,MO,Callaway,71,24603,29027
2021-05-12,MO,Callaway,105,24708,29027
2021-05-13,MO,Callaway,116,24824,29027
2021-05-14,MO,Callaway,107,24931,29027
2021-05-15,MO,Callaway,60,24991,29027
2021-05-16,MO,Callaway,28,25019,29027
2021-05-17,MO,Callaway,93,25112,29027
2021-05-18,MO,Callaway,96,25208,29027
2021-05-19,MO,Callaway,79,25287,29027
2021-05-20,MO,Callaway,156,25443,29027
2021-05-21,MO,Callaway,64,25507,29027
2021-05-22,MO,Callaway,67,25574,29027
2021-05-23,MO,Callaway,20,25594,29027
2021-05-24,MO,Callaway,73,25667,29027
2021-05-25,MO,Callaway,67,25734,29027
2021-05-26,MO,Callaway,66,25800,29027
2021-05-27,MO,Callaway,42,25842,29027
2020-12-15,MO,Camden,5,5,29029
2020-12-16,MO,Camden,5,10,29029
2020-12-17,MO,Camden,12,22,29029
2020-12-18,MO,Camden,19,41,29029
2020-12-19,MO,Camden,4,45,29029
2020-12-20,MO,Camden,3,48,29029
2020-12-21,MO,Camden,102,150,29029
2020-12-22,MO,Camden,146,296,29029
2020-12-23,MO,Camden,79,375,29029
2020-12-26,MO,Camden,1,376,29029
2020-12-27,MO,Camden,1,377,29029
2020-12-28,MO,Camden,95,472,29029
2020-12-29,MO,Camden,173,645,29029
2020-12-30,MO,Camden,73,718,29029
2020-12-31,MO,Camden,7,725,29029
2021-01-01,MO,Camden,1,726,29029
2021-01-02,MO,Camden,1,727,29029
2021-01-04,MO,Camden,25,752,29029
2021-01-05,MO,Camden,24,776,29029
2021-01-06,MO,Camden,35,811,29029
2021-01-07,MO,Camden,51,862,29029
2021-01-08,MO,Camden,24,886,29029
2021-01-09,MO,Camden,4,890,29029
2021-01-10,MO,Camden,2,892,29029
2021-01-11,MO,Camden,144,1036,29029
2021-01-12,MO,Camden,107,1143,29029
2021-01-13,MO,Camden,57,1200,29029
2021-01-14,MO,Camden,65,1265,29029
2021-01-15,MO,Camden,63,1328,29029
2021-01-16,MO,Camden,34,1362,29029
2021-01-17,MO,Camden,3,1365,29029
2021-01-18,MO,Camden,80,1445,29029
2021-01-19,MO,Camden,134,1579,29029
2021-01-20,MO,Camden,100,1679,29029
2021-01-21,MO,Camden,50,1729,29029
2021-01-22,MO,Camden,260,1989,29029
2021-01-23,MO,Camden,28,2017,29029
2021-01-24,MO,Camden,3,2020,29029
2021-01-25,MO,Camden,282,2302,29029
2021-01-26,MO,Camden,110,2412,29029
2021-01-27,MO,Camden,446,2858,29029
2021-01-28,MO,Camden,97,2955,29029
2021-01-29,MO,Camden,414,3369,29029
2021-01-30,MO,Camden,30,3399,29029
2021-01-31,MO,Camden,4,3403,29029
2021-02-01,MO,Camden,295,3698,29029
2021-02-02,MO,Camden,109,3807,29029
2021-02-03,MO,Camden,399,4206,29029
2021-02-04,MO,Camden,190,4396,29029
2021-02-05,MO,Camden,409,4805,29029
2021-02-06,MO,Camden,350,5155,29029
2021-02-07,MO,Camden,2,5157,29029
2021-02-08,MO,Camden,130,5287,29029
2021-02-09,MO,Camden,48,5335,29029
2021-02-10,MO,Camden,171,5506,29029
2021-02-11,MO,Camden,480,5986,29029
2021-02-12,MO,Camden,547,6533,29029
2021-02-13,MO,Camden,77,6610,29029
2021-02-14,MO,Camden,9,6619,29029
2021-02-15,MO,Camden,19,6638,29029
2021-02-16,MO,Camden,47,6685,29029
2021-02-17,MO,Camden,25,6710,29029
2021-02-18,MO,Camden,89,6799,29029
2021-02-19,MO,Camden,680,7479,29029
2021-02-20,MO,Camden,20,7499,29029
2021-02-21,MO,Camden,6,7505,29029
2021-02-22,MO,Camden,612,8117,29029
2021-02-23,MO,Camden,279,8396,29029
2021-02-24,MO,Camden,498,8894,29029
2021-02-25,MO,Camden,662,9556,29029
2021-02-26,MO,Camden,718,10274,29029
2021-02-27,MO,Camden,95,10369,29029
2021-02-28,MO,Camden,20,10389,29029
2021-03-01,MO,Camden,169,10558,29029
2021-03-02,MO,Camden,200,10758,29029
2021-03-03,MO,Camden,318,11076,29029
2021-03-04,MO,Camden,292,11368,29029
2021-03-05,MO,Camden,303,11671,29029
2021-03-06,MO,Camden,347,12018,29029
2021-03-07,MO,Camden,1089,13107,29029
2021-03-08,MO,Camden,153,13260,29029
2021-03-09,MO,Camden,126,13386,29029
2021-03-10,MO,Camden,222,13608,29029
2021-03-11,MO,Camden,680,14288,29029
2021-03-12,MO,Camden,541,14829,29029
2021-03-13,MO,Camden,44,14873,29029
2021-03-14,MO,Camden,12,14885,29029
2021-03-15,MO,Camden,167,15052,29029
2021-03-16,MO,Camden,275,15327,29029
2021-03-17,MO,Camden,267,15594,29029
2021-03-18,MO,Camden,206,15800,29029
2021-03-19,MO,Camden,468,16268,29029
2021-03-20,MO,Camden,66,16334,29029
2021-03-21,MO,Camden,33,16367,29029
2021-03-22,MO,Camden,483,16850,29029
2021-03-23,MO,Camden,234,17084,29029
2021-03-24,MO,Camden,274,17358,29029
2021-03-25,MO,Camden,682,18040,29029
2021-03-26,MO,Camden,262,18302,29029
2021-03-27,MO,Camden,63,18365,29029
2021-03-28,MO,Camden,43,18408,29029
2021-03-29,MO,Camden,186,18594,29029
2021-03-30,MO,Camden,185,18779,29029
2021-03-31,MO,Camden,276,19055,29029
2021-04-01,MO,Camden,255,19310,29029
2021-04-02,MO,Camden,373,19683,29029
2021-04-03,MO,Camden,68,19751,29029
2021-04-04,MO,Camden,16,19767,29029
2021-04-05,MO,Camden,187,19954,29029
2021-04-06,MO,Camden,209,20163,29029
2021-04-07,MO,Camden,247,20410,29029
2021-04-08,MO,Camden,257,20667,29029
2021-04-09,MO,Camden,309,20976,29029
2021-04-10,MO,Camden,52,21028,29029
2021-04-11,MO,Camden,39,21067,29029
2021-04-12,MO,Camden,195,21262,29029
2021-04-13,MO,Camden,219,21481,29029
2021-04-14,MO,Camden,204,21685,29029
2021-04-15,MO,Camden,148,21833,29029
2021-04-16,MO,Camden,249,22082,29029
2021-04-17,MO,Camden,44,22126,29029
2021-04-18,MO,Camden,41,22167,29029
2021-04-19,MO,Camden,160,22327,29029
2021-04-20,MO,Camden,148,22475,29029
2021-04-21,MO,Camden,132,22607,29029
2021-04-22,MO,Camden,196,22803,29029
2021-04-23,MO,Camden,122,22925,29029
2021-04-24,MO,Camden,35,22960,29029
2021-04-25,MO,Camden,23,22983,29029
2021-04-26,MO,Camden,130,23113,29029
2021-04-27,MO,Camden,119,23232,29029
2021-04-28,MO,Camden,194,23426,29029
2021-04-29,MO,Camden,198,23624,29029
2021-04-30,MO,Camden,192,23816,29029
2021-05-01,MO,Camden,29,23845,29029
2021-05-02,MO,Camden,29,23874,29029
2021-05-03,MO,Camden,80,23954,29029
2021-05-04,MO,Camden,103,24057,29029
2021-05-05,MO,Camden,223,24280,29029
2021-05-06,MO,Camden,160,24440,29029
2021-05-07,MO,Camden,149,24589,29029
2021-05-08,MO,Camden,50,24639,29029
2021-05-09,MO,Camden,15,24654,29029
2021-05-10,MO,Camden,88,24742,29029
2021-05-11,MO,Camden,167,24909,29029
2021-05-12,MO,Camden,152,25061,29029
2021-05-13,MO,Camden,119,25180,29029
2021-05-14,MO,Camden,130,25310,29029
2021-05-15,MO,Camden,55,25365,29029
2021-05-16,MO,Camden,33,25398,29029
2021-05-17,MO,Camden,112,25510,29029
2021-05-18,MO,Camden,201,25711,29029
2021-05-19,MO,Camden,118,25829,29029
2021-05-20,MO,Camden,116,25945,29029
2021-05-21,MO,Camden,96,26041,29029
2021-05-22,MO,Camden,34,26075,29029
2021-05-23,MO,Camden,7,26082,29029
2021-05-24,MO,Camden,69,26151,29029
2021-05-25,MO,Camden,55,26206,29029
2021-05-26,MO,Camden,80,26286,29029
2021-05-27,MO,Camden,36,26322,29029
2020-12-15,MO,Cape Girardeau,8,8,29031
2020-12-16,MO,Cape Girardeau,16,24,29031
2020-12-17,MO,Cape Girardeau,173,197,29031
2020-12-18,MO,Cape Girardeau,152,349,29031
2020-12-19,MO,Cape Girardeau,21,370,29031
2020-12-20,MO,Cape Girardeau,6,376,29031
2020-12-21,MO,Cape Girardeau,557,933,29031
2020-12-22,MO,Cape Girardeau,567,1500,29031
2020-12-23,MO,Cape Girardeau,180,1680,29031
2020-12-24,MO,Cape Girardeau,74,1754,29031
2020-12-26,MO,Cape Girardeau,3,1757,29031
2020-12-27,MO,Cape Girardeau,2,1759,29031
2020-12-28,MO,Cape Girardeau,49,1808,29031
2020-12-29,MO,Cape Girardeau,90,1898,29031
2020-12-30,MO,Cape Girardeau,367,2265,29031
2020-12-31,MO,Cape Girardeau,143,2408,29031
2021-01-01,MO,Cape Girardeau,3,2411,29031
2021-01-02,MO,Cape Girardeau,10,2421,29031
2021-01-03,MO,Cape Girardeau,6,2427,29031
2021-01-04,MO,Cape Girardeau,56,2483,29031
2021-01-05,MO,Cape Girardeau,258,2741,29031
2021-01-06,MO,Cape Girardeau,151,2892,29031
2021-01-07,MO,Cape Girardeau,233,3125,29031
2021-01-08,MO,Cape Girardeau,307,3432,29031
2021-01-09,MO,Cape Girardeau,184,3616,29031
2021-01-10,MO,Cape Girardeau,5,3621,29031
2021-01-11,MO,Cape Girardeau,533,4154,29031
2021-01-12,MO,Cape Girardeau,447,4601,29031
2021-01-13,MO,Cape Girardeau,387,4988,29031
2021-01-14,MO,Cape Girardeau,208,5196,29031
2021-01-15,MO,Cape Girardeau,375,5571,29031
2021-01-16,MO,Cape Girardeau,105,5676,29031
2021-01-17,MO,Cape Girardeau,2,5678,29031
2021-01-18,MO,Cape Girardeau,609,6287,29031
2021-01-19,MO,Cape Girardeau,1064,7351,29031
2021-01-20,MO,Cape Girardeau,1477,8828,29031
2021-01-21,MO,Cape Girardeau,791,9619,29031
2021-01-22,MO,Cape Girardeau,1628,11247,29031
2021-01-23,MO,Cape Girardeau,18,11265,29031
2021-01-24,MO,Cape Girardeau,12,11277,29031
2021-01-25,MO,Cape Girardeau,718,11995,29031
2021-01-26,MO,Cape Girardeau,554,12549,29031
2021-01-27,MO,Cape Girardeau,388,12937,29031
2021-01-28,MO,Cape Girardeau,210,13147,29031
2021-01-29,MO,Cape Girardeau,770,13917,29031
2021-01-30,MO,Cape Girardeau,17,13934,29031
2021-02-01,MO,Cape Girardeau,170,14104,29031
2021-02-02,MO,Cape Girardeau,367,14471,29031
2021-02-03,MO,Cape Girardeau,172,14643,29031
2021-02-04,MO,Cape Girardeau,321,14964,29031
2021-02-05,MO,Cape Girardeau,948,15912,29031
2021-02-06,MO,Cape Girardeau,35,15947,29031
2021-02-07,MO,Cape Girardeau,2,15949,29031
2021-02-08,MO,Cape Girardeau,343,16292,29031
2021-02-09,MO,Cape Girardeau,1668,17960,29031
2021-02-10,MO,Cape Girardeau,1027,18987,29031
2021-02-11,MO,Cape Girardeau,621,19608,29031
2021-02-12,MO,Cape Girardeau,1255,20863,29031
2021-02-13,MO,Cape Girardeau,40,20903,29031
2021-02-14,MO,Cape Girardeau,14,20917,29031
2021-02-15,MO,Cape Girardeau,412,21329,29031
2021-02-16,MO,Cape Girardeau,261,21590,29031
2021-02-17,MO,Cape Girardeau,143,21733,29031
2021-02-18,MO,Cape Girardeau,46,21779,29031
2021-02-19,MO,Cape Girardeau,324,22103,29031
2021-02-20,MO,Cape Girardeau,485,22588,29031
2021-02-21,MO,Cape Girardeau,2,22590,29031
2021-02-22,MO,Cape Girardeau,570,23160,29031
2021-02-23,MO,Cape Girardeau,603,23763,29031
2021-02-24,MO,Cape Girardeau,696,24459,29031
2021-02-25,MO,Cape Girardeau,79,24538,29031
2021-02-26,MO,Cape Girardeau,420,24958,29031
2021-02-27,MO,Cape Girardeau,538,25496,29031
2021-02-28,MO,Cape Girardeau,10,25506,29031
2021-03-01,MO,Cape Girardeau,162,25668,29031
2021-03-02,MO,Cape Girardeau,616,26284,29031
2021-03-03,MO,Cape Girardeau,1035,27319,29031
2021-03-04,MO,Cape Girardeau,150,27469,29031
2021-03-05,MO,Cape Girardeau,429,27898,29031
2021-03-06,MO,Cape Girardeau,43,27941,29031
2021-03-07,MO,Cape Girardeau,7,27948,29031
2021-03-08,MO,Cape Girardeau,663,28611,29031
2021-03-09,MO,Cape Girardeau,500,29111,29031
2021-03-10,MO,Cape Girardeau,1093,30204,29031
2021-03-11,MO,Cape Girardeau,202,30406,29031
2021-03-12,MO,Cape Girardeau,407,30813,29031
2021-03-13,MO,Cape Girardeau,113,30926,29031
2021-03-14,MO,Cape Girardeau,75,31001,29031
2021-03-15,MO,Cape Girardeau,470,31471,29031
2021-03-16,MO,Cape Girardeau,302,31773,29031
2021-03-17,MO,Cape Girardeau,240,32013,29031
2021-03-18,MO,Cape Girardeau,170,32183,29031
2021-03-19,MO,Cape Girardeau,1305,33488,29031
2021-03-20,MO,Cape Girardeau,66,33554,29031
2021-03-21,MO,Cape Girardeau,27,33581,29031
2021-03-22,MO,Cape Girardeau,237,33818,29031
2021-03-23,MO,Cape Girardeau,242,34060,29031
2021-03-24,MO,Cape Girardeau,341,34401,29031
2021-03-25,MO,Cape Girardeau,315,34716,29031
2021-03-26,MO,Cape Girardeau,385,35101,29031
2021-03-27,MO,Cape Girardeau,47,35148,29031
2021-03-28,MO,Cape Girardeau,32,35180,29031
2021-03-29,MO,Cape Girardeau,346,35526,29031
2021-03-30,MO,Cape Girardeau,853,36379,29031
2021-03-31,MO,Cape Girardeau,1069,37448,29031
2021-04-01,MO,Cape Girardeau,296,37744,29031
2021-04-02,MO,Cape Girardeau,491,38235,29031
2021-04-03,MO,Cape Girardeau,56,38291,29031
2021-04-04,MO,Cape Girardeau,31,38322,29031
2021-04-05,MO,Cape Girardeau,464,38786,29031
2021-04-06,MO,Cape Girardeau,964,39750,29031
2021-04-07,MO,Cape Girardeau,1442,41192,29031
2021-04-08,MO,Cape Girardeau,169,41361,29031
2021-04-09,MO,Cape Girardeau,1339,42700,29031
2021-04-10,MO,Cape Girardeau,112,42812,29031
2021-04-11,MO,Cape Girardeau,89,42901,29031
2021-04-12,MO,Cape Girardeau,451,43352,29031
2021-04-13,MO,Cape Girardeau,299,43651,29031
2021-04-14,MO,Cape Girardeau,367,44018,29031
2021-04-15,MO,Cape Girardeau,257,44275,29031
2021-04-16,MO,Cape Girardeau,582,44857,29031
2021-04-17,MO,Cape Girardeau,68,44925,29031
2021-04-18,MO,Cape Girardeau,26,44951,29031
2021-04-19,MO,Cape Girardeau,355,45306,29031
2021-04-20,MO,Cape Girardeau,395,45701,29031
2021-04-21,MO,Cape Girardeau,241,45942,29031
2021-04-22,MO,Cape Girardeau,317,46259,29031
2021-04-23,MO,Cape Girardeau,199,46458,29031
2021-04-24,MO,Cape Girardeau,126,46584,29031
2021-04-25,MO,Cape Girardeau,35,46619,29031
2021-04-26,MO,Cape Girardeau,145,46764,29031
2021-04-27,MO,Cape Girardeau,162,46926,29031
2021-04-28,MO,Cape Girardeau,142,47068,29031
2021-04-29,MO,Cape Girardeau,100,47168,29031
2021-04-30,MO,Cape Girardeau,638,47806,29031
2021-05-01,MO,Cape Girardeau,58,47864,29031
2021-05-02,MO,Cape Girardeau,53,47917,29031
2021-05-03,MO,Cape Girardeau,223,48140,29031
2021-05-04,MO,Cape Girardeau,401,48541,29031
2021-05-05,MO,Cape Girardeau,127,48668,29031
2021-05-06,MO,Cape Girardeau,174,48842,29031
2021-05-07,MO,Cape Girardeau,267,49109,29031
2021-05-08,MO,Cape Girardeau,65,49174,29031
2021-05-09,MO,Cape Girardeau,50,49224,29031
2021-05-10,MO,Cape Girardeau,236,49460,29031
2021-05-11,MO,Cape Girardeau,139,49599,29031
2021-05-12,MO,Cape Girardeau,110,49709,29031
2021-05-13,MO,Cape Girardeau,118,49827,29031
2021-05-14,MO,Cape Girardeau,267,50094,29031
2021-05-15,MO,Cape Girardeau,163,50257,29031
2021-05-16,MO,Cape Girardeau,40,50297,29031
2021-05-17,MO,Cape Girardeau,125,50422,29031
2021-05-18,MO,Cape Girardeau,83,50505,29031
2021-05-19,MO,Cape Girardeau,158,50663,29031
2021-05-20,MO,Cape Girardeau,50,50713,29031
2021-05-21,MO,Cape Girardeau,204,50917,29031
2021-05-22,MO,Cape Girardeau,36,50953,29031
2021-05-23,MO,Cape Girardeau,18,50971,29031
2021-05-24,MO,Cape Girardeau,89,51060,29031
2021-05-25,MO,Cape Girardeau,108,51168,29031
2021-05-26,MO,Cape Girardeau,126,51294,29031
2021-05-27,MO,Cape Girardeau,22,51316,29031
2020-12-16,MO,Carroll,2,2,29033
2020-12-18,MO,Carroll,1,3,29033
2020-12-21,MO,Carroll,2,5,29033
2020-12-22,MO,Carroll,5,10,29033
2020-12-23,MO,Carroll,2,12,29033
2020-12-28,MO,Carroll,10,22,29033
2020-12-29,MO,Carroll,60,82,29033
2020-12-30,MO,Carroll,35,117,29033
2020-12-31,MO,Carroll,16,133,29033
2021-01-02,MO,Carroll,2,135,29033
2021-01-04,MO,Carroll,1,136,29033
2021-01-05,MO,Carroll,19,155,29033
2021-01-06,MO,Carroll,14,169,29033
2021-01-07,MO,Carroll,33,202,29033
2021-01-08,MO,Carroll,6,208,29033
2021-01-09,MO,Carroll,3,211,29033
2021-01-11,MO,Carroll,12,223,29033
2021-01-12,MO,Carroll,10,233,29033
2021-01-13,MO,Carroll,9,242,29033
2021-01-14,MO,Carroll,5,247,29033
2021-01-15,MO,Carroll,12,259,29033
2021-01-16,MO,Carroll,1,260,29033
2021-01-18,MO,Carroll,20,280,29033
2021-01-19,MO,Carroll,103,383,29033
2021-01-20,MO,Carroll,61,444,29033
2021-01-21,MO,Carroll,10,454,29033
2021-01-22,MO,Carroll,15,469,29033
2021-01-25,MO,Carroll,10,479,29033
2021-01-26,MO,Carroll,22,501,29033
2021-01-27,MO,Carroll,128,629,29033
2021-01-28,MO,Carroll,60,689,29033
2021-01-29,MO,Carroll,23,712,29033
2021-01-30,MO,Carroll,17,729,29033
2021-01-31,MO,Carroll,2,731,29033
2021-02-01,MO,Carroll,25,756,29033
2021-02-02,MO,Carroll,30,786,29033
2021-02-03,MO,Carroll,201,987,29033
2021-02-04,MO,Carroll,96,1083,29033
2021-02-05,MO,Carroll,24,1107,29033
2021-02-06,MO,Carroll,4,1111,29033
2021-02-08,MO,Carroll,16,1127,29033
2021-02-09,MO,Carroll,25,1152,29033
2021-02-10,MO,Carroll,13,1165,29033
2021-02-11,MO,Carroll,21,1186,29033
2021-02-12,MO,Carroll,30,1216,29033
2021-02-13,MO,Carroll,11,1227,29033
2021-02-14,MO,Carroll,2,1229,29033
2021-02-15,MO,Carroll,28,1257,29033
2021-02-16,MO,Carroll,109,1366,29033
2021-02-17,MO,Carroll,145,1511,29033
2021-02-18,MO,Carroll,72,1583,29033
2021-02-19,MO,Carroll,10,1593,29033
2021-02-20,MO,Carroll,12,1605,29033
2021-02-22,MO,Carroll,25,1630,29033
2021-02-23,MO,Carroll,27,1657,29033
2021-02-24,MO,Carroll,209,1866,29033
2021-02-25,MO,Carroll,237,2103,29033
2021-02-26,MO,Carroll,388,2491,29033
2021-02-27,MO,Carroll,14,2505,29033
2021-02-28,MO,Carroll,1,2506,29033
2021-03-01,MO,Carroll,15,2521,29033
2021-03-02,MO,Carroll,68,2589,29033
2021-03-03,MO,Carroll,25,2614,29033
2021-03-04,MO,Carroll,45,2659,29033
2021-03-05,MO,Carroll,34,2693,29033
2021-03-06,MO,Carroll,22,2715,29033
2021-03-07,MO,Carroll,2,2717,29033
2021-03-08,MO,Carroll,12,2729,29033
2021-03-09,MO,Carroll,17,2746,29033
2021-03-10,MO,Carroll,23,2769,29033
2021-03-11,MO,Carroll,13,2782,29033
2021-03-12,MO,Carroll,91,2873,29033
2021-03-13,MO,Carroll,11,2884,29033
2021-03-14,MO,Carroll,7,2891,29033
2021-03-15,MO,Carroll,38,2929,29033
2021-03-16,MO,Carroll,219,3148,29033
2021-03-17,MO,Carroll,71,3219,29033
2021-03-18,MO,Carroll,66,3285,29033
2021-03-19,MO,Carroll,113,3398,29033
2021-03-20,MO,Carroll,9,3407,29033
2021-03-21,MO,Carroll,1,3408,29033
2021-03-22,MO,Carroll,12,3420,29033
2021-03-23,MO,Carroll,15,3435,29033
2021-03-24,MO,Carroll,51,3486,29033
2021-03-25,MO,Carroll,220,3706,29033
2021-03-26,MO,Carroll,394,4100,29033
2021-03-27,MO,Carroll,5,4105,29033
2021-03-29,MO,Carroll,24,4129,29033
2021-03-30,MO,Carroll,49,4178,29033
2021-03-31,MO,Carroll,12,4190,29033
2021-04-01,MO,Carroll,32,4222,29033
2021-04-02,MO,Carroll,41,4263,29033
2021-04-03,MO,Carroll,1,4264,29033
2021-04-05,MO,Carroll,15,4279,29033
2021-04-06,MO,Carroll,15,4294,29033
2021-04-07,MO,Carroll,28,4322,29033
2021-04-08,MO,Carroll,29,4351,29033
2021-04-09,MO,Carroll,48,4399,29033
2021-04-10,MO,Carroll,5,4404,29033
2021-04-11,MO,Carroll,1,4405,29033
2021-04-12,MO,Carroll,27,4432,29033
2021-04-13,MO,Carroll,189,4621,29033
2021-04-14,MO,Carroll,20,4641,29033
2021-04-15,MO,Carroll,18,4659,29033
2021-04-16,MO,Carroll,100,4759,29033
2021-04-17,MO,Carroll,7,4766,29033
2021-04-19,MO,Carroll,11,4777,29033
2021-04-20,MO,Carroll,13,4790,29033
2021-04-21,MO,Carroll,9,4799,29033
2021-04-22,MO,Carroll,29,4828,29033
2021-04-23,MO,Carroll,43,4871,29033
2021-04-26,MO,Carroll,6,4877,29033
2021-04-27,MO,Carroll,16,4893,29033
2021-04-28,MO,Carroll,15,4908,29033
2021-04-29,MO,Carroll,13,4921,29033
2021-04-30,MO,Carroll,19,4940,29033
2021-05-01,MO,Carroll,4,4944,29033
2021-05-03,MO,Carroll,21,4965,29033
2021-05-04,MO,Carroll,8,4973,29033
2021-05-05,MO,Carroll,25,4998,29033
2021-05-06,MO,Carroll,22,5020,29033
2021-05-07,MO,Carroll,16,5036,29033
2021-05-08,MO,Carroll,3,5039,29033
2021-05-09,MO,Carroll,2,5041,29033
2021-05-10,MO,Carroll,12,5053,29033
2021-05-11,MO,Carroll,26,5079,29033
2021-05-12,MO,Carroll,19,5098,29033
2021-05-13,MO,Carroll,6,5104,29033
2021-05-14,MO,Carroll,55,5159,29033
2021-05-15,MO,Carroll,10,5169,29033
2021-05-16,MO,Carroll,1,5170,29033
2021-05-17,MO,Carroll,4,5174,29033
2021-05-18,MO,Carroll,11,5185,29033
2021-05-19,MO,Carroll,27,5212,29033
2021-05-20,MO,Carroll,21,5233,29033
2021-05-21,MO,Carroll,20,5253,29033
2021-05-22,MO,Carroll,4,5257,29033
2021-05-23,MO,Carroll,2,5259,29033
2021-05-24,MO,Carroll,6,5265,29033
2021-05-25,MO,Carroll,21,5286,29033
2021-05-26,MO,Carroll,12,5298,29033
2021-05-27,MO,Carroll,3,5301,29033
2020-12-17,MO,Carter,2,2,29035
2020-12-18,MO,Carter,1,3,29035
2020-12-21,MO,Carter,1,4,29035
2020-12-22,MO,Carter,2,6,29035
2020-12-23,MO,Carter,5,11,29035
2020-12-26,MO,Carter,1,12,29035
2020-12-27,MO,Carter,1,13,29035
2020-12-28,MO,Carter,2,15,29035
2020-12-29,MO,Carter,4,19,29035
2020-12-30,MO,Carter,1,20,29035
2020-12-31,MO,Carter,1,21,29035
2021-01-03,MO,Carter,1,22,29035
2021-01-04,MO,Carter,4,26,29035
2021-01-05,MO,Carter,10,36,29035
2021-01-06,MO,Carter,8,44,29035
2021-01-07,MO,Carter,12,56,29035
2021-01-08,MO,Carter,5,61,29035
2021-01-09,MO,Carter,24,85,29035
2021-01-11,MO,Carter,5,90,29035
2021-01-12,MO,Carter,1,91,29035
2021-01-13,MO,Carter,18,109,29035
2021-01-14,MO,Carter,10,119,29035
2021-01-15,MO,Carter,5,124,29035
2021-01-16,MO,Carter,1,125,29035
2021-01-18,MO,Carter,3,128,29035
2021-01-19,MO,Carter,7,135,29035
2021-01-20,MO,Carter,4,139,29035
2021-01-21,MO,Carter,4,143,29035
2021-01-22,MO,Carter,69,212,29035
2021-01-23,MO,Carter,6,218,29035
2021-01-24,MO,Carter,3,221,29035
2021-01-25,MO,Carter,19,240,29035
2021-01-26,MO,Carter,12,252,29035
2021-01-27,MO,Carter,7,259,29035
2021-01-28,MO,Carter,81,340,29035
2021-01-29,MO,Carter,235,575,29035
2021-01-30,MO,Carter,2,577,29035
2021-02-01,MO,Carter,26,603,29035
2021-02-02,MO,Carter,2,605,29035
2021-02-03,MO,Carter,5,610,29035
2021-02-04,MO,Carter,89,699,29035
2021-02-05,MO,Carter,13,712,29035
2021-02-06,MO,Carter,48,760,29035
2021-02-08,MO,Carter,9,769,29035
2021-02-09,MO,Carter,7,776,29035
2021-02-10,MO,Carter,10,786,29035
2021-02-11,MO,Carter,4,790,29035
2021-02-12,MO,Carter,90,880,29035
2021-02-13,MO,Carter,6,886,29035
2021-02-14,MO,Carter,2,888,29035
2021-02-15,MO,Carter,6,894,29035
2021-02-16,MO,Carter,2,896,29035
2021-02-17,MO,Carter,2,898,29035
2021-02-18,MO,Carter,16,914,29035
2021-02-19,MO,Carter,8,922,29035
2021-02-20,MO,Carter,4,926,29035
2021-02-21,MO,Carter,1,927,29035
2021-02-22,MO,Carter,31,958,29035
2021-02-23,MO,Carter,81,1039,29035
2021-02-24,MO,Carter,10,1049,29035
2021-02-25,MO,Carter,264,1313,29035
2021-02-26,MO,Carter,9,1322,29035
2021-02-27,MO,Carter,7,1329,29035
2021-03-01,MO,Carter,17,1346,29035
2021-03-02,MO,Carter,8,1354,29035
2021-03-03,MO,Carter,9,1363,29035
2021-03-04,MO,Carter,86,1449,29035
2021-03-05,MO,Carter,11,1460,29035
2021-03-06,MO,Carter,26,1486,29035
2021-03-07,MO,Carter,1,1487,29035
2021-03-08,MO,Carter,6,1493,29035
2021-03-09,MO,Carter,41,1534,29035
2021-03-10,MO,Carter,19,1553,29035
2021-03-11,MO,Carter,18,1571,29035
2021-03-12,MO,Carter,9,1580,29035
2021-03-13,MO,Carter,3,1583,29035
2021-03-14,MO,Carter,1,1584,29035
2021-03-15,MO,Carter,5,1589,29035
2021-03-16,MO,Carter,24,1613,29035
2021-03-17,MO,Carter,7,1620,29035
2021-03-18,MO,Carter,39,1659,29035
2021-03-19,MO,Carter,9,1668,29035
2021-03-20,MO,Carter,5,1673,29035
2021-03-22,MO,Carter,1,1674,29035
2021-03-23,MO,Carter,72,1746,29035
2021-03-24,MO,Carter,18,1764,29035
2021-03-25,MO,Carter,2,1766,29035
2021-03-26,MO,Carter,4,1770,29035
2021-03-27,MO,Carter,6,1776,29035
2021-03-28,MO,Carter,2,1778,29035
2021-03-29,MO,Carter,18,1796,29035
2021-03-30,MO,Carter,17,1813,29035
2021-03-31,MO,Carter,15,1828,29035
2021-04-01,MO,Carter,18,1846,29035
2021-04-02,MO,Carter,9,1855,29035
2021-04-03,MO,Carter,3,1858,29035
2021-04-04,MO,Carter,3,1861,29035
2021-04-05,MO,Carter,5,1866,29035
2021-04-06,MO,Carter,10,1876,29035
2021-04-07,MO,Carter,37,1913,29035
2021-04-08,MO,Carter,42,1955,29035
2021-04-09,MO,Carter,31,1986,29035
2021-04-10,MO,Carter,6,1992,29035
2021-04-11,MO,Carter,2,1994,29035
2021-04-12,MO,Carter,15,2009,29035
2021-04-13,MO,Carter,28,2037,29035
2021-04-14,MO,Carter,9,2046,29035
2021-04-15,MO,Carter,35,2081,29035
2021-04-16,MO,Carter,10,2091,29035
2021-04-17,MO,Carter,3,2094,29035
2021-04-18,MO,Carter,3,2097,29035
2021-04-19,MO,Carter,6,2103,29035
2021-04-20,MO,Carter,10,2113,29035
2021-04-21,MO,Carter,12,2125,29035
2021-04-22,MO,Carter,16,2141,29035
2021-04-23,MO,Carter,11,2152,29035
2021-04-24,MO,Carter,5,2157,29035
2021-04-25,MO,Carter,5,2162,29035
2021-04-26,MO,Carter,6,2168,29035
2021-04-27,MO,Carter,5,2173,29035
2021-04-28,MO,Carter,6,2179,29035
2021-04-29,MO,Carter,19,2198,29035
2021-04-30,MO,Carter,10,2208,29035
2021-05-01,MO,Carter,3,2211,29035
2021-05-02,MO,Carter,3,2214,29035
2021-05-03,MO,Carter,5,2219,29035
2021-05-04,MO,Carter,8,2227,29035
2021-05-05,MO,Carter,13,2240,29035
2021-05-06,MO,Carter,4,2244,29035
2021-05-07,MO,Carter,12,2256,29035
2021-05-08,MO,Carter,5,2261,29035
2021-05-09,MO,Carter,2,2263,29035
2021-05-10,MO,Carter,5,2268,29035
2021-05-11,MO,Carter,10,2278,29035
2021-05-12,MO,Carter,6,2284,29035
2021-05-13,MO,Carter,32,2316,29035
2021-05-14,MO,Carter,13,2329,29035
2021-05-15,MO,Carter,1,2330,29035
2021-05-17,MO,Carter,3,2333,29035
2021-05-18,MO,Carter,5,2338,29035
2021-05-19,MO,Carter,10,2348,29035
2021-05-20,MO,Carter,12,2360,29035
2021-05-21,MO,Carter,9,2369,29035
2021-05-22,MO,Carter,4,2373,29035
2021-05-23,MO,Carter,2,2375,29035
2021-05-24,MO,Carter,5,2380,29035
2021-05-25,MO,Carter,11,2391,29035
2021-05-26,MO,Carter,2,2393,29035
2021-05-27,MO,Carter,2,2395,29035
2020-12-14,MO,Cass,1,1,29037
2020-12-15,MO,Cass,5,6,29037
2020-12-16,MO,Cass,9,15,29037
2020-12-17,MO,Cass,11,26,29037
2020-12-18,MO,Cass,66,92,29037
2020-12-19,MO,Cass,23,115,29037
2020-12-20,MO,Cass,6,121,29037
2020-12-21,MO,Cass,72,193,29037
2020-12-22,MO,Cass,138,331,29037
2020-12-23,MO,Cass,130,461,29037
2020-12-24,MO,Cass,39,500,29037
2020-12-26,MO,Cass,18,518,29037
2020-12-27,MO,Cass,6,524,29037
2020-12-28,MO,Cass,63,587,29037
2020-12-29,MO,Cass,151,738,29037
2020-12-30,MO,Cass,97,835,29037
2020-12-31,MO,Cass,164,999,29037
2021-01-02,MO,Cass,25,1024,29037
2021-01-03,MO,Cass,2,1026,29037
2021-01-04,MO,Cass,77,1103,29037
2021-01-05,MO,Cass,46,1149,29037
2021-01-06,MO,Cass,184,1333,29037
2021-01-07,MO,Cass,222,1555,29037
2021-01-08,MO,Cass,279,1834,29037
2021-01-09,MO,Cass,47,1881,29037
2021-01-10,MO,Cass,4,1885,29037
2021-01-11,MO,Cass,128,2013,29037
2021-01-12,MO,Cass,183,2196,29037
2021-01-13,MO,Cass,192,2388,29037
2021-01-14,MO,Cass,86,2474,29037
2021-01-15,MO,Cass,219,2693,29037
2021-01-16,MO,Cass,20,2713,29037
2021-01-18,MO,Cass,33,2746,29037
2021-01-19,MO,Cass,121,2867,29037
2021-01-20,MO,Cass,492,3359,29037
2021-01-21,MO,Cass,331,3690,29037
2021-01-22,MO,Cass,200,3890,29037
2021-01-23,MO,Cass,152,4042,29037
2021-01-24,MO,Cass,4,4046,29037
2021-01-25,MO,Cass,117,4163,29037
2021-01-26,MO,Cass,284,4447,29037
2021-01-27,MO,Cass,173,4620,29037
2021-01-28,MO,Cass,240,4860,29037
2021-01-29,MO,Cass,612,5472,29037
2021-01-30,MO,Cass,223,5695,29037
2021-01-31,MO,Cass,38,5733,29037
2021-02-01,MO,Cass,284,6017,29037
2021-02-02,MO,Cass,321,6338,29037
2021-02-03,MO,Cass,510,6848,29037
2021-02-04,MO,Cass,273,7121,29037
2021-02-05,MO,Cass,479,7600,29037
2021-02-06,MO,Cass,221,7821,29037
2021-02-07,MO,Cass,12,7833,29037
2021-02-08,MO,Cass,120,7953,29037
2021-02-09,MO,Cass,354,8307,29037
2021-02-10,MO,Cass,279,8586,29037
2021-02-11,MO,Cass,484,9070,29037
2021-02-12,MO,Cass,630,9700,29037
2021-02-13,MO,Cass,490,10190,29037
2021-02-14,MO,Cass,55,10245,29037
2021-02-15,MO,Cass,105,10350,29037
2021-02-16,MO,Cass,267,10617,29037
2021-02-17,MO,Cass,97,10714,29037
2021-02-18,MO,Cass,256,10970,29037
2021-02-19,MO,Cass,172,11142,29037
2021-02-20,MO,Cass,81,11223,29037
2021-02-21,MO,Cass,36,11259,29037
2021-02-22,MO,Cass,296,11555,29037
2021-02-23,MO,Cass,500,12055,29037
2021-02-24,MO,Cass,1016,13071,29037
2021-02-25,MO,Cass,1009,14080,29037
2021-02-26,MO,Cass,1318,15398,29037
2021-02-27,MO,Cass,641,16039,29037
2021-02-28,MO,Cass,129,16168,29037
2021-03-01,MO,Cass,163,16331,29037
2021-03-02,MO,Cass,712,17043,29037
2021-03-03,MO,Cass,866,17909,29037
2021-03-04,MO,Cass,608,18517,29037
2021-03-05,MO,Cass,336,18853,29037
2021-03-06,MO,Cass,209,19062,29037
2021-03-07,MO,Cass,133,19195,29037
2021-03-08,MO,Cass,230,19425,29037
2021-03-09,MO,Cass,896,20321,29037
2021-03-10,MO,Cass,619,20940,29037
2021-03-11,MO,Cass,1252,22192,29037
2021-03-12,MO,Cass,1738,23930,29037
2021-03-13,MO,Cass,1274,25204,29037
2021-03-14,MO,Cass,153,25357,29037
2021-03-15,MO,Cass,207,25564,29037
2021-03-16,MO,Cass,684,26248,29037
2021-03-17,MO,Cass,674,26922,29037
2021-03-18,MO,Cass,641,27563,29037
2021-03-19,MO,Cass,1537,29100,29037
2021-03-20,MO,Cass,1205,30305,29037
2021-03-21,MO,Cass,164,30469,29037
2021-03-22,MO,Cass,221,30690,29037
2021-03-23,MO,Cass,825,31515,29037
2021-03-24,MO,Cass,690,32205,29037
2021-03-25,MO,Cass,929,33134,29037
2021-03-26,MO,Cass,1703,34837,29037
2021-03-27,MO,Cass,579,35416,29037
2021-03-28,MO,Cass,139,35555,29037
2021-03-29,MO,Cass,236,35791,29037
2021-03-30,MO,Cass,837,36628,29037
2021-03-31,MO,Cass,1088,37716,29037
2021-04-01,MO,Cass,1273,38989,29037
2021-04-02,MO,Cass,948,39937,29037
2021-04-03,MO,Cass,454,40391,29037
2021-04-04,MO,Cass,77,40468,29037
2021-04-05,MO,Cass,333,40801,29037
2021-04-06,MO,Cass,1108,41909,29037
2021-04-07,MO,Cass,1009,42918,29037
2021-04-08,MO,Cass,1170,44088,29037
2021-04-09,MO,Cass,1336,45424,29037
2021-04-10,MO,Cass,888,46312,29037
2021-04-11,MO,Cass,143,46455,29037
2021-04-12,MO,Cass,321,46776,29037
2021-04-13,MO,Cass,735,47511,29037
2021-04-14,MO,Cass,645,48156,29037
2021-04-15,MO,Cass,964,49120,29037
2021-04-16,MO,Cass,1161,50281,29037
2021-04-17,MO,Cass,454,50735,29037
2021-04-18,MO,Cass,85,50820,29037
2021-04-19,MO,Cass,215,51035,29037
2021-04-20,MO,Cass,531,51566,29037
2021-04-21,MO,Cass,171,51737,29037
2021-04-22,MO,Cass,324,52061,29037
2021-04-23,MO,Cass,265,52326,29037
2021-04-24,MO,Cass,272,52598,29037
2021-04-25,MO,Cass,100,52698,29037
2021-04-26,MO,Cass,147,52845,29037
2021-04-27,MO,Cass,311,53156,29037
2021-04-28,MO,Cass,629,53785,29037
2021-04-29,MO,Cass,752,54537,29037
2021-04-30,MO,Cass,752,55289,29037
2021-05-01,MO,Cass,649,55938,29037
2021-05-02,MO,Cass,174,56112,29037
2021-05-03,MO,Cass,202,56314,29037
2021-05-04,MO,Cass,452,56766,29037
2021-05-05,MO,Cass,201,56967,29037
2021-05-06,MO,Cass,294,57261,29037
2021-05-07,MO,Cass,253,57514,29037
2021-05-08,MO,Cass,335,57849,29037
2021-05-09,MO,Cass,171,58020,29037
2021-05-10,MO,Cass,148,58168,29037
2021-05-11,MO,Cass,277,58445,29037
2021-05-12,MO,Cass,500,58945,29037
2021-05-13,MO,Cass,252,59197,29037
2021-05-14,MO,Cass,356,59553,29037
2021-05-15,MO,Cass,338,59891,29037
2021-05-16,MO,Cass,141,60032,29037
2021-05-17,MO,Cass,265,60297,29037
2021-05-18,MO,Cass,274,60571,29037
2021-05-19,MO,Cass,370,60941,29037
2021-05-20,MO,Cass,263,61204,29037
2021-05-21,MO,Cass,254,61458,29037
2021-05-22,MO,Cass,312,61770,29037
2021-05-23,MO,Cass,148,61918,29037
2021-05-24,MO,Cass,183,62101,29037
2021-05-25,MO,Cass,196,62297,29037
2021-05-26,MO,Cass,169,62466,29037
2021-05-27,MO,Cass,88,62554,29037
2020-12-15,MO,Cedar,2,2,29039
2020-12-16,MO,Cedar,1,3,29039
2020-12-17,MO,Cedar,3,6,29039
2020-12-18,MO,Cedar,7,13,29039
2020-12-19,MO,Cedar,5,18,29039
2020-12-22,MO,Cedar,4,22,29039
2020-12-23,MO,Cedar,4,26,29039
2020-12-28,MO,Cedar,48,74,29039
2020-12-29,MO,Cedar,64,138,29039
2020-12-30,MO,Cedar,9,147,29039
2020-12-31,MO,Cedar,5,152,29039
2021-01-02,MO,Cedar,1,153,29039
2021-01-04,MO,Cedar,4,157,29039
2021-01-05,MO,Cedar,14,171,29039
2021-01-06,MO,Cedar,33,204,29039
2021-01-07,MO,Cedar,9,213,29039
2021-01-08,MO,Cedar,16,229,29039
2021-01-10,MO,Cedar,1,230,29039
2021-01-11,MO,Cedar,5,235,29039
2021-01-12,MO,Cedar,31,266,29039
2021-01-13,MO,Cedar,1,267,29039
2021-01-14,MO,Cedar,33,300,29039
2021-01-15,MO,Cedar,5,305,29039
2021-01-16,MO,Cedar,2,307,29039
2021-01-18,MO,Cedar,4,311,29039
2021-01-19,MO,Cedar,17,328,29039
2021-01-20,MO,Cedar,13,341,29039
2021-01-21,MO,Cedar,18,359,29039
2021-01-22,MO,Cedar,90,449,29039
2021-01-23,MO,Cedar,10,459,29039
2021-01-24,MO,Cedar,3,462,29039
2021-01-25,MO,Cedar,93,555,29039
2021-01-26,MO,Cedar,97,652,29039
2021-01-27,MO,Cedar,79,731,29039
2021-01-28,MO,Cedar,114,845,29039
2021-01-29,MO,Cedar,115,960,29039
2021-01-30,MO,Cedar,6,966,29039
2021-02-01,MO,Cedar,18,984,29039
2021-02-02,MO,Cedar,15,999,29039
2021-02-03,MO,Cedar,25,1024,29039
2021-02-04,MO,Cedar,13,1037,29039
2021-02-05,MO,Cedar,34,1071,29039
2021-02-06,MO,Cedar,5,1076,29039
2021-02-07,MO,Cedar,4,1080,29039
2021-02-08,MO,Cedar,8,1088,29039
2021-02-09,MO,Cedar,17,1105,29039
2021-02-10,MO,Cedar,61,1166,29039
2021-02-11,MO,Cedar,154,1320,29039
2021-02-12,MO,Cedar,117,1437,29039
2021-02-13,MO,Cedar,12,1449,29039
2021-02-14,MO,Cedar,4,1453,29039
2021-02-15,MO,Cedar,9,1462,29039
2021-02-16,MO,Cedar,11,1473,29039
2021-02-17,MO,Cedar,1,1474,29039
2021-02-18,MO,Cedar,14,1488,29039
2021-02-19,MO,Cedar,95,1583,29039
2021-02-20,MO,Cedar,8,1591,29039
2021-02-22,MO,Cedar,51,1642,29039
2021-02-23,MO,Cedar,54,1696,29039
2021-02-24,MO,Cedar,88,1784,29039
2021-02-25,MO,Cedar,356,2140,29039
2021-02-26,MO,Cedar,179,2319,29039
2021-02-27,MO,Cedar,54,2373,29039
2021-02-28,MO,Cedar,3,2376,29039
2021-03-01,MO,Cedar,140,2516,29039
2021-03-02,MO,Cedar,95,2611,29039
2021-03-03,MO,Cedar,109,2720,29039
2021-03-04,MO,Cedar,60,2780,29039
2021-03-05,MO,Cedar,54,2834,29039
2021-03-06,MO,Cedar,92,2926,29039
2021-03-07,MO,Cedar,7,2933,29039
2021-03-08,MO,Cedar,32,2965,29039
2021-03-09,MO,Cedar,84,3049,29039
2021-03-10,MO,Cedar,26,3075,29039
2021-03-11,MO,Cedar,149,3224,29039
2021-03-12,MO,Cedar,144,3368,29039
2021-03-13,MO,Cedar,6,3374,29039
2021-03-14,MO,Cedar,3,3377,29039
2021-03-15,MO,Cedar,49,3426,29039
2021-03-16,MO,Cedar,54,3480,29039
2021-03-17,MO,Cedar,37,3517,29039
2021-03-18,MO,Cedar,122,3639,29039
2021-03-19,MO,Cedar,58,3697,29039
2021-03-20,MO,Cedar,9,3706,29039
2021-03-21,MO,Cedar,2,3708,29039
2021-03-22,MO,Cedar,28,3736,29039
2021-03-23,MO,Cedar,49,3785,29039
2021-03-24,MO,Cedar,62,3847,29039
2021-03-25,MO,Cedar,251,4098,29039
2021-03-26,MO,Cedar,175,4273,29039
2021-03-27,MO,Cedar,52,4325,29039
2021-03-28,MO,Cedar,3,4328,29039
2021-03-29,MO,Cedar,146,4474,29039
2021-03-30,MO,Cedar,85,4559,29039
2021-03-31,MO,Cedar,79,4638,29039
2021-04-01,MO,Cedar,128,4766,29039
2021-04-02,MO,Cedar,33,4799,29039
2021-04-03,MO,Cedar,4,4803,29039
2021-04-05,MO,Cedar,32,4835,29039
2021-04-06,MO,Cedar,35,4870,29039
2021-04-07,MO,Cedar,36,4906,29039
2021-04-08,MO,Cedar,36,4942,29039
2021-04-09,MO,Cedar,61,5003,29039
2021-04-10,MO,Cedar,10,5013,29039
2021-04-11,MO,Cedar,3,5016,29039
2021-04-12,MO,Cedar,46,5062,29039
2021-04-13,MO,Cedar,41,5103,29039
2021-04-14,MO,Cedar,45,5148,29039
2021-04-15,MO,Cedar,99,5247,29039
2021-04-16,MO,Cedar,66,5313,29039
2021-04-17,MO,Cedar,2,5315,29039
2021-04-18,MO,Cedar,1,5316,29039
2021-04-19,MO,Cedar,21,5337,29039
2021-04-20,MO,Cedar,34,5371,29039
2021-04-21,MO,Cedar,15,5386,29039
2021-04-22,MO,Cedar,26,5412,29039
2021-04-23,MO,Cedar,27,5439,29039
2021-04-24,MO,Cedar,6,5445,29039
2021-04-25,MO,Cedar,3,5448,29039
2021-04-26,MO,Cedar,17,5465,29039
2021-04-27,MO,Cedar,47,5512,29039
2021-04-28,MO,Cedar,18,5530,29039
2021-04-29,MO,Cedar,51,5581,29039
2021-04-30,MO,Cedar,12,5593,29039
2021-05-01,MO,Cedar,3,5596,29039
2021-05-02,MO,Cedar,5,5601,29039
2021-05-03,MO,Cedar,20,5621,29039
2021-05-04,MO,Cedar,23,5644,29039
2021-05-05,MO,Cedar,19,5663,29039
2021-05-06,MO,Cedar,15,5678,29039
2021-05-07,MO,Cedar,12,5690,29039
2021-05-08,MO,Cedar,5,5695,29039
2021-05-09,MO,Cedar,5,5700,29039
2021-05-10,MO,Cedar,12,5712,29039
2021-05-11,MO,Cedar,26,5738,29039
2021-05-12,MO,Cedar,13,5751,29039
2021-05-13,MO,Cedar,55,5806,29039
2021-05-14,MO,Cedar,10,5816,29039
2021-05-15,MO,Cedar,3,5819,29039
2021-05-16,MO,Cedar,3,5822,29039
2021-05-17,MO,Cedar,12,5834,29039
2021-05-18,MO,Cedar,24,5858,29039
2021-05-19,MO,Cedar,11,5869,29039
2021-05-20,MO,Cedar,19,5888,29039
2021-05-21,MO,Cedar,3,5891,29039
2021-05-22,MO,Cedar,2,5893,29039
2021-05-23,MO,Cedar,4,5897,29039
2021-05-24,MO,Cedar,6,5903,29039
2021-05-25,MO,Cedar,12,5915,29039
2021-05-26,MO,Cedar,8,5923,29039
2021-05-27,MO,Cedar,13,5936,29039
2020-12-16,MO,Chariton,3,3,29041
2020-12-17,MO,Chariton,2,5,29041
2020-12-18,MO,Chariton,6,11,29041
2020-12-19,MO,Chariton,2,13,29041
2020-12-20,MO,Chariton,1,14,29041
2020-12-21,MO,Chariton,4,18,29041
2020-12-22,MO,Chariton,2,20,29041
2020-12-23,MO,Chariton,2,22,29041
2020-12-28,MO,Chariton,4,26,29041
2020-12-29,MO,Chariton,19,45,29041
2020-12-30,MO,Chariton,7,52,29041
2021-01-02,MO,Chariton,1,53,29041
2021-01-04,MO,Chariton,5,58,29041
2021-01-05,MO,Chariton,5,63,29041
2021-01-06,MO,Chariton,11,74,29041
2021-01-07,MO,Chariton,4,78,29041
2021-01-08,MO,Chariton,5,83,29041
2021-01-09,MO,Chariton,2,85,29041
2021-01-10,MO,Chariton,1,86,29041
2021-01-11,MO,Chariton,5,91,29041
2021-01-12,MO,Chariton,11,102,29041
2021-01-13,MO,Chariton,46,148,29041
2021-01-14,MO,Chariton,3,151,29041
2021-01-15,MO,Chariton,4,155,29041
2021-01-16,MO,Chariton,1,156,29041
2021-01-18,MO,Chariton,54,210,29041
2021-01-19,MO,Chariton,15,225,29041
2021-01-20,MO,Chariton,17,242,29041
2021-01-21,MO,Chariton,36,278,29041
2021-01-22,MO,Chariton,26,304,29041
2021-01-23,MO,Chariton,3,307,29041
2021-01-25,MO,Chariton,6,313,29041
2021-01-26,MO,Chariton,7,320,29041
2021-01-27,MO,Chariton,9,329,29041
2021-01-28,MO,Chariton,59,388,29041
2021-01-29,MO,Chariton,158,546,29041
2021-01-30,MO,Chariton,5,551,29041
2021-02-01,MO,Chariton,4,555,29041
2021-02-02,MO,Chariton,20,575,29041
2021-02-03,MO,Chariton,22,597,29041
2021-02-04,MO,Chariton,249,846,29041
2021-02-05,MO,Chariton,89,935,29041
2021-02-06,MO,Chariton,6,941,29041
2021-02-08,MO,Chariton,11,952,29041
2021-02-09,MO,Chariton,19,971,29041
2021-02-10,MO,Chariton,55,1026,29041
2021-02-11,MO,Chariton,32,1058,29041
2021-02-12,MO,Chariton,54,1112,29041
2021-02-13,MO,Chariton,5,1117,29041
2021-02-15,MO,Chariton,55,1172,29041
2021-02-16,MO,Chariton,25,1197,29041
2021-02-17,MO,Chariton,41,1238,29041
2021-02-18,MO,Chariton,61,1299,29041
2021-02-19,MO,Chariton,62,1361,29041
2021-02-20,MO,Chariton,7,1368,29041
2021-02-22,MO,Chariton,5,1373,29041
2021-02-23,MO,Chariton,89,1462,29041
2021-02-24,MO,Chariton,132,1594,29041
2021-02-25,MO,Chariton,61,1655,29041
2021-02-26,MO,Chariton,47,1702,29041
2021-02-27,MO,Chariton,2,1704,29041
2021-02-28,MO,Chariton,1,1705,29041
2021-03-01,MO,Chariton,52,1757,29041
2021-03-02,MO,Chariton,11,1768,29041
2021-03-03,MO,Chariton,19,1787,29041
2021-03-04,MO,Chariton,246,2033,29041
2021-03-05,MO,Chariton,3,2036,29041
2021-03-06,MO,Chariton,5,2041,29041
2021-03-07,MO,Chariton,3,2044,29041
2021-03-08,MO,Chariton,33,2077,29041
2021-03-09,MO,Chariton,106,2183,29041
2021-03-10,MO,Chariton,22,2205,29041
2021-03-11,MO,Chariton,41,2246,29041
2021-03-12,MO,Chariton,74,2320,29041
2021-03-14,MO,Chariton,2,2322,29041
2021-03-15,MO,Chariton,17,2339,29041
2021-03-16,MO,Chariton,69,2408,29041
2021-03-17,MO,Chariton,29,2437,29041
2021-03-18,MO,Chariton,17,2454,29041
2021-03-19,MO,Chariton,34,2488,29041
2021-03-20,MO,Chariton,2,2490,29041
2021-03-21,MO,Chariton,1,2491,29041
2021-03-22,MO,Chariton,23,2514,29041
2021-03-23,MO,Chariton,77,2591,29041
2021-03-24,MO,Chariton,62,2653,29041
2021-03-25,MO,Chariton,70,2723,29041
2021-03-26,MO,Chariton,100,2823,29041
2021-03-27,MO,Chariton,3,2826,29041
2021-03-28,MO,Chariton,3,2829,29041
2021-03-29,MO,Chariton,56,2885,29041
2021-03-30,MO,Chariton,10,2895,29041
2021-03-31,MO,Chariton,27,2922,29041
2021-04-01,MO,Chariton,7,2929,29041
2021-04-02,MO,Chariton,19,2948,29041
2021-04-03,MO,Chariton,2,2950,29041
2021-04-05,MO,Chariton,27,2977,29041
2021-04-06,MO,Chariton,30,3007,29041
2021-04-07,MO,Chariton,51,3058,29041
2021-04-08,MO,Chariton,57,3115,29041
2021-04-09,MO,Chariton,21,3136,29041
2021-04-10,MO,Chariton,2,3138,29041
2021-04-11,MO,Chariton,2,3140,29041
2021-04-12,MO,Chariton,15,3155,29041
2021-04-13,MO,Chariton,44,3199,29041
2021-04-14,MO,Chariton,21,3220,29041
2021-04-15,MO,Chariton,17,3237,29041
2021-04-16,MO,Chariton,45,3282,29041
2021-04-17,MO,Chariton,3,3285,29041
2021-04-18,MO,Chariton,1,3286,29041
2021-04-19,MO,Chariton,8,3294,29041
2021-04-20,MO,Chariton,10,3304,29041
2021-04-21,MO,Chariton,38,3342,29041
2021-04-22,MO,Chariton,15,3357,29041
2021-04-23,MO,Chariton,57,3414,29041
2021-04-24,MO,Chariton,6,3420,29041
2021-04-25,MO,Chariton,1,3421,29041
2021-04-26,MO,Chariton,9,3430,29041
2021-04-27,MO,Chariton,12,3442,29041
2021-04-28,MO,Chariton,15,3457,29041
2021-04-29,MO,Chariton,17,3474,29041
2021-04-30,MO,Chariton,13,3487,29041
2021-05-01,MO,Chariton,5,3492,29041
2021-05-03,MO,Chariton,10,3502,29041
2021-05-04,MO,Chariton,5,3507,29041
2021-05-05,MO,Chariton,9,3516,29041
2021-05-06,MO,Chariton,9,3525,29041
2021-05-07,MO,Chariton,9,3534,29041
2021-05-08,MO,Chariton,4,3538,29041
2021-05-10,MO,Chariton,7,3545,29041
2021-05-11,MO,Chariton,30,3575,29041
2021-05-12,MO,Chariton,15,3590,29041
2021-05-13,MO,Chariton,10,3600,29041
2021-05-14,MO,Chariton,10,3610,29041
2021-05-15,MO,Chariton,1,3611,29041
2021-05-16,MO,Chariton,1,3612,29041
2021-05-17,MO,Chariton,14,3626,29041
2021-05-18,MO,Chariton,20,3646,29041
2021-05-19,MO,Chariton,11,3657,29041
2021-05-20,MO,Chariton,6,3663,29041
2021-05-21,MO,Chariton,3,3666,29041
2021-05-22,MO,Chariton,1,3667,29041
2021-05-24,MO,Chariton,9,3676,29041
2021-05-25,MO,Chariton,9,3685,29041
2021-05-26,MO,Chariton,5,3690,29041
2021-05-27,MO,Chariton,7,3697,29041
2020-12-14,MO,Christian,2,2,29043
2020-12-15,MO,Christian,24,26,29043
2020-12-16,MO,Christian,93,119,29043
2020-12-17,MO,Christian,113,232,29043
2020-12-18,MO,Christian,83,315,29043
2020-12-19,MO,Christian,20,335,29043
2020-12-20,MO,Christian,14,349,29043
2020-12-21,MO,Christian,121,470,29043
2020-12-22,MO,Christian,273,743,29043
2020-12-23,MO,Christian,220,963,29043
2020-12-24,MO,Christian,134,1097,29043
2020-12-26,MO,Christian,80,1177,29043
2020-12-27,MO,Christian,37,1214,29043
2020-12-28,MO,Christian,155,1369,29043
2020-12-29,MO,Christian,167,1536,29043
2020-12-30,MO,Christian,190,1726,29043
2020-12-31,MO,Christian,228,1954,29043
2021-01-01,MO,Christian,1,1955,29043
2021-01-02,MO,Christian,22,1977,29043
2021-01-03,MO,Christian,6,1983,29043
2021-01-04,MO,Christian,67,2050,29043
2021-01-05,MO,Christian,117,2167,29043
2021-01-06,MO,Christian,95,2262,29043
2021-01-07,MO,Christian,57,2319,29043
2021-01-08,MO,Christian,205,2524,29043
2021-01-09,MO,Christian,33,2557,29043
2021-01-10,MO,Christian,25,2582,29043
2021-01-11,MO,Christian,85,2667,29043
2021-01-12,MO,Christian,158,2825,29043
2021-01-13,MO,Christian,174,2999,29043
2021-01-14,MO,Christian,156,3155,29043
2021-01-15,MO,Christian,156,3311,29043
2021-01-16,MO,Christian,99,3410,29043
2021-01-17,MO,Christian,21,3431,29043
2021-01-18,MO,Christian,110,3541,29043
2021-01-19,MO,Christian,160,3701,29043
2021-01-20,MO,Christian,220,3921,29043
2021-01-21,MO,Christian,543,4464,29043
2021-01-22,MO,Christian,358,4822,29043
2021-01-23,MO,Christian,131,4953,29043
2021-01-24,MO,Christian,68,5021,29043
2021-01-25,MO,Christian,309,5330,29043
2021-01-26,MO,Christian,362,5692,29043
2021-01-27,MO,Christian,415,6107,29043
2021-01-28,MO,Christian,726,6833,29043
2021-01-29,MO,Christian,270,7103,29043
2021-01-30,MO,Christian,52,7155,29043
2021-01-31,MO,Christian,3,7158,29043
2021-02-01,MO,Christian,288,7446,29043
2021-02-02,MO,Christian,152,7598,29043
2021-02-03,MO,Christian,329,7927,29043
2021-02-04,MO,Christian,383,8310,29043
2021-02-05,MO,Christian,504,8814,29043
2021-02-06,MO,Christian,380,9194,29043
2021-02-07,MO,Christian,7,9201,29043
2021-02-08,MO,Christian,277,9478,29043
2021-02-09,MO,Christian,333,9811,29043
2021-02-10,MO,Christian,197,10008,29043
2021-02-11,MO,Christian,605,10613,29043
2021-02-12,MO,Christian,430,11043,29043
2021-02-13,MO,Christian,214,11257,29043
2021-02-14,MO,Christian,131,11388,29043
2021-02-15,MO,Christian,97,11485,29043
2021-02-16,MO,Christian,164,11649,29043
2021-02-17,MO,Christian,130,11779,29043
2021-02-18,MO,Christian,277,12056,29043
2021-02-19,MO,Christian,279,12335,29043
2021-02-20,MO,Christian,20,12355,29043
2021-02-21,MO,Christian,14,12369,29043
2021-02-22,MO,Christian,389,12758,29043
2021-02-23,MO,Christian,237,12995,29043
2021-02-24,MO,Christian,354,13349,29043
2021-02-25,MO,Christian,334,13683,29043
2021-02-26,MO,Christian,868,14551,29043
2021-02-27,MO,Christian,648,15199,29043
2021-02-28,MO,Christian,59,15258,29043
2021-03-01,MO,Christian,544,15802,29043
2021-03-02,MO,Christian,312,16114,29043
2021-03-03,MO,Christian,806,16920,29043
2021-03-04,MO,Christian,907,17827,29043
2021-03-05,MO,Christian,986,18813,29043
2021-03-06,MO,Christian,485,19298,29043
2021-03-07,MO,Christian,94,19392,29043
2021-03-08,MO,Christian,505,19897,29043
2021-03-09,MO,Christian,711,20608,29043
2021-03-10,MO,Christian,411,21019,29043
2021-03-11,MO,Christian,527,21546,29043
2021-03-12,MO,Christian,416,21962,29043
2021-03-13,MO,Christian,334,22296,29043
2021-03-14,MO,Christian,112,22408,29043
2021-03-15,MO,Christian,430,22838,29043
2021-03-16,MO,Christian,372,23210,29043
2021-03-17,MO,Christian,448,23658,29043
2021-03-18,MO,Christian,867,24525,29043
2021-03-19,MO,Christian,817,25342,29043
2021-03-20,MO,Christian,269,25611,29043
2021-03-21,MO,Christian,133,25744,29043
2021-03-22,MO,Christian,922,26666,29043
2021-03-23,MO,Christian,701,27367,29043
2021-03-24,MO,Christian,690,28057,29043
2021-03-25,MO,Christian,491,28548,29043
2021-03-26,MO,Christian,849,29397,29043
2021-03-27,MO,Christian,564,29961,29043
2021-03-28,MO,Christian,91,30052,29043
2021-03-29,MO,Christian,514,30566,29043
2021-03-30,MO,Christian,460,31026,29043
2021-03-31,MO,Christian,927,31953,29043
2021-04-01,MO,Christian,909,32862,29043
2021-04-02,MO,Christian,835,33697,29043
2021-04-03,MO,Christian,570,34267,29043
2021-04-04,MO,Christian,117,34384,29043
2021-04-05,MO,Christian,657,35041,29043
2021-04-06,MO,Christian,893,35934,29043
2021-04-07,MO,Christian,646,36580,29043
2021-04-08,MO,Christian,1031,37611,29043
2021-04-09,MO,Christian,1621,39232,29043
2021-04-10,MO,Christian,282,39514,29043
2021-04-11,MO,Christian,105,39619,29043
2021-04-12,MO,Christian,672,40291,29043
2021-04-13,MO,Christian,610,40901,29043
2021-04-14,MO,Christian,555,41456,29043
2021-04-15,MO,Christian,465,41921,29043
2021-04-16,MO,Christian,393,42314,29043
2021-04-17,MO,Christian,197,42511,29043
2021-04-18,MO,Christian,77,42588,29043
2021-04-19,MO,Christian,279,42867,29043
2021-04-20,MO,Christian,342,43209,29043
2021-04-21,MO,Christian,371,43580,29043
2021-04-22,MO,Christian,323,43903,29043
2021-04-23,MO,Christian,438,44341,29043
2021-04-24,MO,Christian,439,44780,29043
2021-04-25,MO,Christian,54,44834,29043
2021-04-26,MO,Christian,374,45208,29043
2021-04-27,MO,Christian,274,45482,29043
2021-04-28,MO,Christian,402,45884,29043
2021-04-29,MO,Christian,233,46117,29043
2021-04-30,MO,Christian,351,46468,29043
2021-05-01,MO,Christian,102,46570,29043
2021-05-02,MO,Christian,142,46712,29043
2021-05-03,MO,Christian,299,47011,29043
2021-05-04,MO,Christian,210,47221,29043
2021-05-05,MO,Christian,412,47633,29043
2021-05-06,MO,Christian,320,47953,29043
2021-05-07,MO,Christian,328,48281,29043
2021-05-08,MO,Christian,94,48375,29043
2021-05-09,MO,Christian,41,48416,29043
2021-05-10,MO,Christian,172,48588,29043
2021-05-11,MO,Christian,213,48801,29043
2021-05-12,MO,Christian,184,48985,29043
2021-05-13,MO,Christian,186,49171,29043
2021-05-14,MO,Christian,242,49413,29043
2021-05-15,MO,Christian,142,49555,29043
2021-05-16,MO,Christian,53,49608,29043
2021-05-17,MO,Christian,188,49796,29043
2021-05-18,MO,Christian,233,50029,29043
2021-05-19,MO,Christian,211,50240,29043
2021-05-20,MO,Christian,184,50424,29043
2021-05-21,MO,Christian,188,50612,29043
2021-05-22,MO,Christian,91,50703,29043
2021-05-23,MO,Christian,59,50762,29043
2021-05-24,MO,Christian,107,50869,29043
2021-05-25,MO,Christian,146,51015,29043
2021-05-26,MO,Christian,144,51159,29043
2021-05-27,MO,Christian,60,51219,29043
2020-12-21,MO,Clark,3,3,29045
2020-12-23,MO,Clark,4,7,29045
2020-12-28,MO,Clark,3,10,29045
2020-12-29,MO,Clark,2,12,29045
2020-12-30,MO,Clark,3,15,29045
2021-01-02,MO,Clark,1,16,29045
2021-01-05,MO,Clark,1,17,29045
2021-01-07,MO,Clark,3,20,29045
2021-01-11,MO,Clark,4,24,29045
2021-01-12,MO,Clark,1,25,29045
2021-01-13,MO,Clark,1,26,29045
2021-01-15,MO,Clark,1,27,29045
2021-01-17,MO,Clark,1,28,29045
2021-01-18,MO,Clark,9,37,29045
2021-01-19,MO,Clark,6,43,29045
2021-01-20,MO,Clark,37,80,29045
2021-01-21,MO,Clark,20,100,29045
2021-01-22,MO,Clark,86,186,29045
2021-01-23,MO,Clark,2,188,29045
2021-01-26,MO,Clark,2,190,29045
2021-01-27,MO,Clark,3,193,29045
2021-01-28,MO,Clark,17,210,29045
2021-01-29,MO,Clark,26,236,29045
2021-02-01,MO,Clark,34,270,29045
2021-02-02,MO,Clark,24,294,29045
2021-02-03,MO,Clark,45,339,29045
2021-02-04,MO,Clark,36,375,29045
2021-02-05,MO,Clark,34,409,29045
2021-02-06,MO,Clark,8,417,29045
2021-02-08,MO,Clark,22,439,29045
2021-02-09,MO,Clark,35,474,29045
2021-02-10,MO,Clark,14,488,29045
2021-02-11,MO,Clark,28,516,29045
2021-02-12,MO,Clark,31,547,29045
2021-02-13,MO,Clark,1,548,29045
2021-02-14,MO,Clark,3,551,29045
2021-02-15,MO,Clark,3,554,29045
2021-02-16,MO,Clark,19,573,29045
2021-02-17,MO,Clark,57,630,29045
2021-02-19,MO,Clark,119,749,29045
2021-02-20,MO,Clark,1,750,29045
2021-02-22,MO,Clark,1,751,29045
2021-02-23,MO,Clark,10,761,29045
2021-02-24,MO,Clark,11,772,29045
2021-02-25,MO,Clark,37,809,29045
2021-02-26,MO,Clark,26,835,29045
2021-03-01,MO,Clark,66,901,29045
2021-03-02,MO,Clark,18,919,29045
2021-03-03,MO,Clark,46,965,29045
2021-03-04,MO,Clark,38,1003,29045
2021-03-05,MO,Clark,44,1047,29045
2021-03-06,MO,Clark,8,1055,29045
2021-03-08,MO,Clark,9,1064,29045
2021-03-09,MO,Clark,40,1104,29045
2021-03-10,MO,Clark,8,1112,29045
2021-03-11,MO,Clark,23,1135,29045
2021-03-12,MO,Clark,19,1154,29045
2021-03-13,MO,Clark,1,1155,29045
2021-03-14,MO,Clark,2,1157,29045
2021-03-15,MO,Clark,13,1170,29045
2021-03-16,MO,Clark,16,1186,29045
2021-03-17,MO,Clark,44,1230,29045
2021-03-18,MO,Clark,31,1261,29045
2021-03-19,MO,Clark,92,1353,29045
2021-03-20,MO,Clark,1,1354,29045
2021-03-21,MO,Clark,1,1355,29045
2021-03-22,MO,Clark,2,1357,29045
2021-03-23,MO,Clark,14,1371,29045
2021-03-24,MO,Clark,31,1402,29045
2021-03-25,MO,Clark,41,1443,29045
2021-03-26,MO,Clark,26,1469,29045
2021-03-27,MO,Clark,1,1470,29045
2021-03-28,MO,Clark,1,1471,29045
2021-03-29,MO,Clark,16,1487,29045
2021-03-30,MO,Clark,17,1504,29045
2021-03-31,MO,Clark,14,1518,29045
2021-04-01,MO,Clark,22,1540,29045
2021-04-02,MO,Clark,19,1559,29045
2021-04-03,MO,Clark,1,1560,29045
2021-04-05,MO,Clark,17,1577,29045
2021-04-06,MO,Clark,8,1585,29045
2021-04-07,MO,Clark,9,1594,29045
2021-04-08,MO,Clark,15,1609,29045
2021-04-09,MO,Clark,16,1625,29045
2021-04-10,MO,Clark,3,1628,29045
2021-04-11,MO,Clark,4,1632,29045
2021-04-12,MO,Clark,6,1638,29045
2021-04-13,MO,Clark,9,1647,29045
2021-04-14,MO,Clark,11,1658,29045
2021-04-15,MO,Clark,9,1667,29045
2021-04-16,MO,Clark,84,1751,29045
2021-04-17,MO,Clark,1,1752,29045
2021-04-18,MO,Clark,1,1753,29045
2021-04-19,MO,Clark,12,1765,29045
2021-04-20,MO,Clark,8,1773,29045
2021-04-21,MO,Clark,3,1776,29045
2021-04-22,MO,Clark,8,1784,29045
2021-04-23,MO,Clark,15,1799,29045
2021-04-24,MO,Clark,3,1802,29045
2021-04-25,MO,Clark,2,1804,29045
2021-04-26,MO,Clark,9,1813,29045
2021-04-27,MO,Clark,7,1820,29045
2021-04-28,MO,Clark,6,1826,29045
2021-04-30,MO,Clark,28,1854,29045
2021-05-01,MO,Clark,1,1855,29045
2021-05-02,MO,Clark,1,1856,29045
2021-05-03,MO,Clark,1,1857,29045
2021-05-04,MO,Clark,32,1889,29045
2021-05-05,MO,Clark,3,1892,29045
2021-05-06,MO,Clark,18,1910,29045
2021-05-07,MO,Clark,2,1912,29045
2021-05-08,MO,Clark,5,1917,29045
2021-05-11,MO,Clark,26,1943,29045
2021-05-13,MO,Clark,23,1966,29045
2021-05-14,MO,Clark,1,1967,29045
2021-05-15,MO,Clark,2,1969,29045
2021-05-17,MO,Clark,1,1970,29045
2021-05-18,MO,Clark,31,2001,29045
2021-05-19,MO,Clark,2,2003,29045
2021-05-20,MO,Clark,19,2022,29045
2021-05-25,MO,Clark,30,2052,29045
2021-05-26,MO,Clark,2,2054,29045
2021-05-27,MO,Clark,8,2062,29045
2020-12-14,MO,Clay,2,2,29047
2020-12-15,MO,Clay,7,9,29047
2020-12-16,MO,Clay,2,11,29047
2020-12-17,MO,Clay,25,36,29047
2020-12-18,MO,Clay,20,56,29047
2020-12-19,MO,Clay,34,90,29047
2020-12-20,MO,Clay,3,93,29047
2020-12-21,MO,Clay,109,202,29047
2020-12-22,MO,Clay,243,445,29047
2020-12-23,MO,Clay,146,591,29047
2020-12-24,MO,Clay,33,624,29047
2020-12-26,MO,Clay,6,630,29047
2020-12-27,MO,Clay,8,638,29047
2020-12-28,MO,Clay,55,693,29047
2020-12-29,MO,Clay,211,904,29047
2020-12-30,MO,Clay,342,1246,29047
2020-12-31,MO,Clay,277,1523,29047
2021-01-01,MO,Clay,3,1526,29047
2021-01-02,MO,Clay,54,1580,29047
2021-01-03,MO,Clay,16,1596,29047
2021-01-04,MO,Clay,36,1632,29047
2021-01-05,MO,Clay,157,1789,29047
2021-01-06,MO,Clay,268,2057,29047
2021-01-07,MO,Clay,191,2248,29047
2021-01-08,MO,Clay,166,2414,29047
2021-01-09,MO,Clay,94,2508,29047
2021-01-10,MO,Clay,6,2514,29047
2021-01-11,MO,Clay,335,2849,29047
2021-01-12,MO,Clay,395,3244,29047
2021-01-13,MO,Clay,198,3442,29047
2021-01-14,MO,Clay,196,3638,29047
2021-01-15,MO,Clay,378,4016,29047
2021-01-16,MO,Clay,53,4069,29047
2021-01-17,MO,Clay,3,4072,29047
2021-01-18,MO,Clay,97,4169,29047
2021-01-19,MO,Clay,353,4522,29047
2021-01-20,MO,Clay,289,4811,29047
2021-01-21,MO,Clay,399,5210,29047
2021-01-22,MO,Clay,309,5519,29047
2021-01-23,MO,Clay,67,5586,29047
2021-01-24,MO,Clay,4,5590,29047
2021-01-25,MO,Clay,171,5761,29047
2021-01-26,MO,Clay,291,6052,29047
2021-01-27,MO,Clay,306,6358,29047
2021-01-28,MO,Clay,487,6845,29047
2021-01-29,MO,Clay,382,7227,29047
2021-01-30,MO,Clay,456,7683,29047
2021-01-31,MO,Clay,86,7769,29047
2021-02-01,MO,Clay,279,8048,29047
2021-02-02,MO,Clay,212,8260,29047
2021-02-03,MO,Clay,329,8589,29047
2021-02-04,MO,Clay,689,9278,29047
2021-02-05,MO,Clay,1183,10461,29047
2021-02-06,MO,Clay,486,10947,29047
2021-02-07,MO,Clay,33,10980,29047
2021-02-08,MO,Clay,238,11218,29047
2021-02-09,MO,Clay,235,11453,29047
2021-02-10,MO,Clay,205,11658,29047
2021-02-11,MO,Clay,377,12035,29047
2021-02-12,MO,Clay,469,12504,29047
2021-02-13,MO,Clay,181,12685,29047
2021-02-14,MO,Clay,64,12749,29047
2021-02-15,MO,Clay,198,12947,29047
2021-02-16,MO,Clay,255,13202,29047
2021-02-17,MO,Clay,247,13449,29047
2021-02-18,MO,Clay,1076,14525,29047
2021-02-19,MO,Clay,262,14787,29047
2021-02-20,MO,Clay,394,15181,29047
2021-02-21,MO,Clay,31,15212,29047
2021-02-22,MO,Clay,269,15481,29047
2021-02-23,MO,Clay,283,15764,29047
2021-02-24,MO,Clay,400,16164,29047
2021-02-25,MO,Clay,1574,17738,29047
2021-02-26,MO,Clay,1705,19443,29047
2021-02-27,MO,Clay,354,19797,29047
2021-02-28,MO,Clay,86,19883,29047
2021-03-01,MO,Clay,458,20341,29047
2021-03-02,MO,Clay,324,20665,29047
2021-03-03,MO,Clay,589,21254,29047
2021-03-04,MO,Clay,1392,22646,29047
2021-03-05,MO,Clay,1113,23759,29047
2021-03-06,MO,Clay,623,24382,29047
2021-03-07,MO,Clay,133,24515,29047
2021-03-08,MO,Clay,1082,25597,29047
2021-03-09,MO,Clay,930,26527,29047
2021-03-10,MO,Clay,334,26861,29047
2021-03-11,MO,Clay,519,27380,29047
2021-03-12,MO,Clay,437,27817,29047
2021-03-13,MO,Clay,320,28137,29047
2021-03-14,MO,Clay,155,28292,29047
2021-03-15,MO,Clay,707,28999,29047
2021-03-16,MO,Clay,533,29532,29047
2021-03-17,MO,Clay,1154,30686,29047
2021-03-18,MO,Clay,1057,31743,29047
2021-03-19,MO,Clay,1071,32814,29047
2021-03-20,MO,Clay,339,33153,29047
2021-03-21,MO,Clay,191,33344,29047
2021-03-22,MO,Clay,326,33670,29047
2021-03-23,MO,Clay,582,34252,29047
2021-03-24,MO,Clay,746,34998,29047
2021-03-25,MO,Clay,1626,36624,29047
2021-03-26,MO,Clay,1712,38336,29047
2021-03-27,MO,Clay,517,38853,29047
2021-03-28,MO,Clay,83,38936,29047
2021-03-29,MO,Clay,1729,40665,29047
2021-03-30,MO,Clay,1796,42461,29047
2021-03-31,MO,Clay,568,43029,29047
2021-04-01,MO,Clay,1249,44278,29047
2021-04-02,MO,Clay,1167,45445,29047
2021-04-03,MO,Clay,242,45687,29047
2021-04-04,MO,Clay,90,45777,29047
2021-04-05,MO,Clay,686,46463,29047
2021-04-06,MO,Clay,829,47292,29047
2021-04-07,MO,Clay,606,47898,29047
2021-04-08,MO,Clay,1159,49057,29047
2021-04-09,MO,Clay,1485,50542,29047
2021-04-10,MO,Clay,391,50933,29047
2021-04-11,MO,Clay,137,51070,29047
2021-04-12,MO,Clay,504,51574,29047
2021-04-13,MO,Clay,682,52256,29047
2021-04-14,MO,Clay,542,52798,29047
2021-04-15,MO,Clay,1105,53903,29047
2021-04-16,MO,Clay,1024,54927,29047
2021-04-17,MO,Clay,211,55138,29047
2021-04-18,MO,Clay,109,55247,29047
2021-04-19,MO,Clay,400,55647,29047
2021-04-20,MO,Clay,406,56053,29047
2021-04-21,MO,Clay,497,56550,29047
2021-04-22,MO,Clay,1138,57688,29047
2021-04-23,MO,Clay,1103,58791,29047
2021-04-24,MO,Clay,248,59039,29047
2021-04-25,MO,Clay,123,59162,29047
2021-04-26,MO,Clay,332,59494,29047
2021-04-27,MO,Clay,633,60127,29047
2021-04-28,MO,Clay,495,60622,29047
2021-04-29,MO,Clay,461,61083,29047
2021-04-30,MO,Clay,522,61605,29047
2021-05-01,MO,Clay,284,61889,29047
2021-05-02,MO,Clay,149,62038,29047
2021-05-03,MO,Clay,326,62364,29047
2021-05-04,MO,Clay,518,62882,29047
2021-05-05,MO,Clay,336,63218,29047
2021-05-06,MO,Clay,1266,64484,29047
2021-05-07,MO,Clay,384,64868,29047
2021-05-08,MO,Clay,172,65040,29047
2021-05-09,MO,Clay,117,65157,29047
2021-05-10,MO,Clay,259,65416,29047
2021-05-11,MO,Clay,512,65928,29047
2021-05-12,MO,Clay,228,66156,29047
2021-05-13,MO,Clay,300,66456,29047
2021-05-14,MO,Clay,508,66964,29047
2021-05-15,MO,Clay,366,67330,29047
2021-05-16,MO,Clay,153,67483,29047
2021-05-17,MO,Clay,512,67995,29047
2021-05-18,MO,Clay,461,68456,29047
2021-05-19,MO,Clay,419,68875,29047
2021-05-20,MO,Clay,270,69145,29047
2021-05-21,MO,Clay,271,69416,29047
2021-05-22,MO,Clay,242,69658,29047
2021-05-23,MO,Clay,101,69759,29047
2021-05-24,MO,Clay,284,70043,29047
2021-05-25,MO,Clay,251,70294,29047
2021-05-26,MO,Clay,211,70505,29047
2021-05-27,MO,Clay,105,70610,29047
2020-12-18,MO,Clinton,2,2,29049
2020-12-19,MO,Clinton,2,4,29049
2020-12-20,MO,Clinton,1,5,29049
2020-12-21,MO,Clinton,15,20,29049
2020-12-22,MO,Clinton,18,38,29049
2020-12-23,MO,Clinton,28,66,29049
2020-12-24,MO,Clinton,8,74,29049
2020-12-27,MO,Clinton,7,81,29049
2020-12-28,MO,Clinton,29,110,29049
2020-12-29,MO,Clinton,33,143,29049
2020-12-30,MO,Clinton,40,183,29049
2020-12-31,MO,Clinton,27,210,29049
2021-01-02,MO,Clinton,34,244,29049
2021-01-03,MO,Clinton,8,252,29049
2021-01-04,MO,Clinton,23,275,29049
2021-01-05,MO,Clinton,19,294,29049
2021-01-06,MO,Clinton,62,356,29049
2021-01-07,MO,Clinton,12,368,29049
2021-01-08,MO,Clinton,28,396,29049
2021-01-09,MO,Clinton,8,404,29049
2021-01-11,MO,Clinton,45,449,29049
2021-01-12,MO,Clinton,42,491,29049
2021-01-13,MO,Clinton,83,574,29049
2021-01-14,MO,Clinton,91,665,29049
2021-01-15,MO,Clinton,42,707,29049
2021-01-16,MO,Clinton,74,781,29049
2021-01-17,MO,Clinton,3,784,29049
2021-01-18,MO,Clinton,26,810,29049
2021-01-19,MO,Clinton,99,909,29049
2021-01-20,MO,Clinton,86,995,29049
2021-01-21,MO,Clinton,72,1067,29049
2021-01-22,MO,Clinton,45,1112,29049
2021-01-23,MO,Clinton,4,1116,29049
2021-01-24,MO,Clinton,11,1127,29049
2021-01-25,MO,Clinton,68,1195,29049
2021-01-26,MO,Clinton,42,1237,29049
2021-01-27,MO,Clinton,28,1265,29049
2021-01-28,MO,Clinton,103,1368,29049
2021-01-29,MO,Clinton,100,1468,29049
2021-01-30,MO,Clinton,41,1509,29049
2021-01-31,MO,Clinton,20,1529,29049
2021-02-01,MO,Clinton,45,1574,29049
2021-02-02,MO,Clinton,82,1656,29049
2021-02-03,MO,Clinton,187,1843,29049
2021-02-04,MO,Clinton,260,2103,29049
2021-02-05,MO,Clinton,159,2262,29049
2021-02-06,MO,Clinton,34,2296,29049
2021-02-07,MO,Clinton,4,2300,29049
2021-02-08,MO,Clinton,50,2350,29049
2021-02-09,MO,Clinton,54,2404,29049
2021-02-10,MO,Clinton,36,2440,29049
2021-02-11,MO,Clinton,62,2502,29049
2021-02-12,MO,Clinton,63,2565,29049
2021-02-13,MO,Clinton,440,3005,29049
2021-02-14,MO,Clinton,84,3089,29049
2021-02-15,MO,Clinton,28,3117,29049
2021-02-16,MO,Clinton,53,3170,29049
2021-02-17,MO,Clinton,67,3237,29049
2021-02-18,MO,Clinton,63,3300,29049
2021-02-19,MO,Clinton,81,3381,29049
2021-02-20,MO,Clinton,73,3454,29049
2021-02-21,MO,Clinton,7,3461,29049
2021-02-22,MO,Clinton,113,3574,29049
2021-02-23,MO,Clinton,30,3604,29049
2021-02-24,MO,Clinton,79,3683,29049
2021-02-25,MO,Clinton,298,3981,29049
2021-02-26,MO,Clinton,88,4069,29049
2021-02-27,MO,Clinton,53,4122,29049
2021-02-28,MO,Clinton,8,4130,29049
2021-03-01,MO,Clinton,51,4181,29049
2021-03-02,MO,Clinton,65,4246,29049
2021-03-03,MO,Clinton,169,4415,29049
2021-03-04,MO,Clinton,163,4578,29049
2021-03-05,MO,Clinton,125,4703,29049
2021-03-06,MO,Clinton,71,4774,29049
2021-03-07,MO,Clinton,11,4785,29049
2021-03-08,MO,Clinton,55,4840,29049
2021-03-09,MO,Clinton,70,4910,29049
2021-03-10,MO,Clinton,58,4968,29049
2021-03-11,MO,Clinton,158,5126,29049
2021-03-12,MO,Clinton,67,5193,29049
2021-03-13,MO,Clinton,413,5606,29049
2021-03-14,MO,Clinton,16,5622,29049
2021-03-15,MO,Clinton,61,5683,29049
2021-03-16,MO,Clinton,70,5753,29049
2021-03-17,MO,Clinton,115,5868,29049
2021-03-18,MO,Clinton,211,6079,29049
2021-03-19,MO,Clinton,104,6183,29049
2021-03-20,MO,Clinton,50,6233,29049
2021-03-21,MO,Clinton,16,6249,29049
2021-03-22,MO,Clinton,41,6290,29049
2021-03-23,MO,Clinton,50,6340,29049
2021-03-24,MO,Clinton,174,6514,29049
2021-03-25,MO,Clinton,163,6677,29049
2021-03-26,MO,Clinton,167,6844,29049
2021-03-27,MO,Clinton,28,6872,29049
2021-03-28,MO,Clinton,4,6876,29049
2021-03-29,MO,Clinton,131,7007,29049
2021-03-30,MO,Clinton,105,7112,29049
2021-03-31,MO,Clinton,145,7257,29049
2021-04-01,MO,Clinton,186,7443,29049
2021-04-02,MO,Clinton,195,7638,29049
2021-04-03,MO,Clinton,17,7655,29049
2021-04-04,MO,Clinton,4,7659,29049
2021-04-05,MO,Clinton,52,7711,29049
2021-04-06,MO,Clinton,114,7825,29049
2021-04-07,MO,Clinton,87,7912,29049
2021-04-08,MO,Clinton,175,8087,29049
2021-04-09,MO,Clinton,179,8266,29049
2021-04-10,MO,Clinton,37,8303,29049
2021-04-11,MO,Clinton,14,8317,29049
2021-04-12,MO,Clinton,49,8366,29049
2021-04-13,MO,Clinton,91,8457,29049
2021-04-14,MO,Clinton,118,8575,29049
2021-04-15,MO,Clinton,164,8739,29049
2021-04-16,MO,Clinton,204,8943,29049
2021-04-17,MO,Clinton,19,8962,29049
2021-04-18,MO,Clinton,13,8975,29049
2021-04-19,MO,Clinton,117,9092,29049
2021-04-20,MO,Clinton,66,9158,29049
2021-04-21,MO,Clinton,64,9222,29049
2021-04-22,MO,Clinton,158,9380,29049
2021-04-23,MO,Clinton,194,9574,29049
2021-04-24,MO,Clinton,24,9598,29049
2021-04-25,MO,Clinton,8,9606,29049
2021-04-26,MO,Clinton,29,9635,29049
2021-04-27,MO,Clinton,71,9706,29049
2021-04-28,MO,Clinton,45,9751,29049
2021-04-29,MO,Clinton,87,9838,29049
2021-04-30,MO,Clinton,153,9991,29049
2021-05-01,MO,Clinton,33,10024,29049
2021-05-02,MO,Clinton,12,10036,29049
2021-05-03,MO,Clinton,26,10062,29049
2021-05-04,MO,Clinton,52,10114,29049
2021-05-05,MO,Clinton,48,10162,29049
2021-05-06,MO,Clinton,168,10330,29049
2021-05-07,MO,Clinton,61,10391,29049
2021-05-08,MO,Clinton,78,10469,29049
2021-05-09,MO,Clinton,13,10482,29049
2021-05-10,MO,Clinton,42,10524,29049
2021-05-11,MO,Clinton,48,10572,29049
2021-05-12,MO,Clinton,27,10599,29049
2021-05-13,MO,Clinton,59,10658,29049
2021-05-14,MO,Clinton,60,10718,29049
2021-05-15,MO,Clinton,43,10761,29049
2021-05-16,MO,Clinton,12,10773,29049
2021-05-17,MO,Clinton,45,10818,29049
2021-05-18,MO,Clinton,57,10875,29049
2021-05-19,MO,Clinton,39,10914,29049
2021-05-20,MO,Clinton,48,10962,29049
2021-05-21,MO,Clinton,150,11112,29049
2021-05-22,MO,Clinton,24,11136,29049
2021-05-23,MO,Clinton,6,11142,29049
2021-05-24,MO,Clinton,32,11174,29049
2021-05-25,MO,Clinton,36,11210,29049
2021-05-26,MO,Clinton,18,11228,29049
2021-05-27,MO,Clinton,28,11256,29049
2020-12-15,MO,Cole,36,36,29051
2020-12-16,MO,Cole,63,99,29051
2020-12-17,MO,Cole,184,283,29051
2020-12-18,MO,Cole,244,527,29051
2020-12-19,MO,Cole,18,545,29051
2020-12-20,MO,Cole,34,579,29051
2020-12-21,MO,Cole,121,700,29051
2020-12-22,MO,Cole,122,822,29051
2020-12-23,MO,Cole,84,906,29051
2020-12-24,MO,Cole,6,912,29051
2020-12-26,MO,Cole,3,915,29051
2020-12-27,MO,Cole,3,918,29051
2020-12-28,MO,Cole,43,961,29051
2020-12-29,MO,Cole,66,1027,29051
2020-12-30,MO,Cole,151,1178,29051
2020-12-31,MO,Cole,33,1211,29051
2021-01-01,MO,Cole,6,1217,29051
2021-01-02,MO,Cole,15,1232,29051
2021-01-03,MO,Cole,13,1245,29051
2021-01-04,MO,Cole,72,1317,29051
2021-01-05,MO,Cole,57,1374,29051
2021-01-06,MO,Cole,135,1509,29051
2021-01-07,MO,Cole,326,1835,29051
2021-01-08,MO,Cole,214,2049,29051
2021-01-09,MO,Cole,28,2077,29051
2021-01-10,MO,Cole,102,2179,29051
2021-01-11,MO,Cole,208,2387,29051
2021-01-12,MO,Cole,172,2559,29051
2021-01-13,MO,Cole,142,2701,29051
2021-01-14,MO,Cole,153,2854,29051
2021-01-15,MO,Cole,203,3057,29051
2021-01-16,MO,Cole,58,3115,29051
2021-01-17,MO,Cole,4,3119,29051
2021-01-18,MO,Cole,177,3296,29051
2021-01-19,MO,Cole,325,3621,29051
2021-01-20,MO,Cole,200,3821,29051
2021-01-21,MO,Cole,404,4225,29051
2021-01-22,MO,Cole,798,5023,29051
2021-01-23,MO,Cole,792,5815,29051
2021-01-24,MO,Cole,10,5825,29051
2021-01-25,MO,Cole,382,6207,29051
2021-01-26,MO,Cole,368,6575,29051
2021-01-27,MO,Cole,518,7093,29051
2021-01-28,MO,Cole,348,7441,29051
2021-01-29,MO,Cole,906,8347,29051
2021-01-30,MO,Cole,614,8961,29051
2021-01-31,MO,Cole,32,8993,29051
2021-02-01,MO,Cole,195,9188,29051
2021-02-02,MO,Cole,291,9479,29051
2021-02-03,MO,Cole,224,9703,29051
2021-02-04,MO,Cole,748,10451,29051
2021-02-05,MO,Cole,1358,11809,29051
2021-02-06,MO,Cole,267,12076,29051
2021-02-07,MO,Cole,1,12077,29051
2021-02-08,MO,Cole,326,12403,29051
2021-02-09,MO,Cole,288,12691,29051
2021-02-10,MO,Cole,282,12973,29051
2021-02-11,MO,Cole,702,13675,29051
2021-02-12,MO,Cole,855,14530,29051
2021-02-13,MO,Cole,901,15431,29051
2021-02-14,MO,Cole,10,15441,29051
2021-02-15,MO,Cole,97,15538,29051
2021-02-16,MO,Cole,243,15781,29051
2021-02-17,MO,Cole,301,16082,29051
2021-02-18,MO,Cole,663,16745,29051
2021-02-19,MO,Cole,1138,17883,29051
2021-02-20,MO,Cole,624,18507,29051
2021-02-21,MO,Cole,2,18509,29051
2021-02-22,MO,Cole,370,18879,29051
2021-02-23,MO,Cole,361,19240,29051
2021-02-24,MO,Cole,366,19606,29051
2021-02-25,MO,Cole,870,20476,29051
2021-02-26,MO,Cole,2040,22516,29051
2021-02-27,MO,Cole,330,22846,29051
2021-02-28,MO,Cole,22,22868,29051
2021-03-01,MO,Cole,741,23609,29051
2021-03-02,MO,Cole,402,24011,29051
2021-03-03,MO,Cole,495,24506,29051
2021-03-04,MO,Cole,605,25111,29051
2021-03-05,MO,Cole,377,25488,29051
2021-03-06,MO,Cole,67,25555,29051
2021-03-07,MO,Cole,77,25632,29051
2021-03-08,MO,Cole,161,25793,29051
2021-03-09,MO,Cole,220,26013,29051
2021-03-10,MO,Cole,514,26527,29051
2021-03-11,MO,Cole,630,27157,29051
2021-03-12,MO,Cole,754,27911,29051
2021-03-13,MO,Cole,34,27945,29051
2021-03-14,MO,Cole,7,27952,29051
2021-03-15,MO,Cole,612,28564,29051
2021-03-16,MO,Cole,616,29180,29051
2021-03-17,MO,Cole,449,29629,29051
2021-03-18,MO,Cole,379,30008,29051
2021-03-19,MO,Cole,1117,31125,29051
2021-03-20,MO,Cole,111,31236,29051
2021-03-21,MO,Cole,92,31328,29051
2021-03-22,MO,Cole,557,31885,29051
2021-03-23,MO,Cole,271,32156,29051
2021-03-24,MO,Cole,677,32833,29051
2021-03-25,MO,Cole,783,33616,29051
2021-03-26,MO,Cole,831,34447,29051
2021-03-27,MO,Cole,235,34682,29051
2021-03-28,MO,Cole,81,34763,29051
2021-03-29,MO,Cole,896,35659,29051
2021-03-30,MO,Cole,717,36376,29051
2021-03-31,MO,Cole,573,36949,29051
2021-04-01,MO,Cole,842,37791,29051
2021-04-02,MO,Cole,853,38644,29051
2021-04-03,MO,Cole,89,38733,29051
2021-04-04,MO,Cole,86,38819,29051
2021-04-05,MO,Cole,447,39266,29051
2021-04-06,MO,Cole,363,39629,29051
2021-04-07,MO,Cole,280,39909,29051
2021-04-08,MO,Cole,346,40255,29051
2021-04-09,MO,Cole,1188,41443,29051
2021-04-10,MO,Cole,394,41837,29051
2021-04-11,MO,Cole,73,41910,29051
2021-04-12,MO,Cole,625,42535,29051
2021-04-13,MO,Cole,672,43207,29051
2021-04-14,MO,Cole,843,44050,29051
2021-04-15,MO,Cole,552,44602,29051
2021-04-16,MO,Cole,466,45068,29051
2021-04-17,MO,Cole,240,45308,29051
2021-04-18,MO,Cole,29,45337,29051
2021-04-19,MO,Cole,641,45978,29051
2021-04-20,MO,Cole,615,46593,29051
2021-04-21,MO,Cole,326,46919,29051
2021-04-22,MO,Cole,414,47333,29051
2021-04-23,MO,Cole,240,47573,29051
2021-04-24,MO,Cole,66,47639,29051
2021-04-25,MO,Cole,45,47684,29051
2021-04-26,MO,Cole,283,47967,29051
2021-04-27,MO,Cole,228,48195,29051
2021-04-28,MO,Cole,178,48373,29051
2021-04-29,MO,Cole,440,48813,29051
2021-04-30,MO,Cole,289,49102,29051
2021-05-01,MO,Cole,80,49182,29051
2021-05-02,MO,Cole,108,49290,29051
2021-05-03,MO,Cole,224,49514,29051
2021-05-04,MO,Cole,338,49852,29051
2021-05-05,MO,Cole,245,50097,29051
2021-05-06,MO,Cole,299,50396,29051
2021-05-07,MO,Cole,179,50575,29051
2021-05-08,MO,Cole,112,50687,29051
2021-05-09,MO,Cole,31,50718,29051
2021-05-10,MO,Cole,369,51087,29051
2021-05-11,MO,Cole,141,51228,29051
2021-05-12,MO,Cole,132,51360,29051
2021-05-13,MO,Cole,378,51738,29051
2021-05-14,MO,Cole,217,51955,29051
2021-05-15,MO,Cole,93,52048,29051
2021-05-16,MO,Cole,56,52104,29051
2021-05-17,MO,Cole,288,52392,29051
2021-05-18,MO,Cole,444,52836,29051
2021-05-19,MO,Cole,151,52987,29051
2021-05-20,MO,Cole,186,53173,29051
2021-05-21,MO,Cole,124,53297,29051
2021-05-22,MO,Cole,62,53359,29051
2021-05-23,MO,Cole,28,53387,29051
2021-05-24,MO,Cole,135,53522,29051
2021-05-25,MO,Cole,127,53649,29051
2021-05-26,MO,Cole,87,53736,29051
2021-05-27,MO,Cole,50,53786,29051
2020-12-15,MO,Cooper,1,1,29053
2020-12-16,MO,Cooper,4,5,29053
2020-12-17,MO,Cooper,15,20,29053
2020-12-18,MO,Cooper,24,44,29053
2020-12-19,MO,Cooper,10,54,29053
2020-12-20,MO,Cooper,7,61,29053
2020-12-21,MO,Cooper,21,82,29053
2020-12-22,MO,Cooper,29,111,29053
2020-12-23,MO,Cooper,5,116,29053
2020-12-24,MO,Cooper,1,117,29053
2020-12-27,MO,Cooper,1,118,29053
2020-12-28,MO,Cooper,23,141,29053
2020-12-29,MO,Cooper,36,177,29053
2020-12-30,MO,Cooper,29,206,29053
2020-12-31,MO,Cooper,12,218,29053
2021-01-01,MO,Cooper,3,221,29053
2021-01-02,MO,Cooper,6,227,29053
2021-01-03,MO,Cooper,6,233,29053
2021-01-04,MO,Cooper,5,238,29053
2021-01-05,MO,Cooper,17,255,29053
2021-01-06,MO,Cooper,25,280,29053
2021-01-07,MO,Cooper,24,304,29053
2021-01-08,MO,Cooper,26,330,29053
2021-01-09,MO,Cooper,10,340,29053
2021-01-10,MO,Cooper,13,353,29053
2021-01-11,MO,Cooper,50,403,29053
2021-01-12,MO,Cooper,66,469,29053
2021-01-13,MO,Cooper,12,481,29053
2021-01-14,MO,Cooper,58,539,29053
2021-01-15,MO,Cooper,17,556,29053
2021-01-16,MO,Cooper,11,567,29053
2021-01-17,MO,Cooper,4,571,29053
2021-01-18,MO,Cooper,56,627,29053
2021-01-19,MO,Cooper,28,655,29053
2021-01-20,MO,Cooper,95,750,29053
2021-01-21,MO,Cooper,92,842,29053
2021-01-22,MO,Cooper,87,929,29053
2021-01-23,MO,Cooper,14,943,29053
2021-01-24,MO,Cooper,5,948,29053
2021-01-25,MO,Cooper,29,977,29053
2021-01-26,MO,Cooper,66,1043,29053
2021-01-27,MO,Cooper,22,1065,29053
2021-01-28,MO,Cooper,626,1691,29053
2021-01-29,MO,Cooper,356,2047,29053
2021-01-30,MO,Cooper,13,2060,29053
2021-01-31,MO,Cooper,4,2064,29053
2021-02-01,MO,Cooper,38,2102,29053
2021-02-02,MO,Cooper,32,2134,29053
2021-02-03,MO,Cooper,88,2222,29053
2021-02-04,MO,Cooper,191,2413,29053
2021-02-05,MO,Cooper,62,2475,29053
2021-02-06,MO,Cooper,42,2517,29053
2021-02-08,MO,Cooper,36,2553,29053
2021-02-09,MO,Cooper,62,2615,29053
2021-02-10,MO,Cooper,36,2651,29053
2021-02-11,MO,Cooper,59,2710,29053
2021-02-12,MO,Cooper,43,2753,29053
2021-02-13,MO,Cooper,28,2781,29053
2021-02-14,MO,Cooper,4,2785,29053
2021-02-15,MO,Cooper,56,2841,29053
2021-02-16,MO,Cooper,55,2896,29053
2021-02-17,MO,Cooper,214,3110,29053
2021-02-18,MO,Cooper,251,3361,29053
2021-02-19,MO,Cooper,324,3685,29053
2021-02-20,MO,Cooper,8,3693,29053
2021-02-21,MO,Cooper,1,3694,29053
2021-02-22,MO,Cooper,50,3744,29053
2021-02-23,MO,Cooper,285,4029,29053
2021-02-24,MO,Cooper,282,4311,29053
2021-02-25,MO,Cooper,203,4514,29053
2021-02-26,MO,Cooper,82,4596,29053
2021-02-27,MO,Cooper,60,4656,29053
2021-02-28,MO,Cooper,7,4663,29053
2021-03-01,MO,Cooper,157,4820,29053
2021-03-02,MO,Cooper,268,5088,29053
2021-03-03,MO,Cooper,146,5234,29053
2021-03-04,MO,Cooper,89,5323,29053
2021-03-05,MO,Cooper,136,5459,29053
2021-03-06,MO,Cooper,55,5514,29053
2021-03-07,MO,Cooper,6,5520,29053
2021-03-08,MO,Cooper,27,5547,29053
2021-03-09,MO,Cooper,65,5612,29053
2021-03-10,MO,Cooper,58,5670,29053
2021-03-11,MO,Cooper,58,5728,29053
2021-03-12,MO,Cooper,91,5819,29053
2021-03-13,MO,Cooper,22,5841,29053
2021-03-14,MO,Cooper,25,5866,29053
2021-03-15,MO,Cooper,47,5913,29053
2021-03-16,MO,Cooper,73,5986,29053
2021-03-17,MO,Cooper,110,6096,29053
2021-03-18,MO,Cooper,50,6146,29053
2021-03-19,MO,Cooper,86,6232,29053
2021-03-20,MO,Cooper,20,6252,29053
2021-03-21,MO,Cooper,26,6278,29053
2021-03-22,MO,Cooper,195,6473,29053
2021-03-23,MO,Cooper,234,6707,29053
2021-03-24,MO,Cooper,92,6799,29053
2021-03-25,MO,Cooper,102,6901,29053
2021-03-26,MO,Cooper,84,6985,29053
2021-03-27,MO,Cooper,84,7069,29053
2021-03-28,MO,Cooper,10,7079,29053
2021-03-29,MO,Cooper,59,7138,29053
2021-03-30,MO,Cooper,117,7255,29053
2021-03-31,MO,Cooper,205,7460,29053
2021-04-01,MO,Cooper,83,7543,29053
2021-04-02,MO,Cooper,141,7684,29053
2021-04-03,MO,Cooper,33,7717,29053
2021-04-04,MO,Cooper,7,7724,29053
2021-04-05,MO,Cooper,77,7801,29053
2021-04-06,MO,Cooper,72,7873,29053
2021-04-07,MO,Cooper,54,7927,29053
2021-04-08,MO,Cooper,61,7988,29053
2021-04-09,MO,Cooper,102,8090,29053
2021-04-10,MO,Cooper,22,8112,29053
2021-04-11,MO,Cooper,61,8173,29053
2021-04-12,MO,Cooper,75,8248,29053
2021-04-13,MO,Cooper,62,8310,29053
2021-04-14,MO,Cooper,56,8366,29053
2021-04-15,MO,Cooper,200,8566,29053
2021-04-16,MO,Cooper,62,8628,29053
2021-04-17,MO,Cooper,51,8679,29053
2021-04-18,MO,Cooper,11,8690,29053
2021-04-19,MO,Cooper,26,8716,29053
2021-04-20,MO,Cooper,68,8784,29053
2021-04-21,MO,Cooper,97,8881,29053
2021-04-22,MO,Cooper,53,8934,29053
2021-04-23,MO,Cooper,63,8997,29053
2021-04-24,MO,Cooper,23,9020,29053
2021-04-25,MO,Cooper,8,9028,29053
2021-04-26,MO,Cooper,94,9122,29053
2021-04-27,MO,Cooper,61,9183,29053
2021-04-28,MO,Cooper,31,9214,29053
2021-04-29,MO,Cooper,29,9243,29053
2021-04-30,MO,Cooper,48,9291,29053
2021-05-01,MO,Cooper,17,9308,29053
2021-05-02,MO,Cooper,9,9317,29053
2021-05-03,MO,Cooper,57,9374,29053
2021-05-04,MO,Cooper,21,9395,29053
2021-05-05,MO,Cooper,32,9427,29053
2021-05-06,MO,Cooper,151,9578,29053
2021-05-07,MO,Cooper,43,9621,29053
2021-05-08,MO,Cooper,43,9664,29053
2021-05-09,MO,Cooper,14,9678,29053
2021-05-10,MO,Cooper,27,9705,29053
2021-05-11,MO,Cooper,15,9720,29053
2021-05-12,MO,Cooper,29,9749,29053
2021-05-13,MO,Cooper,20,9769,29053
2021-05-14,MO,Cooper,33,9802,29053
2021-05-15,MO,Cooper,18,9820,29053
2021-05-16,MO,Cooper,8,9828,29053
2021-05-17,MO,Cooper,30,9858,29053
2021-05-18,MO,Cooper,29,9887,29053
2021-05-19,MO,Cooper,34,9921,29053
2021-05-20,MO,Cooper,58,9979,29053
2021-05-21,MO,Cooper,24,10003,29053
2021-05-22,MO,Cooper,18,10021,29053
2021-05-23,MO,Cooper,8,10029,29053
2021-05-24,MO,Cooper,13,10042,29053
2021-05-25,MO,Cooper,11,10053,29053
2021-05-26,MO,Cooper,11,10064,29053
2021-05-27,MO,Cooper,7,10071,29053
2020-12-16,MO,Crawford,2,2,29055
2020-12-17,MO,Crawford,2,4,29055
2020-12-18,MO,Crawford,15,19,29055
2020-12-19,MO,Crawford,3,22,29055
2020-12-20,MO,Crawford,2,24,29055
2020-12-21,MO,Crawford,6,30,29055
2020-12-22,MO,Crawford,11,41,29055
2020-12-23,MO,Crawford,8,49,29055
2020-12-24,MO,Crawford,1,50,29055
2020-12-26,MO,Crawford,1,51,29055
2020-12-28,MO,Crawford,7,58,29055
2020-12-29,MO,Crawford,11,69,29055
2020-12-30,MO,Crawford,17,86,29055
2020-12-31,MO,Crawford,12,98,29055
2021-01-01,MO,Crawford,7,105,29055
2021-01-02,MO,Crawford,19,124,29055
2021-01-03,MO,Crawford,4,128,29055
2021-01-04,MO,Crawford,15,143,29055
2021-01-05,MO,Crawford,17,160,29055
2021-01-06,MO,Crawford,22,182,29055
2021-01-07,MO,Crawford,24,206,29055
2021-01-08,MO,Crawford,18,224,29055
2021-01-09,MO,Crawford,8,232,29055
2021-01-10,MO,Crawford,1,233,29055
2021-01-11,MO,Crawford,18,251,29055
2021-01-12,MO,Crawford,18,269,29055
2021-01-13,MO,Crawford,28,297,29055
2021-01-14,MO,Crawford,17,314,29055
2021-01-15,MO,Crawford,15,329,29055
2021-01-16,MO,Crawford,8,337,29055
2021-01-18,MO,Crawford,17,354,29055
2021-01-19,MO,Crawford,71,425,29055
2021-01-20,MO,Crawford,63,488,29055
2021-01-21,MO,Crawford,33,521,29055
2021-01-22,MO,Crawford,28,549,29055
2021-01-23,MO,Crawford,49,598,29055
2021-01-24,MO,Crawford,1,599,29055
2021-01-25,MO,Crawford,40,639,29055
2021-01-26,MO,Crawford,24,663,29055
2021-01-27,MO,Crawford,28,691,29055
2021-01-28,MO,Crawford,77,768,29055
2021-01-29,MO,Crawford,53,821,29055
2021-01-30,MO,Crawford,56,877,29055
2021-01-31,MO,Crawford,3,880,29055
2021-02-01,MO,Crawford,14,894,29055
2021-02-02,MO,Crawford,16,910,29055
2021-02-03,MO,Crawford,46,956,29055
2021-02-04,MO,Crawford,92,1048,29055
2021-02-05,MO,Crawford,228,1276,29055
2021-02-06,MO,Crawford,30,1306,29055
2021-02-08,MO,Crawford,91,1397,29055
2021-02-09,MO,Crawford,115,1512,29055
2021-02-10,MO,Crawford,77,1589,29055
2021-02-11,MO,Crawford,78,1667,29055
2021-02-12,MO,Crawford,106,1773,29055
2021-02-13,MO,Crawford,38,1811,29055
2021-02-14,MO,Crawford,8,1819,29055
2021-02-15,MO,Crawford,21,1840,29055
2021-02-16,MO,Crawford,82,1922,29055
2021-02-17,MO,Crawford,58,1980,29055
2021-02-18,MO,Crawford,42,2022,29055
2021-02-19,MO,Crawford,45,2067,29055
2021-02-20,MO,Crawford,35,2102,29055
2021-02-21,MO,Crawford,1,2103,29055
2021-02-22,MO,Crawford,49,2152,29055
2021-02-23,MO,Crawford,82,2234,29055
2021-02-24,MO,Crawford,123,2357,29055
2021-02-25,MO,Crawford,77,2434,29055
2021-02-26,MO,Crawford,202,2636,29055
2021-02-27,MO,Crawford,62,2698,29055
2021-02-28,MO,Crawford,13,2711,29055
2021-03-01,MO,Crawford,139,2850,29055
2021-03-02,MO,Crawford,269,3119,29055
2021-03-03,MO,Crawford,89,3208,29055
2021-03-04,MO,Crawford,162,3370,29055
2021-03-05,MO,Crawford,302,3672,29055
2021-03-06,MO,Crawford,235,3907,29055
2021-03-07,MO,Crawford,10,3917,29055
2021-03-08,MO,Crawford,54,3971,29055
2021-03-09,MO,Crawford,79,4050,29055
2021-03-10,MO,Crawford,93,4143,29055
2021-03-11,MO,Crawford,83,4226,29055
2021-03-12,MO,Crawford,131,4357,29055
2021-03-13,MO,Crawford,20,4377,29055
2021-03-14,MO,Crawford,8,4385,29055
2021-03-15,MO,Crawford,66,4451,29055
2021-03-16,MO,Crawford,81,4532,29055
2021-03-17,MO,Crawford,55,4587,29055
2021-03-18,MO,Crawford,95,4682,29055
2021-03-19,MO,Crawford,92,4774,29055
2021-03-20,MO,Crawford,29,4803,29055
2021-03-21,MO,Crawford,17,4820,29055
2021-03-22,MO,Crawford,154,4974,29055
2021-03-23,MO,Crawford,147,5121,29055
2021-03-24,MO,Crawford,119,5240,29055
2021-03-25,MO,Crawford,115,5355,29055
2021-03-26,MO,Crawford,361,5716,29055
2021-03-27,MO,Crawford,223,5939,29055
2021-03-28,MO,Crawford,10,5949,29055
2021-03-29,MO,Crawford,101,6050,29055
2021-03-30,MO,Crawford,97,6147,29055
2021-03-31,MO,Crawford,152,6299,29055
2021-04-01,MO,Crawford,103,6402,29055
2021-04-02,MO,Crawford,68,6470,29055
2021-04-03,MO,Crawford,15,6485,29055
2021-04-04,MO,Crawford,7,6492,29055
2021-04-05,MO,Crawford,60,6552,29055
2021-04-06,MO,Crawford,56,6608,29055
2021-04-07,MO,Crawford,129,6737,29055
2021-04-08,MO,Crawford,61,6798,29055
2021-04-09,MO,Crawford,264,7062,29055
2021-04-10,MO,Crawford,31,7093,29055
2021-04-11,MO,Crawford,18,7111,29055
2021-04-12,MO,Crawford,184,7295,29055
2021-04-13,MO,Crawford,91,7386,29055
2021-04-14,MO,Crawford,175,7561,29055
2021-04-15,MO,Crawford,90,7651,29055
2021-04-16,MO,Crawford,78,7729,29055
2021-04-17,MO,Crawford,25,7754,29055
2021-04-18,MO,Crawford,16,7770,29055
2021-04-19,MO,Crawford,22,7792,29055
2021-04-20,MO,Crawford,73,7865,29055
2021-04-21,MO,Crawford,82,7947,29055
2021-04-22,MO,Crawford,51,7998,29055
2021-04-23,MO,Crawford,64,8062,29055
2021-04-24,MO,Crawford,13,8075,29055
2021-04-25,MO,Crawford,9,8084,29055
2021-04-26,MO,Crawford,75,8159,29055
2021-04-27,MO,Crawford,114,8273,29055
2021-04-28,MO,Crawford,71,8344,29055
2021-04-29,MO,Crawford,27,8371,29055
2021-04-30,MO,Crawford,68,8439,29055
2021-05-01,MO,Crawford,11,8450,29055
2021-05-02,MO,Crawford,2,8452,29055
2021-05-03,MO,Crawford,62,8514,29055
2021-05-04,MO,Crawford,39,8553,29055
2021-05-05,MO,Crawford,170,8723,29055
2021-05-06,MO,Crawford,47,8770,29055
2021-05-07,MO,Crawford,96,8866,29055
2021-05-08,MO,Crawford,9,8875,29055
2021-05-09,MO,Crawford,13,8888,29055
2021-05-10,MO,Crawford,60,8948,29055
2021-05-11,MO,Crawford,32,8980,29055
2021-05-12,MO,Crawford,68,9048,29055
2021-05-13,MO,Crawford,46,9094,29055
2021-05-14,MO,Crawford,71,9165,29055
2021-05-15,MO,Crawford,20,9185,29055
2021-05-16,MO,Crawford,16,9201,29055
2021-05-17,MO,Crawford,51,9252,29055
2021-05-18,MO,Crawford,31,9283,29055
2021-05-19,MO,Crawford,59,9342,29055
2021-05-20,MO,Crawford,44,9386,29055
2021-05-21,MO,Crawford,40,9426,29055
2021-05-22,MO,Crawford,16,9442,29055
2021-05-23,MO,Crawford,6,9448,29055
2021-05-24,MO,Crawford,29,9477,29055
2021-05-25,MO,Crawford,33,9510,29055
2021-05-26,MO,Crawford,27,9537,29055
2021-05-27,MO,Crawford,24,9561,29055
2020-12-16,MO,Dade,1,1,29057
2020-12-17,MO,Dade,2,3,29057
2020-12-18,MO,Dade,3,6,29057
2020-12-21,MO,Dade,3,9,29057
2020-12-22,MO,Dade,4,13,29057
2020-12-23,MO,Dade,6,19,29057
2020-12-24,MO,Dade,6,25,29057
2020-12-26,MO,Dade,3,28,29057
2020-12-28,MO,Dade,1,29,29057
2020-12-29,MO,Dade,5,34,29057
2020-12-30,MO,Dade,13,47,29057
2020-12-31,MO,Dade,5,52,29057
2021-01-03,MO,Dade,1,53,29057
2021-01-04,MO,Dade,4,57,29057
2021-01-05,MO,Dade,49,106,29057
2021-01-06,MO,Dade,3,109,29057
2021-01-07,MO,Dade,4,113,29057
2021-01-08,MO,Dade,68,181,29057
2021-01-10,MO,Dade,1,182,29057
2021-01-11,MO,Dade,5,187,29057
2021-01-12,MO,Dade,7,194,29057
2021-01-13,MO,Dade,4,198,29057
2021-01-14,MO,Dade,4,202,29057
2021-01-15,MO,Dade,13,215,29057
2021-01-16,MO,Dade,4,219,29057
2021-01-17,MO,Dade,1,220,29057
2021-01-18,MO,Dade,4,224,29057
2021-01-19,MO,Dade,6,230,29057
2021-01-20,MO,Dade,6,236,29057
2021-01-21,MO,Dade,18,254,29057
2021-01-22,MO,Dade,8,262,29057
2021-01-23,MO,Dade,7,269,29057
2021-01-24,MO,Dade,5,274,29057
2021-01-25,MO,Dade,89,363,29057
2021-01-26,MO,Dade,19,382,29057
2021-01-27,MO,Dade,21,403,29057
2021-01-28,MO,Dade,101,504,29057
2021-01-29,MO,Dade,125,629,29057
2021-01-30,MO,Dade,23,652,29057
2021-02-01,MO,Dade,77,729,29057
2021-02-02,MO,Dade,67,796,29057
2021-02-03,MO,Dade,5,801,29057
2021-02-04,MO,Dade,8,809,29057
2021-02-05,MO,Dade,148,957,29057
2021-02-06,MO,Dade,4,961,29057
2021-02-07,MO,Dade,1,962,29057
2021-02-08,MO,Dade,9,971,29057
2021-02-09,MO,Dade,10,981,29057
2021-02-10,MO,Dade,8,989,29057
2021-02-11,MO,Dade,19,1008,29057
2021-02-12,MO,Dade,101,1109,29057
2021-02-13,MO,Dade,16,1125,29057
2021-02-14,MO,Dade,5,1130,29057
2021-02-15,MO,Dade,1,1131,29057
2021-02-16,MO,Dade,8,1139,29057
2021-02-17,MO,Dade,8,1147,29057
2021-02-18,MO,Dade,10,1157,29057
2021-02-19,MO,Dade,107,1264,29057
2021-02-20,MO,Dade,37,1301,29057
2021-02-21,MO,Dade,2,1303,29057
2021-02-22,MO,Dade,104,1407,29057
2021-02-23,MO,Dade,111,1518,29057
2021-02-24,MO,Dade,20,1538,29057
2021-02-25,MO,Dade,21,1559,29057
2021-02-26,MO,Dade,128,1687,29057
2021-02-27,MO,Dade,14,1701,29057
2021-02-28,MO,Dade,5,1706,29057
2021-03-01,MO,Dade,102,1808,29057
2021-03-02,MO,Dade,31,1839,29057
2021-03-03,MO,Dade,18,1857,29057
2021-03-04,MO,Dade,20,1877,29057
2021-03-05,MO,Dade,111,1988,29057
2021-03-06,MO,Dade,35,2023,29057
2021-03-07,MO,Dade,2,2025,29057
2021-03-08,MO,Dade,115,2140,29057
2021-03-09,MO,Dade,31,2171,29057
2021-03-10,MO,Dade,18,2189,29057
2021-03-11,MO,Dade,65,2254,29057
2021-03-12,MO,Dade,89,2343,29057
2021-03-13,MO,Dade,12,2355,29057
2021-03-14,MO,Dade,3,2358,29057
2021-03-15,MO,Dade,87,2445,29057
2021-03-16,MO,Dade,63,2508,29057
2021-03-17,MO,Dade,107,2615,29057
2021-03-18,MO,Dade,28,2643,29057
2021-03-19,MO,Dade,91,2734,29057
2021-03-20,MO,Dade,13,2747,29057
2021-03-21,MO,Dade,4,2751,29057
2021-03-22,MO,Dade,54,2805,29057
2021-03-23,MO,Dade,39,2844,29057
2021-03-24,MO,Dade,19,2863,29057
2021-03-25,MO,Dade,45,2908,29057
2021-03-26,MO,Dade,112,3020,29057
2021-03-27,MO,Dade,12,3032,29057
2021-03-28,MO,Dade,4,3036,29057
2021-03-29,MO,Dade,58,3094,29057
2021-03-30,MO,Dade,24,3118,29057
2021-03-31,MO,Dade,43,3161,29057
2021-04-01,MO,Dade,32,3193,29057
2021-04-02,MO,Dade,45,3238,29057
2021-04-03,MO,Dade,15,3253,29057
2021-04-04,MO,Dade,1,3254,29057
2021-04-05,MO,Dade,39,3293,29057
2021-04-06,MO,Dade,41,3334,29057
2021-04-07,MO,Dade,13,3347,29057
2021-04-08,MO,Dade,66,3413,29057
2021-04-09,MO,Dade,105,3518,29057
2021-04-10,MO,Dade,13,3531,29057
2021-04-11,MO,Dade,4,3535,29057
2021-04-12,MO,Dade,89,3624,29057
2021-04-13,MO,Dade,65,3689,29057
2021-04-14,MO,Dade,18,3707,29057
2021-04-15,MO,Dade,36,3743,29057
2021-04-16,MO,Dade,109,3852,29057
2021-04-17,MO,Dade,11,3863,29057
2021-04-18,MO,Dade,3,3866,29057
2021-04-19,MO,Dade,35,3901,29057
2021-04-20,MO,Dade,23,3924,29057
2021-04-21,MO,Dade,22,3946,29057
2021-04-22,MO,Dade,38,3984,29057
2021-04-23,MO,Dade,21,4005,29057
2021-04-24,MO,Dade,12,4017,29057
2021-04-25,MO,Dade,2,4019,29057
2021-04-26,MO,Dade,35,4054,29057
2021-04-27,MO,Dade,19,4073,29057
2021-04-28,MO,Dade,5,4078,29057
2021-04-29,MO,Dade,1,4079,29057
2021-04-30,MO,Dade,36,4115,29057
2021-05-01,MO,Dade,7,4122,29057
2021-05-02,MO,Dade,3,4125,29057
2021-05-03,MO,Dade,11,4136,29057
2021-05-04,MO,Dade,18,4154,29057
2021-05-05,MO,Dade,10,4164,29057
2021-05-06,MO,Dade,7,4171,29057
2021-05-07,MO,Dade,35,4206,29057
2021-05-08,MO,Dade,3,4209,29057
2021-05-09,MO,Dade,2,4211,29057
2021-05-10,MO,Dade,9,4220,29057
2021-05-11,MO,Dade,9,4229,29057
2021-05-12,MO,Dade,7,4236,29057
2021-05-13,MO,Dade,23,4259,29057
2021-05-14,MO,Dade,13,4272,29057
2021-05-16,MO,Dade,3,4275,29057
2021-05-17,MO,Dade,11,4286,29057
2021-05-18,MO,Dade,19,4305,29057
2021-05-19,MO,Dade,5,4310,29057
2021-05-20,MO,Dade,17,4327,29057
2021-05-21,MO,Dade,6,4333,29057
2021-05-22,MO,Dade,3,4336,29057
2021-05-23,MO,Dade,1,4337,29057
2021-05-24,MO,Dade,13,4350,29057
2021-05-25,MO,Dade,4,4354,29057
2021-05-26,MO,Dade,5,4359,29057
2020-12-15,MO,Dallas,1,1,29059
2020-12-16,MO,Dallas,5,6,29059
2020-12-17,MO,Dallas,4,10,29059
2020-12-18,MO,Dallas,5,15,29059
2020-12-19,MO,Dallas,1,16,29059
2020-12-21,MO,Dallas,7,23,29059
2020-12-22,MO,Dallas,14,37,29059
2020-12-23,MO,Dallas,13,50,29059
2020-12-24,MO,Dallas,9,59,29059
2020-12-26,MO,Dallas,2,61,29059
2020-12-27,MO,Dallas,2,63,29059
2020-12-28,MO,Dallas,7,70,29059
2020-12-29,MO,Dallas,17,87,29059
2020-12-30,MO,Dallas,8,95,29059
2020-12-31,MO,Dallas,54,149,29059
2021-01-02,MO,Dallas,4,153,29059
2021-01-04,MO,Dallas,11,164,29059
2021-01-05,MO,Dallas,17,181,29059
2021-01-06,MO,Dallas,5,186,29059
2021-01-07,MO,Dallas,5,191,29059
2021-01-08,MO,Dallas,15,206,29059
2021-01-09,MO,Dallas,2,208,29059
2021-01-10,MO,Dallas,4,212,29059
2021-01-11,MO,Dallas,7,219,29059
2021-01-12,MO,Dallas,25,244,29059
2021-01-13,MO,Dallas,8,252,29059
2021-01-14,MO,Dallas,11,263,29059
2021-01-15,MO,Dallas,11,274,29059
2021-01-16,MO,Dallas,8,282,29059
2021-01-17,MO,Dallas,4,286,29059
2021-01-18,MO,Dallas,6,292,29059
2021-01-19,MO,Dallas,14,306,29059
2021-01-20,MO,Dallas,22,328,29059
2021-01-21,MO,Dallas,26,354,29059
2021-01-22,MO,Dallas,35,389,29059
2021-01-23,MO,Dallas,10,399,29059
2021-01-24,MO,Dallas,2,401,29059
2021-01-25,MO,Dallas,58,459,29059
2021-01-26,MO,Dallas,174,633,29059
2021-01-27,MO,Dallas,45,678,29059
2021-01-28,MO,Dallas,117,795,29059
2021-01-29,MO,Dallas,65,860,29059
2021-01-30,MO,Dallas,5,865,29059
2021-02-01,MO,Dallas,58,923,29059
2021-02-02,MO,Dallas,142,1065,29059
2021-02-03,MO,Dallas,42,1107,29059
2021-02-04,MO,Dallas,14,1121,29059
2021-02-05,MO,Dallas,46,1167,29059
2021-02-06,MO,Dallas,22,1189,29059
2021-02-07,MO,Dallas,1,1190,29059
2021-02-08,MO,Dallas,16,1206,29059
2021-02-09,MO,Dallas,36,1242,29059
2021-02-10,MO,Dallas,80,1322,29059
2021-02-11,MO,Dallas,127,1449,29059
2021-02-12,MO,Dallas,237,1686,29059
2021-02-13,MO,Dallas,26,1712,29059
2021-02-14,MO,Dallas,11,1723,29059
2021-02-15,MO,Dallas,11,1734,29059
2021-02-16,MO,Dallas,10,1744,29059
2021-02-17,MO,Dallas,26,1770,29059
2021-02-18,MO,Dallas,18,1788,29059
2021-02-19,MO,Dallas,270,2058,29059
2021-02-20,MO,Dallas,23,2081,29059
2021-02-21,MO,Dallas,1,2082,29059
2021-02-22,MO,Dallas,30,2112,29059
2021-02-23,MO,Dallas,144,2256,29059
2021-02-24,MO,Dallas,31,2287,29059
2021-02-25,MO,Dallas,95,2382,29059
2021-02-26,MO,Dallas,120,2502,29059
2021-02-27,MO,Dallas,42,2544,29059
2021-02-28,MO,Dallas,2,2546,29059
2021-03-01,MO,Dallas,74,2620,29059
2021-03-02,MO,Dallas,167,2787,29059
2021-03-03,MO,Dallas,76,2863,29059
2021-03-04,MO,Dallas,118,2981,29059
2021-03-05,MO,Dallas,81,3062,29059
2021-03-06,MO,Dallas,116,3178,29059
2021-03-07,MO,Dallas,7,3185,29059
2021-03-08,MO,Dallas,54,3239,29059
2021-03-09,MO,Dallas,111,3350,29059
2021-03-10,MO,Dallas,97,3447,29059
2021-03-11,MO,Dallas,86,3533,29059
2021-03-12,MO,Dallas,242,3775,29059
2021-03-13,MO,Dallas,31,3806,29059
2021-03-14,MO,Dallas,5,3811,29059
2021-03-15,MO,Dallas,172,3983,29059
2021-03-16,MO,Dallas,33,4016,29059
2021-03-17,MO,Dallas,206,4222,29059
2021-03-18,MO,Dallas,110,4332,29059
2021-03-19,MO,Dallas,279,4611,29059
2021-03-20,MO,Dallas,22,4633,29059
2021-03-21,MO,Dallas,15,4648,29059
2021-03-22,MO,Dallas,60,4708,29059
2021-03-23,MO,Dallas,49,4757,29059
2021-03-24,MO,Dallas,51,4808,29059
2021-03-25,MO,Dallas,55,4863,29059
2021-03-26,MO,Dallas,118,4981,29059
2021-03-27,MO,Dallas,38,5019,29059
2021-03-28,MO,Dallas,29,5048,29059
2021-03-29,MO,Dallas,15,5063,29059
2021-03-30,MO,Dallas,44,5107,29059
2021-03-31,MO,Dallas,85,5192,29059
2021-04-01,MO,Dallas,60,5252,29059
2021-04-02,MO,Dallas,103,5355,29059
2021-04-03,MO,Dallas,29,5384,29059
2021-04-04,MO,Dallas,26,5410,29059
2021-04-05,MO,Dallas,35,5445,29059
2021-04-06,MO,Dallas,79,5524,29059
2021-04-07,MO,Dallas,62,5586,29059
2021-04-08,MO,Dallas,94,5680,29059
2021-04-09,MO,Dallas,100,5780,29059
2021-04-10,MO,Dallas,30,5810,29059
2021-04-11,MO,Dallas,31,5841,29059
2021-04-12,MO,Dallas,54,5895,29059
2021-04-13,MO,Dallas,44,5939,29059
2021-04-14,MO,Dallas,49,5988,29059
2021-04-15,MO,Dallas,34,6022,29059
2021-04-16,MO,Dallas,78,6100,29059
2021-04-17,MO,Dallas,150,6250,29059
2021-04-18,MO,Dallas,15,6265,29059
2021-04-19,MO,Dallas,24,6289,29059
2021-04-20,MO,Dallas,23,6312,29059
2021-04-21,MO,Dallas,33,6345,29059
2021-04-22,MO,Dallas,32,6377,29059
2021-04-23,MO,Dallas,36,6413,29059
2021-04-24,MO,Dallas,17,6430,29059
2021-04-25,MO,Dallas,6,6436,29059
2021-04-26,MO,Dallas,31,6467,29059
2021-04-27,MO,Dallas,22,6489,29059
2021-04-28,MO,Dallas,20,6509,29059
2021-04-29,MO,Dallas,10,6519,29059
2021-04-30,MO,Dallas,56,6575,29059
2021-05-01,MO,Dallas,15,6590,29059
2021-05-02,MO,Dallas,12,6602,29059
2021-05-03,MO,Dallas,14,6616,29059
2021-05-04,MO,Dallas,30,6646,29059
2021-05-05,MO,Dallas,27,6673,29059
2021-05-06,MO,Dallas,24,6697,29059
2021-05-07,MO,Dallas,20,6717,29059
2021-05-08,MO,Dallas,10,6727,29059
2021-05-09,MO,Dallas,15,6742,29059
2021-05-10,MO,Dallas,15,6757,29059
2021-05-11,MO,Dallas,21,6778,29059
2021-05-12,MO,Dallas,14,6792,29059
2021-05-13,MO,Dallas,37,6829,29059
2021-05-14,MO,Dallas,57,6886,29059
2021-05-15,MO,Dallas,17,6903,29059
2021-05-16,MO,Dallas,7,6910,29059
2021-05-17,MO,Dallas,34,6944,29059
2021-05-18,MO,Dallas,14,6958,29059
2021-05-19,MO,Dallas,27,6985,29059
2021-05-20,MO,Dallas,16,7001,29059
2021-05-21,MO,Dallas,37,7038,29059
2021-05-22,MO,Dallas,7,7045,29059
2021-05-23,MO,Dallas,9,7054,29059
2021-05-24,MO,Dallas,9,7063,29059
2021-05-25,MO,Dallas,19,7082,29059
2021-05-26,MO,Dallas,10,7092,29059
2021-05-27,MO,Dallas,6,7098,29059
2020-12-21,MO,Daviess,3,3,29061
2020-12-22,MO,Daviess,4,7,29061
2020-12-23,MO,Daviess,2,9,29061
2020-12-24,MO,Daviess,1,10,29061
2020-12-26,MO,Daviess,1,11,29061
2020-12-28,MO,Daviess,7,18,29061
2020-12-29,MO,Daviess,47,65,29061
2020-12-30,MO,Daviess,23,88,29061
2020-12-31,MO,Daviess,12,100,29061
2021-01-02,MO,Daviess,2,102,29061
2021-01-04,MO,Daviess,2,104,29061
2021-01-05,MO,Daviess,12,116,29061
2021-01-06,MO,Daviess,2,118,29061
2021-01-07,MO,Daviess,3,121,29061
2021-01-08,MO,Daviess,10,131,29061
2021-01-09,MO,Daviess,1,132,29061
2021-01-11,MO,Daviess,5,137,29061
2021-01-12,MO,Daviess,23,160,29061
2021-01-13,MO,Daviess,25,185,29061
2021-01-14,MO,Daviess,16,201,29061
2021-01-15,MO,Daviess,14,215,29061
2021-01-16,MO,Daviess,13,228,29061
2021-01-17,MO,Daviess,1,229,29061
2021-01-18,MO,Daviess,1,230,29061
2021-01-19,MO,Daviess,2,232,29061
2021-01-20,MO,Daviess,6,238,29061
2021-01-21,MO,Daviess,11,249,29061
2021-01-22,MO,Daviess,13,262,29061
2021-01-23,MO,Daviess,3,265,29061
2021-01-25,MO,Daviess,10,275,29061
2021-01-26,MO,Daviess,4,279,29061
2021-01-27,MO,Daviess,22,301,29061
2021-01-28,MO,Daviess,97,398,29061
2021-01-29,MO,Daviess,99,497,29061
2021-01-30,MO,Daviess,42,539,29061
2021-01-31,MO,Daviess,2,541,29061
2021-02-01,MO,Daviess,13,554,29061
2021-02-02,MO,Daviess,21,575,29061
2021-02-03,MO,Daviess,31,606,29061
2021-02-04,MO,Daviess,64,670,29061
2021-02-05,MO,Daviess,132,802,29061
2021-02-06,MO,Daviess,1,803,29061
2021-02-08,MO,Daviess,8,811,29061
2021-02-09,MO,Daviess,38,849,29061
2021-02-10,MO,Daviess,21,870,29061
2021-02-11,MO,Daviess,21,891,29061
2021-02-12,MO,Daviess,125,1016,29061
2021-02-13,MO,Daviess,17,1033,29061
2021-02-14,MO,Daviess,15,1048,29061
2021-02-16,MO,Daviess,3,1051,29061
2021-02-17,MO,Daviess,5,1056,29061
2021-02-18,MO,Daviess,20,1076,29061
2021-02-19,MO,Daviess,17,1093,29061
2021-02-20,MO,Daviess,6,1099,29061
2021-02-22,MO,Daviess,13,1112,29061
2021-02-23,MO,Daviess,15,1127,29061
2021-02-24,MO,Daviess,30,1157,29061
2021-02-25,MO,Daviess,127,1284,29061
2021-02-26,MO,Daviess,104,1388,29061
2021-02-27,MO,Daviess,75,1463,29061
2021-02-28,MO,Daviess,2,1465,29061
2021-03-01,MO,Daviess,8,1473,29061
2021-03-02,MO,Daviess,7,1480,29061
2021-03-03,MO,Daviess,22,1502,29061
2021-03-04,MO,Daviess,14,1516,29061
2021-03-05,MO,Daviess,139,1655,29061
2021-03-06,MO,Daviess,31,1686,29061
2021-03-07,MO,Daviess,2,1688,29061
2021-03-08,MO,Daviess,15,1703,29061
2021-03-09,MO,Daviess,14,1717,29061
2021-03-10,MO,Daviess,6,1723,29061
2021-03-11,MO,Daviess,66,1789,29061
2021-03-12,MO,Daviess,131,1920,29061
2021-03-13,MO,Daviess,17,1937,29061
2021-03-14,MO,Daviess,3,1940,29061
2021-03-15,MO,Daviess,27,1967,29061
2021-03-16,MO,Daviess,31,1998,29061
2021-03-17,MO,Daviess,40,2038,29061
2021-03-18,MO,Daviess,77,2115,29061
2021-03-19,MO,Daviess,40,2155,29061
2021-03-20,MO,Daviess,7,2162,29061
2021-03-21,MO,Daviess,3,2165,29061
2021-03-22,MO,Daviess,14,2179,29061
2021-03-23,MO,Daviess,16,2195,29061
2021-03-24,MO,Daviess,28,2223,29061
2021-03-25,MO,Daviess,106,2329,29061
2021-03-26,MO,Daviess,33,2362,29061
2021-03-27,MO,Daviess,12,2374,29061
2021-03-29,MO,Daviess,28,2402,29061
2021-03-30,MO,Daviess,11,2413,29061
2021-03-31,MO,Daviess,16,2429,29061
2021-04-01,MO,Daviess,36,2465,29061
2021-04-02,MO,Daviess,12,2477,29061
2021-04-03,MO,Daviess,7,2484,29061
2021-04-05,MO,Daviess,17,2501,29061
2021-04-06,MO,Daviess,8,2509,29061
2021-04-07,MO,Daviess,18,2527,29061
2021-04-08,MO,Daviess,20,2547,29061
2021-04-09,MO,Daviess,75,2622,29061
2021-04-10,MO,Daviess,7,2629,29061
2021-04-11,MO,Daviess,6,2635,29061
2021-04-12,MO,Daviess,21,2656,29061
2021-04-13,MO,Daviess,14,2670,29061
2021-04-14,MO,Daviess,20,2690,29061
2021-04-15,MO,Daviess,45,2735,29061
2021-04-16,MO,Daviess,17,2752,29061
2021-04-17,MO,Daviess,1,2753,29061
2021-04-18,MO,Daviess,3,2756,29061
2021-04-19,MO,Daviess,9,2765,29061
2021-04-20,MO,Daviess,16,2781,29061
2021-04-21,MO,Daviess,17,2798,29061
2021-04-22,MO,Daviess,43,2841,29061
2021-04-23,MO,Daviess,11,2852,29061
2021-04-24,MO,Daviess,9,2861,29061
2021-04-26,MO,Daviess,4,2865,29061
2021-04-27,MO,Daviess,8,2873,29061
2021-04-28,MO,Daviess,8,2881,29061
2021-04-29,MO,Daviess,27,2908,29061
2021-04-30,MO,Daviess,6,2914,29061
2021-05-01,MO,Daviess,7,2921,29061
2021-05-02,MO,Daviess,1,2922,29061
2021-05-03,MO,Daviess,13,2935,29061
2021-05-04,MO,Daviess,8,2943,29061
2021-05-05,MO,Daviess,4,2947,29061
2021-05-06,MO,Daviess,32,2979,29061
2021-05-07,MO,Daviess,13,2992,29061
2021-05-08,MO,Daviess,6,2998,29061
2021-05-09,MO,Daviess,3,3001,29061
2021-05-10,MO,Daviess,6,3007,29061
2021-05-11,MO,Daviess,6,3013,29061
2021-05-12,MO,Daviess,6,3019,29061
2021-05-13,MO,Daviess,23,3042,29061
2021-05-14,MO,Daviess,13,3055,29061
2021-05-15,MO,Daviess,5,3060,29061
2021-05-17,MO,Daviess,6,3066,29061
2021-05-18,MO,Daviess,6,3072,29061
2021-05-19,MO,Daviess,7,3079,29061
2021-05-20,MO,Daviess,24,3103,29061
2021-05-21,MO,Daviess,10,3113,29061
2021-05-22,MO,Daviess,5,3118,29061
2021-05-23,MO,Daviess,1,3119,29061
2021-05-24,MO,Daviess,5,3124,29061
2021-05-25,MO,Daviess,5,3129,29061
2021-05-26,MO,Daviess,5,3134,29061
2021-05-27,MO,Daviess,14,3148,29061
2020-12-16,MO,DeKalb,2,2,29063
2020-12-20,MO,DeKalb,1,3,29063
2020-12-21,MO,DeKalb,1,4,29063
2020-12-22,MO,DeKalb,3,7,29063
2020-12-23,MO,DeKalb,4,11,29063
2020-12-24,MO,DeKalb,1,12,29063
2020-12-27,MO,DeKalb,6,18,29063
2020-12-28,MO,DeKalb,13,31,29063
2020-12-29,MO,DeKalb,14,45,29063
2020-12-30,MO,DeKalb,35,80,29063
2020-12-31,MO,DeKalb,5,85,29063
2021-01-02,MO,DeKalb,1,86,29063
2021-01-03,MO,DeKalb,9,95,29063
2021-01-04,MO,DeKalb,14,109,29063
2021-01-05,MO,DeKalb,13,122,29063
2021-01-06,MO,DeKalb,15,137,29063
2021-01-07,MO,DeKalb,6,143,29063
2021-01-08,MO,DeKalb,5,148,29063
2021-01-10,MO,DeKalb,2,150,29063
2021-01-11,MO,DeKalb,3,153,29063
2021-01-12,MO,DeKalb,5,158,29063
2021-01-13,MO,DeKalb,30,188,29063
2021-01-14,MO,DeKalb,24,212,29063
2021-01-15,MO,DeKalb,9,221,29063
2021-01-16,MO,DeKalb,8,229,29063
2021-01-17,MO,DeKalb,2,231,29063
2021-01-18,MO,DeKalb,3,234,29063
2021-01-19,MO,DeKalb,4,238,29063
2021-01-20,MO,DeKalb,25,263,29063
2021-01-21,MO,DeKalb,25,288,29063
2021-01-22,MO,DeKalb,10,298,29063
2021-01-25,MO,DeKalb,15,313,29063
2021-01-26,MO,DeKalb,22,335,29063
2021-01-27,MO,DeKalb,40,375,29063
2021-01-28,MO,DeKalb,30,405,29063
2021-01-29,MO,DeKalb,56,461,29063
2021-01-30,MO,DeKalb,6,467,29063
2021-01-31,MO,DeKalb,6,473,29063
2021-02-01,MO,DeKalb,156,629,29063
2021-02-02,MO,DeKalb,40,669,29063
2021-02-03,MO,DeKalb,59,728,29063
2021-02-04,MO,DeKalb,56,784,29063
2021-02-05,MO,DeKalb,52,836,29063
2021-02-06,MO,DeKalb,1,837,29063
2021-02-07,MO,DeKalb,2,839,29063
2021-02-08,MO,DeKalb,16,855,29063
2021-02-09,MO,DeKalb,39,894,29063
2021-02-10,MO,DeKalb,40,934,29063
2021-02-11,MO,DeKalb,61,995,29063
2021-02-12,MO,DeKalb,29,1024,29063
2021-02-13,MO,DeKalb,51,1075,29063
2021-02-14,MO,DeKalb,8,1083,29063
2021-02-15,MO,DeKalb,1,1084,29063
2021-02-16,MO,DeKalb,16,1100,29063
2021-02-17,MO,DeKalb,23,1123,29063
2021-02-18,MO,DeKalb,25,1148,29063
2021-02-19,MO,DeKalb,79,1227,29063
2021-02-20,MO,DeKalb,5,1232,29063
2021-02-22,MO,DeKalb,179,1411,29063
2021-02-23,MO,DeKalb,16,1427,29063
2021-02-24,MO,DeKalb,30,1457,29063
2021-02-25,MO,DeKalb,65,1522,29063
2021-02-26,MO,DeKalb,35,1557,29063
2021-02-27,MO,DeKalb,23,1580,29063
2021-03-01,MO,DeKalb,56,1636,29063
2021-03-02,MO,DeKalb,42,1678,29063
2021-03-03,MO,DeKalb,71,1749,29063
2021-03-04,MO,DeKalb,78,1827,29063
2021-03-05,MO,DeKalb,37,1864,29063
2021-03-06,MO,DeKalb,19,1883,29063
2021-03-07,MO,DeKalb,1,1884,29063
2021-03-08,MO,DeKalb,18,1902,29063
2021-03-09,MO,DeKalb,73,1975,29063
2021-03-10,MO,DeKalb,255,2230,29063
2021-03-11,MO,DeKalb,160,2390,29063
2021-03-12,MO,DeKalb,56,2446,29063
2021-03-13,MO,DeKalb,50,2496,29063
2021-03-14,MO,DeKalb,1,2497,29063
2021-03-15,MO,DeKalb,40,2537,29063
2021-03-16,MO,DeKalb,53,2590,29063
2021-03-17,MO,DeKalb,46,2636,29063
2021-03-18,MO,DeKalb,52,2688,29063
2021-03-19,MO,DeKalb,91,2779,29063
2021-03-20,MO,DeKalb,1,2780,29063
2021-03-22,MO,DeKalb,7,2787,29063
2021-03-23,MO,DeKalb,45,2832,29063
2021-03-24,MO,DeKalb,45,2877,29063
2021-03-25,MO,DeKalb,77,2954,29063
2021-03-26,MO,DeKalb,57,3011,29063
2021-03-27,MO,DeKalb,2,3013,29063
2021-03-29,MO,DeKalb,52,3065,29063
2021-03-30,MO,DeKalb,57,3122,29063
2021-03-31,MO,DeKalb,47,3169,29063
2021-04-01,MO,DeKalb,49,3218,29063
2021-04-02,MO,DeKalb,30,3248,29063
2021-04-03,MO,DeKalb,6,3254,29063
2021-04-04,MO,DeKalb,2,3256,29063
2021-04-05,MO,DeKalb,13,3269,29063
2021-04-06,MO,DeKalb,44,3313,29063
2021-04-07,MO,DeKalb,236,3549,29063
2021-04-08,MO,DeKalb,148,3697,29063
2021-04-09,MO,DeKalb,75,3772,29063
2021-04-10,MO,DeKalb,4,3776,29063
2021-04-11,MO,DeKalb,3,3779,29063
2021-04-12,MO,DeKalb,24,3803,29063
2021-04-13,MO,DeKalb,27,3830,29063
2021-04-14,MO,DeKalb,65,3895,29063
2021-04-15,MO,DeKalb,65,3960,29063
2021-04-16,MO,DeKalb,55,4015,29063
2021-04-17,MO,DeKalb,6,4021,29063
2021-04-18,MO,DeKalb,3,4024,29063
2021-04-19,MO,DeKalb,32,4056,29063
2021-04-20,MO,DeKalb,57,4113,29063
2021-04-21,MO,DeKalb,11,4124,29063
2021-04-22,MO,DeKalb,51,4175,29063
2021-04-23,MO,DeKalb,26,4201,29063
2021-04-24,MO,DeKalb,5,4206,29063
2021-04-25,MO,DeKalb,1,4207,29063
2021-04-26,MO,DeKalb,7,4214,29063
2021-04-27,MO,DeKalb,10,4224,29063
2021-04-28,MO,DeKalb,6,4230,29063
2021-04-29,MO,DeKalb,25,4255,29063
2021-04-30,MO,DeKalb,26,4281,29063
2021-05-01,MO,DeKalb,5,4286,29063
2021-05-02,MO,DeKalb,2,4288,29063
2021-05-03,MO,DeKalb,11,4299,29063
2021-05-04,MO,DeKalb,18,4317,29063
2021-05-05,MO,DeKalb,11,4328,29063
2021-05-06,MO,DeKalb,12,4340,29063
2021-05-07,MO,DeKalb,26,4366,29063
2021-05-08,MO,DeKalb,12,4378,29063
2021-05-09,MO,DeKalb,1,4379,29063
2021-05-10,MO,DeKalb,3,4382,29063
2021-05-11,MO,DeKalb,14,4396,29063
2021-05-12,MO,DeKalb,15,4411,29063
2021-05-13,MO,DeKalb,17,4428,29063
2021-05-14,MO,DeKalb,14,4442,29063
2021-05-15,MO,DeKalb,11,4453,29063
2021-05-16,MO,DeKalb,1,4454,29063
2021-05-17,MO,DeKalb,10,4464,29063
2021-05-18,MO,DeKalb,28,4492,29063
2021-05-19,MO,DeKalb,12,4504,29063
2021-05-20,MO,DeKalb,9,4513,29063
2021-05-21,MO,DeKalb,10,4523,29063
2021-05-22,MO,DeKalb,6,4529,29063
2021-05-23,MO,DeKalb,4,4533,29063
2021-05-24,MO,DeKalb,11,4544,29063
2021-05-25,MO,DeKalb,11,4555,29063
2021-05-26,MO,DeKalb,7,4562,29063
2021-05-27,MO,DeKalb,6,4568,29063
2020-12-15,MO,Dent,2,2,29065
2020-12-16,MO,Dent,3,5,29065
2020-12-17,MO,Dent,2,7,29065
2020-12-18,MO,Dent,7,14,29065
2020-12-21,MO,Dent,1,15,29065
2020-12-22,MO,Dent,2,17,29065
2020-12-23,MO,Dent,2,19,29065
2020-12-27,MO,Dent,1,20,29065
2020-12-28,MO,Dent,4,24,29065
2020-12-29,MO,Dent,10,34,29065
2020-12-30,MO,Dent,10,44,29065
2020-12-31,MO,Dent,4,48,29065
2021-01-01,MO,Dent,5,53,29065
2021-01-02,MO,Dent,9,62,29065
2021-01-03,MO,Dent,5,67,29065
2021-01-04,MO,Dent,7,74,29065
2021-01-05,MO,Dent,12,86,29065
2021-01-06,MO,Dent,18,104,29065
2021-01-07,MO,Dent,12,116,29065
2021-01-08,MO,Dent,15,131,29065
2021-01-11,MO,Dent,22,153,29065
2021-01-12,MO,Dent,31,184,29065
2021-01-13,MO,Dent,36,220,29065
2021-01-14,MO,Dent,54,274,29065
2021-01-15,MO,Dent,33,307,29065
2021-01-16,MO,Dent,37,344,29065
2021-01-18,MO,Dent,20,364,29065
2021-01-19,MO,Dent,37,401,29065
2021-01-20,MO,Dent,15,416,29065
2021-01-21,MO,Dent,9,425,29065
2021-01-22,MO,Dent,23,448,29065
2021-01-23,MO,Dent,45,493,29065
2021-01-25,MO,Dent,47,540,29065
2021-01-26,MO,Dent,5,545,29065
2021-01-27,MO,Dent,15,560,29065
2021-01-28,MO,Dent,23,583,29065
2021-01-29,MO,Dent,32,615,29065
2021-01-30,MO,Dent,30,645,29065
2021-01-31,MO,Dent,1,646,29065
2021-02-01,MO,Dent,22,668,29065
2021-02-02,MO,Dent,40,708,29065
2021-02-03,MO,Dent,51,759,29065
2021-02-04,MO,Dent,77,836,29065
2021-02-05,MO,Dent,244,1080,29065
2021-02-06,MO,Dent,10,1090,29065
2021-02-08,MO,Dent,31,1121,29065
2021-02-09,MO,Dent,12,1133,29065
2021-02-10,MO,Dent,150,1283,29065
2021-02-11,MO,Dent,334,1617,29065
2021-02-12,MO,Dent,193,1810,29065
2021-02-13,MO,Dent,92,1902,29065
2021-02-14,MO,Dent,6,1908,29065
2021-02-15,MO,Dent,15,1923,29065
2021-02-16,MO,Dent,30,1953,29065
2021-02-17,MO,Dent,2,1955,29065
2021-02-18,MO,Dent,74,2029,29065
2021-02-19,MO,Dent,20,2049,29065
2021-02-20,MO,Dent,5,2054,29065
2021-02-22,MO,Dent,44,2098,29065
2021-02-23,MO,Dent,18,2116,29065
2021-02-24,MO,Dent,42,2158,29065
2021-02-25,MO,Dent,92,2250,29065
2021-02-26,MO,Dent,53,2303,29065
2021-02-27,MO,Dent,43,2346,29065
2021-02-28,MO,Dent,5,2351,29065
2021-03-01,MO,Dent,20,2371,29065
2021-03-02,MO,Dent,45,2416,29065
2021-03-03,MO,Dent,215,2631,29065
2021-03-04,MO,Dent,69,2700,29065
2021-03-05,MO,Dent,13,2713,29065
2021-03-06,MO,Dent,16,2729,29065
2021-03-07,MO,Dent,7,2736,29065
2021-03-08,MO,Dent,28,2764,29065
2021-03-09,MO,Dent,38,2802,29065
2021-03-10,MO,Dent,176,2978,29065
2021-03-11,MO,Dent,329,3307,29065
2021-03-12,MO,Dent,202,3509,29065
2021-03-13,MO,Dent,28,3537,29065
2021-03-14,MO,Dent,5,3542,29065
2021-03-15,MO,Dent,18,3560,29065
2021-03-16,MO,Dent,28,3588,29065
2021-03-17,MO,Dent,110,3698,29065
2021-03-18,MO,Dent,31,3729,29065
2021-03-19,MO,Dent,82,3811,29065
2021-03-20,MO,Dent,6,3817,29065
2021-03-21,MO,Dent,16,3833,29065
2021-03-22,MO,Dent,22,3855,29065
2021-03-23,MO,Dent,38,3893,29065
2021-03-24,MO,Dent,48,3941,29065
2021-03-25,MO,Dent,96,4037,29065
2021-03-26,MO,Dent,25,4062,29065
2021-03-27,MO,Dent,12,4074,29065
2021-03-28,MO,Dent,22,4096,29065
2021-03-29,MO,Dent,12,4108,29065
2021-03-30,MO,Dent,44,4152,29065
2021-03-31,MO,Dent,85,4237,29065
2021-04-01,MO,Dent,57,4294,29065
2021-04-02,MO,Dent,24,4318,29065
2021-04-03,MO,Dent,18,4336,29065
2021-04-04,MO,Dent,6,4342,29065
2021-04-05,MO,Dent,19,4361,29065
2021-04-06,MO,Dent,46,4407,29065
2021-04-07,MO,Dent,64,4471,29065
2021-04-08,MO,Dent,60,4531,29065
2021-04-09,MO,Dent,35,4566,29065
2021-04-10,MO,Dent,16,4582,29065
2021-04-11,MO,Dent,19,4601,29065
2021-04-12,MO,Dent,26,4627,29065
2021-04-13,MO,Dent,31,4658,29065
2021-04-14,MO,Dent,134,4792,29065
2021-04-15,MO,Dent,9,4801,29065
2021-04-16,MO,Dent,100,4901,29065
2021-04-17,MO,Dent,8,4909,29065
2021-04-18,MO,Dent,19,4928,29065
2021-04-19,MO,Dent,23,4951,29065
2021-04-20,MO,Dent,34,4985,29065
2021-04-21,MO,Dent,60,5045,29065
2021-04-22,MO,Dent,28,5073,29065
2021-04-23,MO,Dent,7,5080,29065
2021-04-24,MO,Dent,7,5087,29065
2021-04-25,MO,Dent,32,5119,29065
2021-04-26,MO,Dent,16,5135,29065
2021-04-27,MO,Dent,35,5170,29065
2021-04-28,MO,Dent,60,5230,29065
2021-04-29,MO,Dent,15,5245,29065
2021-04-30,MO,Dent,30,5275,29065
2021-05-01,MO,Dent,6,5281,29065
2021-05-02,MO,Dent,21,5302,29065
2021-05-03,MO,Dent,27,5329,29065
2021-05-04,MO,Dent,25,5354,29065
2021-05-05,MO,Dent,57,5411,29065
2021-05-06,MO,Dent,37,5448,29065
2021-05-07,MO,Dent,72,5520,29065
2021-05-08,MO,Dent,13,5533,29065
2021-05-09,MO,Dent,17,5550,29065
2021-05-10,MO,Dent,14,5564,29065
2021-05-11,MO,Dent,27,5591,29065
2021-05-12,MO,Dent,30,5621,29065
2021-05-13,MO,Dent,10,5631,29065
2021-05-14,MO,Dent,37,5668,29065
2021-05-15,MO,Dent,7,5675,29065
2021-05-16,MO,Dent,14,5689,29065
2021-05-17,MO,Dent,27,5716,29065
2021-05-18,MO,Dent,24,5740,29065
2021-05-19,MO,Dent,22,5762,29065
2021-05-20,MO,Dent,11,5773,29065
2021-05-21,MO,Dent,13,5786,29065
2021-05-22,MO,Dent,14,5800,29065
2021-05-23,MO,Dent,11,5811,29065
2021-05-24,MO,Dent,8,5819,29065
2021-05-25,MO,Dent,27,5846,29065
2021-05-26,MO,Dent,30,5876,29065
2021-05-27,MO,Dent,11,5887,29065
2020-12-17,MO,Douglas,4,4,29067
2020-12-18,MO,Douglas,1,5,29067
2020-12-21,MO,Douglas,4,9,29067
2020-12-22,MO,Douglas,6,15,29067
2020-12-23,MO,Douglas,8,23,29067
2020-12-24,MO,Douglas,2,25,29067
2020-12-26,MO,Douglas,2,27,29067
2020-12-28,MO,Douglas,4,31,29067
2020-12-29,MO,Douglas,6,37,29067
2020-12-30,MO,Douglas,39,76,29067
2020-12-31,MO,Douglas,4,80,29067
2021-01-02,MO,Douglas,1,81,29067
2021-01-03,MO,Douglas,1,82,29067
2021-01-04,MO,Douglas,13,95,29067
2021-01-05,MO,Douglas,2,97,29067
2021-01-06,MO,Douglas,3,100,29067
2021-01-07,MO,Douglas,18,118,29067
2021-01-08,MO,Douglas,5,123,29067
2021-01-11,MO,Douglas,5,128,29067
2021-01-12,MO,Douglas,3,131,29067
2021-01-13,MO,Douglas,2,133,29067
2021-01-14,MO,Douglas,4,137,29067
2021-01-15,MO,Douglas,10,147,29067
2021-01-16,MO,Douglas,3,150,29067
2021-01-18,MO,Douglas,5,155,29067
2021-01-19,MO,Douglas,11,166,29067
2021-01-20,MO,Douglas,5,171,29067
2021-01-21,MO,Douglas,13,184,29067
2021-01-22,MO,Douglas,27,211,29067
2021-01-23,MO,Douglas,13,224,29067
2021-01-24,MO,Douglas,3,227,29067
2021-01-25,MO,Douglas,10,237,29067
2021-01-26,MO,Douglas,7,244,29067
2021-01-27,MO,Douglas,36,280,29067
2021-01-28,MO,Douglas,15,295,29067
2021-01-29,MO,Douglas,73,368,29067
2021-01-30,MO,Douglas,2,370,29067
2021-02-01,MO,Douglas,48,418,29067
2021-02-02,MO,Douglas,9,427,29067
2021-02-03,MO,Douglas,9,436,29067
2021-02-04,MO,Douglas,28,464,29067
2021-02-05,MO,Douglas,38,502,29067
2021-02-06,MO,Douglas,291,793,29067
2021-02-08,MO,Douglas,11,804,29067
2021-02-09,MO,Douglas,7,811,29067
2021-02-10,MO,Douglas,24,835,29067
2021-02-11,MO,Douglas,39,874,29067
2021-02-12,MO,Douglas,86,960,29067
2021-02-13,MO,Douglas,15,975,29067
2021-02-14,MO,Douglas,6,981,29067
2021-02-15,MO,Douglas,3,984,29067
2021-02-16,MO,Douglas,20,1004,29067
2021-02-17,MO,Douglas,1,1005,29067
2021-02-18,MO,Douglas,36,1041,29067
2021-02-19,MO,Douglas,32,1073,29067
2021-02-20,MO,Douglas,6,1079,29067
2021-02-21,MO,Douglas,1,1080,29067
2021-02-22,MO,Douglas,5,1085,29067
2021-02-23,MO,Douglas,54,1139,29067
2021-02-24,MO,Douglas,18,1157,29067
2021-02-25,MO,Douglas,31,1188,29067
2021-02-26,MO,Douglas,77,1265,29067
2021-02-27,MO,Douglas,307,1572,29067
2021-02-28,MO,Douglas,4,1576,29067
2021-03-01,MO,Douglas,52,1628,29067
2021-03-02,MO,Douglas,46,1674,29067
2021-03-03,MO,Douglas,48,1722,29067
2021-03-04,MO,Douglas,28,1750,29067
2021-03-05,MO,Douglas,32,1782,29067
2021-03-06,MO,Douglas,13,1795,29067
2021-03-07,MO,Douglas,1,1796,29067
2021-03-08,MO,Douglas,60,1856,29067
2021-03-09,MO,Douglas,33,1889,29067
2021-03-10,MO,Douglas,23,1912,29067
2021-03-11,MO,Douglas,33,1945,29067
2021-03-12,MO,Douglas,79,2024,29067
2021-03-13,MO,Douglas,14,2038,29067
2021-03-14,MO,Douglas,1,2039,29067
2021-03-15,MO,Douglas,76,2115,29067
2021-03-16,MO,Douglas,56,2171,29067
2021-03-17,MO,Douglas,27,2198,29067
2021-03-18,MO,Douglas,29,2227,29067
2021-03-19,MO,Douglas,63,2290,29067
2021-03-20,MO,Douglas,7,2297,29067
2021-03-22,MO,Douglas,42,2339,29067
2021-03-23,MO,Douglas,70,2409,29067
2021-03-24,MO,Douglas,34,2443,29067
2021-03-25,MO,Douglas,22,2465,29067
2021-03-26,MO,Douglas,56,2521,29067
2021-03-27,MO,Douglas,30,2551,29067
2021-03-28,MO,Douglas,2,2553,29067
2021-03-29,MO,Douglas,24,2577,29067
2021-03-30,MO,Douglas,61,2638,29067
2021-03-31,MO,Douglas,18,2656,29067
2021-04-01,MO,Douglas,25,2681,29067
2021-04-02,MO,Douglas,52,2733,29067
2021-04-03,MO,Douglas,9,2742,29067
2021-04-05,MO,Douglas,31,2773,29067
2021-04-06,MO,Douglas,84,2857,29067
2021-04-07,MO,Douglas,36,2893,29067
2021-04-08,MO,Douglas,38,2931,29067
2021-04-09,MO,Douglas,61,2992,29067
2021-04-10,MO,Douglas,8,3000,29067
2021-04-11,MO,Douglas,3,3003,29067
2021-04-12,MO,Douglas,62,3065,29067
2021-04-13,MO,Douglas,107,3172,29067
2021-04-14,MO,Douglas,27,3199,29067
2021-04-15,MO,Douglas,15,3214,29067
2021-04-16,MO,Douglas,36,3250,29067
2021-04-17,MO,Douglas,8,3258,29067
2021-04-18,MO,Douglas,2,3260,29067
2021-04-19,MO,Douglas,16,3276,29067
2021-04-20,MO,Douglas,38,3314,29067
2021-04-21,MO,Douglas,24,3338,29067
2021-04-22,MO,Douglas,22,3360,29067
2021-04-23,MO,Douglas,35,3395,29067
2021-04-24,MO,Douglas,10,3405,29067
2021-04-25,MO,Douglas,1,3406,29067
2021-04-26,MO,Douglas,23,3429,29067
2021-04-27,MO,Douglas,26,3455,29067
2021-04-28,MO,Douglas,21,3476,29067
2021-04-29,MO,Douglas,12,3488,29067
2021-04-30,MO,Douglas,26,3514,29067
2021-05-01,MO,Douglas,12,3526,29067
2021-05-02,MO,Douglas,1,3527,29067
2021-05-03,MO,Douglas,20,3547,29067
2021-05-04,MO,Douglas,31,3578,29067
2021-05-05,MO,Douglas,26,3604,29067
2021-05-06,MO,Douglas,27,3631,29067
2021-05-07,MO,Douglas,22,3653,29067
2021-05-08,MO,Douglas,9,3662,29067
2021-05-10,MO,Douglas,24,3686,29067
2021-05-11,MO,Douglas,41,3727,29067
2021-05-12,MO,Douglas,16,3743,29067
2021-05-13,MO,Douglas,14,3757,29067
2021-05-14,MO,Douglas,13,3770,29067
2021-05-15,MO,Douglas,5,3775,29067
2021-05-16,MO,Douglas,1,3776,29067
2021-05-17,MO,Douglas,20,3796,29067
2021-05-18,MO,Douglas,25,3821,29067
2021-05-19,MO,Douglas,9,3830,29067
2021-05-20,MO,Douglas,8,3838,29067
2021-05-21,MO,Douglas,18,3856,29067
2021-05-22,MO,Douglas,9,3865,29067
2021-05-23,MO,Douglas,1,3866,29067
2021-05-24,MO,Douglas,10,3876,29067
2021-05-25,MO,Douglas,17,3893,29067
2021-05-26,MO,Douglas,11,3904,29067
2021-05-27,MO,Douglas,5,3909,29067
2020-12-17,MO,Dunklin,1,1,29069
2020-12-18,MO,Dunklin,2,3,29069
2020-12-19,MO,Dunklin,11,14,29069
2020-12-21,MO,Dunklin,47,61,29069
2020-12-22,MO,Dunklin,4,65,29069
2020-12-23,MO,Dunklin,8,73,29069
2020-12-28,MO,Dunklin,5,78,29069
2020-12-29,MO,Dunklin,60,138,29069
2020-12-30,MO,Dunklin,23,161,29069
2020-12-31,MO,Dunklin,7,168,29069
2021-01-02,MO,Dunklin,34,202,29069
2021-01-03,MO,Dunklin,30,232,29069
2021-01-04,MO,Dunklin,6,238,29069
2021-01-05,MO,Dunklin,23,261,29069
2021-01-06,MO,Dunklin,36,297,29069
2021-01-07,MO,Dunklin,15,312,29069
2021-01-08,MO,Dunklin,16,328,29069
2021-01-09,MO,Dunklin,2,330,29069
2021-01-11,MO,Dunklin,29,359,29069
2021-01-12,MO,Dunklin,110,469,29069
2021-01-13,MO,Dunklin,16,485,29069
2021-01-14,MO,Dunklin,25,510,29069
2021-01-15,MO,Dunklin,25,535,29069
2021-01-16,MO,Dunklin,30,565,29069
2021-01-18,MO,Dunklin,60,625,29069
2021-01-19,MO,Dunklin,57,682,29069
2021-01-20,MO,Dunklin,247,929,29069
2021-01-21,MO,Dunklin,48,977,29069
2021-01-22,MO,Dunklin,150,1127,29069
2021-01-23,MO,Dunklin,11,1138,29069
2021-01-24,MO,Dunklin,2,1140,29069
2021-01-25,MO,Dunklin,72,1212,29069
2021-01-26,MO,Dunklin,100,1312,29069
2021-01-27,MO,Dunklin,135,1447,29069
2021-01-28,MO,Dunklin,96,1543,29069
2021-01-29,MO,Dunklin,108,1651,29069
2021-01-30,MO,Dunklin,71,1722,29069
2021-02-01,MO,Dunklin,218,1940,29069
2021-02-02,MO,Dunklin,59,1999,29069
2021-02-03,MO,Dunklin,93,2092,29069
2021-02-04,MO,Dunklin,467,2559,29069
2021-02-05,MO,Dunklin,165,2724,29069
2021-02-06,MO,Dunklin,2,2726,29069
2021-02-08,MO,Dunklin,85,2811,29069
2021-02-09,MO,Dunklin,220,3031,29069
2021-02-10,MO,Dunklin,88,3119,29069
2021-02-11,MO,Dunklin,21,3140,29069
2021-02-12,MO,Dunklin,190,3330,29069
2021-02-13,MO,Dunklin,32,3362,29069
2021-02-14,MO,Dunklin,14,3376,29069
2021-02-15,MO,Dunklin,33,3409,29069
2021-02-16,MO,Dunklin,51,3460,29069
2021-02-17,MO,Dunklin,30,3490,29069
2021-02-18,MO,Dunklin,30,3520,29069
2021-02-19,MO,Dunklin,63,3583,29069
2021-02-20,MO,Dunklin,13,3596,29069
2021-02-21,MO,Dunklin,6,3602,29069
2021-02-22,MO,Dunklin,99,3701,29069
2021-02-23,MO,Dunklin,758,4459,29069
2021-02-24,MO,Dunklin,157,4616,29069
2021-02-25,MO,Dunklin,249,4865,29069
2021-02-26,MO,Dunklin,165,5030,29069
2021-02-27,MO,Dunklin,49,5079,29069
2021-03-01,MO,Dunklin,210,5289,29069
2021-03-02,MO,Dunklin,152,5441,29069
2021-03-03,MO,Dunklin,157,5598,29069
2021-03-04,MO,Dunklin,553,6151,29069
2021-03-05,MO,Dunklin,175,6326,29069
2021-03-06,MO,Dunklin,30,6356,29069
2021-03-07,MO,Dunklin,13,6369,29069
2021-03-08,MO,Dunklin,85,6454,29069
2021-03-09,MO,Dunklin,121,6575,29069
2021-03-10,MO,Dunklin,60,6635,29069
2021-03-11,MO,Dunklin,62,6697,29069
2021-03-12,MO,Dunklin,62,6759,29069
2021-03-13,MO,Dunklin,28,6787,29069
2021-03-14,MO,Dunklin,17,6804,29069
2021-03-15,MO,Dunklin,68,6872,29069
2021-03-16,MO,Dunklin,100,6972,29069
2021-03-17,MO,Dunklin,49,7021,29069
2021-03-18,MO,Dunklin,54,7075,29069
2021-03-19,MO,Dunklin,145,7220,29069
2021-03-20,MO,Dunklin,20,7240,29069
2021-03-21,MO,Dunklin,7,7247,29069
2021-03-22,MO,Dunklin,51,7298,29069
2021-03-23,MO,Dunklin,277,7575,29069
2021-03-24,MO,Dunklin,41,7616,29069
2021-03-25,MO,Dunklin,49,7665,29069
2021-03-26,MO,Dunklin,46,7711,29069
2021-03-27,MO,Dunklin,15,7726,29069
2021-03-28,MO,Dunklin,2,7728,29069
2021-03-29,MO,Dunklin,13,7741,29069
2021-03-30,MO,Dunklin,141,7882,29069
2021-03-31,MO,Dunklin,76,7958,29069
2021-04-01,MO,Dunklin,181,8139,29069
2021-04-02,MO,Dunklin,136,8275,29069
2021-04-03,MO,Dunklin,31,8306,29069
2021-04-04,MO,Dunklin,12,8318,29069
2021-04-05,MO,Dunklin,45,8363,29069
2021-04-06,MO,Dunklin,204,8567,29069
2021-04-07,MO,Dunklin,54,8621,29069
2021-04-08,MO,Dunklin,51,8672,29069
2021-04-09,MO,Dunklin,60,8732,29069
2021-04-10,MO,Dunklin,20,8752,29069
2021-04-11,MO,Dunklin,13,8765,29069
2021-04-12,MO,Dunklin,71,8836,29069
2021-04-13,MO,Dunklin,65,8901,29069
2021-04-14,MO,Dunklin,39,8940,29069
2021-04-15,MO,Dunklin,49,8989,29069
2021-04-16,MO,Dunklin,66,9055,29069
2021-04-17,MO,Dunklin,10,9065,29069
2021-04-18,MO,Dunklin,3,9068,29069
2021-04-19,MO,Dunklin,51,9119,29069
2021-04-20,MO,Dunklin,44,9163,29069
2021-04-21,MO,Dunklin,55,9218,29069
2021-04-22,MO,Dunklin,33,9251,29069
2021-04-23,MO,Dunklin,51,9302,29069
2021-04-24,MO,Dunklin,20,9322,29069
2021-04-25,MO,Dunklin,6,9328,29069
2021-04-26,MO,Dunklin,32,9360,29069
2021-04-27,MO,Dunklin,35,9395,29069
2021-04-28,MO,Dunklin,18,9413,29069
2021-04-29,MO,Dunklin,29,9442,29069
2021-04-30,MO,Dunklin,33,9475,29069
2021-05-01,MO,Dunklin,21,9496,29069
2021-05-02,MO,Dunklin,10,9506,29069
2021-05-03,MO,Dunklin,28,9534,29069
2021-05-04,MO,Dunklin,29,9563,29069
2021-05-05,MO,Dunklin,31,9594,29069
2021-05-06,MO,Dunklin,30,9624,29069
2021-05-07,MO,Dunklin,31,9655,29069
2021-05-08,MO,Dunklin,11,9666,29069
2021-05-09,MO,Dunklin,5,9671,29069
2021-05-10,MO,Dunklin,28,9699,29069
2021-05-11,MO,Dunklin,21,9720,29069
2021-05-12,MO,Dunklin,24,9744,29069
2021-05-13,MO,Dunklin,14,9758,29069
2021-05-14,MO,Dunklin,41,9799,29069
2021-05-15,MO,Dunklin,18,9817,29069
2021-05-16,MO,Dunklin,9,9826,29069
2021-05-17,MO,Dunklin,30,9856,29069
2021-05-18,MO,Dunklin,33,9889,29069
2021-05-19,MO,Dunklin,46,9935,29069
2021-05-20,MO,Dunklin,17,9952,29069
2021-05-21,MO,Dunklin,30,9982,29069
2021-05-22,MO,Dunklin,27,10009,29069
2021-05-23,MO,Dunklin,11,10020,29069
2021-05-24,MO,Dunklin,30,10050,29069
2021-05-25,MO,Dunklin,58,10108,29069
2021-05-26,MO,Dunklin,17,10125,29069
2021-05-27,MO,Dunklin,12,10137,29069
2020-12-14,MO,Franklin,2,2,29071
2020-12-15,MO,Franklin,52,54,29071
2020-12-16,MO,Franklin,93,147,29071
2020-12-17,MO,Franklin,141,288,29071
2020-12-18,MO,Franklin,151,439,29071
2020-12-19,MO,Franklin,29,468,29071
2020-12-20,MO,Franklin,8,476,29071
2020-12-21,MO,Franklin,145,621,29071
2020-12-22,MO,Franklin,140,761,29071
2020-12-23,MO,Franklin,142,903,29071
2020-12-24,MO,Franklin,28,931,29071
2020-12-26,MO,Franklin,18,949,29071
2020-12-27,MO,Franklin,12,961,29071
2020-12-28,MO,Franklin,117,1078,29071
2020-12-29,MO,Franklin,159,1237,29071
2020-12-30,MO,Franklin,176,1413,29071
2020-12-31,MO,Franklin,152,1565,29071
2021-01-01,MO,Franklin,3,1568,29071
2021-01-02,MO,Franklin,53,1621,29071
2021-01-03,MO,Franklin,6,1627,29071
2021-01-04,MO,Franklin,111,1738,29071
2021-01-05,MO,Franklin,143,1881,29071
2021-01-06,MO,Franklin,309,2190,29071
2021-01-07,MO,Franklin,201,2391,29071
2021-01-08,MO,Franklin,249,2640,29071
2021-01-09,MO,Franklin,77,2717,29071
2021-01-10,MO,Franklin,11,2728,29071
2021-01-11,MO,Franklin,295,3023,29071
2021-01-12,MO,Franklin,233,3256,29071
2021-01-13,MO,Franklin,201,3457,29071
2021-01-14,MO,Franklin,154,3611,29071
2021-01-15,MO,Franklin,320,3931,29071
2021-01-16,MO,Franklin,45,3976,29071
2021-01-17,MO,Franklin,20,3996,29071
2021-01-18,MO,Franklin,285,4281,29071
2021-01-19,MO,Franklin,300,4581,29071
2021-01-20,MO,Franklin,395,4976,29071
2021-01-21,MO,Franklin,317,5293,29071
2021-01-22,MO,Franklin,293,5586,29071
2021-01-23,MO,Franklin,183,5769,29071
2021-01-24,MO,Franklin,83,5852,29071
2021-01-25,MO,Franklin,270,6122,29071
2021-01-26,MO,Franklin,293,6415,29071
2021-01-27,MO,Franklin,210,6625,29071
2021-01-28,MO,Franklin,365,6990,29071
2021-01-29,MO,Franklin,373,7363,29071
2021-01-30,MO,Franklin,1195,8558,29071
2021-01-31,MO,Franklin,98,8656,29071
2021-02-01,MO,Franklin,311,8967,29071
2021-02-02,MO,Franklin,421,9388,29071
2021-02-03,MO,Franklin,358,9746,29071
2021-02-04,MO,Franklin,334,10080,29071
2021-02-05,MO,Franklin,262,10342,29071
2021-02-06,MO,Franklin,114,10456,29071
2021-02-07,MO,Franklin,7,10463,29071
2021-02-08,MO,Franklin,407,10870,29071
2021-02-09,MO,Franklin,477,11347,29071
2021-02-10,MO,Franklin,401,11748,29071
2021-02-11,MO,Franklin,519,12267,29071
2021-02-12,MO,Franklin,568,12835,29071
2021-02-13,MO,Franklin,212,13047,29071
2021-02-14,MO,Franklin,99,13146,29071
2021-02-15,MO,Franklin,196,13342,29071
2021-02-16,MO,Franklin,272,13614,29071
2021-02-17,MO,Franklin,339,13953,29071
2021-02-18,MO,Franklin,361,14314,29071
2021-02-19,MO,Franklin,409,14723,29071
2021-02-20,MO,Franklin,283,15006,29071
2021-02-21,MO,Franklin,10,15016,29071
2021-02-22,MO,Franklin,326,15342,29071
2021-02-23,MO,Franklin,499,15841,29071
2021-02-24,MO,Franklin,533,16374,29071
2021-02-25,MO,Franklin,780,17154,29071
2021-02-26,MO,Franklin,874,18028,29071
2021-02-27,MO,Franklin,1264,19292,29071
2021-02-28,MO,Franklin,45,19337,29071
2021-03-01,MO,Franklin,702,20039,29071
2021-03-02,MO,Franklin,834,20873,29071
2021-03-03,MO,Franklin,882,21755,29071
2021-03-04,MO,Franklin,647,22402,29071
2021-03-05,MO,Franklin,832,23234,29071
2021-03-06,MO,Franklin,309,23543,29071
2021-03-07,MO,Franklin,148,23691,29071
2021-03-08,MO,Franklin,638,24329,29071
2021-03-09,MO,Franklin,707,25036,29071
2021-03-10,MO,Franklin,786,25822,29071
2021-03-11,MO,Franklin,1167,26989,29071
2021-03-12,MO,Franklin,767,27756,29071
2021-03-13,MO,Franklin,207,27963,29071
2021-03-14,MO,Franklin,39,28002,29071
2021-03-15,MO,Franklin,642,28644,29071
2021-03-16,MO,Franklin,1074,29718,29071
2021-03-17,MO,Franklin,860,30578,29071
2021-03-18,MO,Franklin,1015,31593,29071
2021-03-19,MO,Franklin,1073,32666,29071
2021-03-20,MO,Franklin,214,32880,29071
2021-03-21,MO,Franklin,124,33004,29071
2021-03-22,MO,Franklin,781,33785,29071
2021-03-23,MO,Franklin,1245,35030,29071
2021-03-24,MO,Franklin,1058,36088,29071
2021-03-25,MO,Franklin,971,37059,29071
2021-03-26,MO,Franklin,1447,38506,29071
2021-03-27,MO,Franklin,427,38933,29071
2021-03-28,MO,Franklin,95,39028,29071
2021-03-29,MO,Franklin,761,39789,29071
2021-03-30,MO,Franklin,1851,41640,29071
2021-03-31,MO,Franklin,1492,43132,29071
2021-04-01,MO,Franklin,1405,44537,29071
2021-04-02,MO,Franklin,760,45297,29071
2021-04-03,MO,Franklin,200,45497,29071
2021-04-04,MO,Franklin,42,45539,29071
2021-04-05,MO,Franklin,903,46442,29071
2021-04-06,MO,Franklin,1090,47532,29071
2021-04-07,MO,Franklin,1247,48779,29071
2021-04-08,MO,Franklin,1278,50057,29071
2021-04-09,MO,Franklin,1149,51206,29071
2021-04-10,MO,Franklin,510,51716,29071
2021-04-11,MO,Franklin,174,51890,29071
2021-04-12,MO,Franklin,923,52813,29071
2021-04-13,MO,Franklin,1269,54082,29071
2021-04-14,MO,Franklin,973,55055,29071
2021-04-15,MO,Franklin,821,55876,29071
2021-04-16,MO,Franklin,1178,57054,29071
2021-04-17,MO,Franklin,249,57303,29071
2021-04-18,MO,Franklin,103,57406,29071
2021-04-19,MO,Franklin,638,58044,29071
2021-04-20,MO,Franklin,968,59012,29071
2021-04-21,MO,Franklin,849,59861,29071
2021-04-22,MO,Franklin,735,60596,29071
2021-04-23,MO,Franklin,762,61358,29071
2021-04-24,MO,Franklin,225,61583,29071
2021-04-25,MO,Franklin,64,61647,29071
2021-04-26,MO,Franklin,679,62326,29071
2021-04-27,MO,Franklin,1693,64019,29071
2021-04-28,MO,Franklin,956,64975,29071
2021-04-29,MO,Franklin,770,65745,29071
2021-04-30,MO,Franklin,808,66553,29071
2021-05-01,MO,Franklin,286,66839,29071
2021-05-02,MO,Franklin,76,66915,29071
2021-05-03,MO,Franklin,570,67485,29071
2021-05-04,MO,Franklin,589,68074,29071
2021-05-05,MO,Franklin,613,68687,29071
2021-05-06,MO,Franklin,462,69149,29071
2021-05-07,MO,Franklin,408,69557,29071
2021-05-08,MO,Franklin,172,69729,29071
2021-05-09,MO,Franklin,57,69786,29071
2021-05-10,MO,Franklin,460,70246,29071
2021-05-11,MO,Franklin,520,70766,29071
2021-05-12,MO,Franklin,398,71164,29071
2021-05-13,MO,Franklin,478,71642,29071
2021-05-14,MO,Franklin,581,72223,29071
2021-05-15,MO,Franklin,192,72415,29071
2021-05-16,MO,Franklin,109,72524,29071
2021-05-17,MO,Franklin,380,72904,29071
2021-05-18,MO,Franklin,411,73315,29071
2021-05-19,MO,Franklin,297,73612,29071
2021-05-20,MO,Franklin,324,73936,29071
2021-05-21,MO,Franklin,287,74223,29071
2021-05-22,MO,Franklin,126,74349,29071
2021-05-23,MO,Franklin,48,74397,29071
2021-05-24,MO,Franklin,276,74673,29071
2021-05-25,MO,Franklin,306,74979,29071
2021-05-26,MO,Franklin,221,75200,29071
2021-05-27,MO,Franklin,214,75414,29071
2020-12-15,MO,Gasconade,1,1,29073
2020-12-16,MO,Gasconade,4,5,29073
2020-12-17,MO,Gasconade,5,10,29073
2020-12-18,MO,Gasconade,18,28,29073
2020-12-19,MO,Gasconade,2,30,29073
2020-12-20,MO,Gasconade,1,31,29073
2020-12-21,MO,Gasconade,13,44,29073
2020-12-22,MO,Gasconade,19,63,29073
2020-12-23,MO,Gasconade,19,82,29073
2020-12-24,MO,Gasconade,6,88,29073
2020-12-26,MO,Gasconade,1,89,29073
2020-12-28,MO,Gasconade,17,106,29073
2020-12-29,MO,Gasconade,12,118,29073
2020-12-30,MO,Gasconade,15,133,29073
2020-12-31,MO,Gasconade,11,144,29073
2021-01-01,MO,Gasconade,1,145,29073
2021-01-02,MO,Gasconade,2,147,29073
2021-01-03,MO,Gasconade,3,150,29073
2021-01-04,MO,Gasconade,12,162,29073
2021-01-05,MO,Gasconade,88,250,29073
2021-01-06,MO,Gasconade,21,271,29073
2021-01-07,MO,Gasconade,51,322,29073
2021-01-08,MO,Gasconade,25,347,29073
2021-01-09,MO,Gasconade,3,350,29073
2021-01-10,MO,Gasconade,3,353,29073
2021-01-11,MO,Gasconade,17,370,29073
2021-01-12,MO,Gasconade,92,462,29073
2021-01-13,MO,Gasconade,32,494,29073
2021-01-14,MO,Gasconade,19,513,29073
2021-01-15,MO,Gasconade,53,566,29073
2021-01-16,MO,Gasconade,10,576,29073
2021-01-18,MO,Gasconade,35,611,29073
2021-01-19,MO,Gasconade,30,641,29073
2021-01-20,MO,Gasconade,29,670,29073
2021-01-21,MO,Gasconade,26,696,29073
2021-01-22,MO,Gasconade,38,734,29073
2021-01-23,MO,Gasconade,24,758,29073
2021-01-24,MO,Gasconade,6,764,29073
2021-01-25,MO,Gasconade,57,821,29073
2021-01-26,MO,Gasconade,175,996,29073
2021-01-27,MO,Gasconade,12,1008,29073
2021-01-28,MO,Gasconade,158,1166,29073
2021-01-29,MO,Gasconade,59,1225,29073
2021-01-30,MO,Gasconade,441,1666,29073
2021-01-31,MO,Gasconade,258,1924,29073
2021-02-01,MO,Gasconade,22,1946,29073
2021-02-02,MO,Gasconade,100,2046,29073
2021-02-03,MO,Gasconade,35,2081,29073
2021-02-04,MO,Gasconade,150,2231,29073
2021-02-05,MO,Gasconade,62,2293,29073
2021-02-06,MO,Gasconade,9,2302,29073
2021-02-07,MO,Gasconade,1,2303,29073
2021-02-08,MO,Gasconade,77,2380,29073
2021-02-09,MO,Gasconade,92,2472,29073
2021-02-10,MO,Gasconade,315,2787,29073
2021-02-11,MO,Gasconade,121,2908,29073
2021-02-12,MO,Gasconade,167,3075,29073
2021-02-13,MO,Gasconade,31,3106,29073
2021-02-14,MO,Gasconade,4,3110,29073
2021-02-15,MO,Gasconade,9,3119,29073
2021-02-16,MO,Gasconade,12,3131,29073
2021-02-17,MO,Gasconade,8,3139,29073
2021-02-18,MO,Gasconade,27,3166,29073
2021-02-19,MO,Gasconade,79,3245,29073
2021-02-20,MO,Gasconade,680,3925,29073
2021-02-21,MO,Gasconade,2,3927,29073
2021-02-22,MO,Gasconade,181,4108,29073
2021-02-23,MO,Gasconade,175,4283,29073
2021-02-24,MO,Gasconade,94,4377,29073
2021-02-25,MO,Gasconade,18,4395,29073
2021-02-26,MO,Gasconade,38,4433,29073
2021-02-27,MO,Gasconade,16,4449,29073
2021-02-28,MO,Gasconade,5,4454,29073
2021-03-01,MO,Gasconade,41,4495,29073
2021-03-02,MO,Gasconade,124,4619,29073
2021-03-03,MO,Gasconade,110,4729,29073
2021-03-04,MO,Gasconade,142,4871,29073
2021-03-05,MO,Gasconade,69,4940,29073
2021-03-06,MO,Gasconade,46,4986,29073
2021-03-07,MO,Gasconade,2,4988,29073
2021-03-08,MO,Gasconade,29,5017,29073
2021-03-09,MO,Gasconade,70,5087,29073
2021-03-10,MO,Gasconade,417,5504,29073
2021-03-11,MO,Gasconade,129,5633,29073
2021-03-12,MO,Gasconade,149,5782,29073
2021-03-13,MO,Gasconade,29,5811,29073
2021-03-14,MO,Gasconade,2,5813,29073
2021-03-15,MO,Gasconade,131,5944,29073
2021-03-16,MO,Gasconade,31,5975,29073
2021-03-17,MO,Gasconade,120,6095,29073
2021-03-18,MO,Gasconade,76,6171,29073
2021-03-19,MO,Gasconade,148,6319,29073
2021-03-20,MO,Gasconade,7,6326,29073
2021-03-21,MO,Gasconade,4,6330,29073
2021-03-22,MO,Gasconade,61,6391,29073
2021-03-23,MO,Gasconade,50,6441,29073
2021-03-24,MO,Gasconade,142,6583,29073
2021-03-25,MO,Gasconade,55,6638,29073
2021-03-26,MO,Gasconade,120,6758,29073
2021-03-27,MO,Gasconade,58,6816,29073
2021-03-28,MO,Gasconade,2,6818,29073
2021-03-29,MO,Gasconade,43,6861,29073
2021-03-30,MO,Gasconade,57,6918,29073
2021-03-31,MO,Gasconade,114,7032,29073
2021-04-01,MO,Gasconade,89,7121,29073
2021-04-02,MO,Gasconade,91,7212,29073
2021-04-03,MO,Gasconade,8,7220,29073
2021-04-05,MO,Gasconade,152,7372,29073
2021-04-06,MO,Gasconade,96,7468,29073
2021-04-07,MO,Gasconade,287,7755,29073
2021-04-08,MO,Gasconade,64,7819,29073
2021-04-09,MO,Gasconade,144,7963,29073
2021-04-10,MO,Gasconade,309,8272,29073
2021-04-11,MO,Gasconade,5,8277,29073
2021-04-12,MO,Gasconade,75,8352,29073
2021-04-13,MO,Gasconade,47,8399,29073
2021-04-14,MO,Gasconade,89,8488,29073
2021-04-15,MO,Gasconade,64,8552,29073
2021-04-16,MO,Gasconade,165,8717,29073
2021-04-17,MO,Gasconade,12,8729,29073
2021-04-18,MO,Gasconade,6,8735,29073
2021-04-19,MO,Gasconade,46,8781,29073
2021-04-20,MO,Gasconade,45,8826,29073
2021-04-21,MO,Gasconade,46,8872,29073
2021-04-22,MO,Gasconade,44,8916,29073
2021-04-23,MO,Gasconade,60,8976,29073
2021-04-24,MO,Gasconade,8,8984,29073
2021-04-25,MO,Gasconade,2,8986,29073
2021-04-26,MO,Gasconade,39,9025,29073
2021-04-27,MO,Gasconade,48,9073,29073
2021-04-28,MO,Gasconade,64,9137,29073
2021-04-29,MO,Gasconade,42,9179,29073
2021-04-30,MO,Gasconade,101,9280,29073
2021-05-01,MO,Gasconade,279,9559,29073
2021-05-02,MO,Gasconade,1,9560,29073
2021-05-03,MO,Gasconade,30,9590,29073
2021-05-04,MO,Gasconade,62,9652,29073
2021-05-05,MO,Gasconade,44,9696,29073
2021-05-06,MO,Gasconade,43,9739,29073
2021-05-07,MO,Gasconade,41,9780,29073
2021-05-08,MO,Gasconade,10,9790,29073
2021-05-09,MO,Gasconade,10,9800,29073
2021-05-10,MO,Gasconade,32,9832,29073
2021-05-11,MO,Gasconade,42,9874,29073
2021-05-12,MO,Gasconade,32,9906,29073
2021-05-13,MO,Gasconade,25,9931,29073
2021-05-14,MO,Gasconade,29,9960,29073
2021-05-15,MO,Gasconade,10,9970,29073
2021-05-16,MO,Gasconade,2,9972,29073
2021-05-17,MO,Gasconade,28,10000,29073
2021-05-18,MO,Gasconade,72,10072,29073
2021-05-19,MO,Gasconade,10,10082,29073
2021-05-20,MO,Gasconade,33,10115,29073
2021-05-21,MO,Gasconade,33,10148,29073
2021-05-22,MO,Gasconade,8,10156,29073
2021-05-23,MO,Gasconade,3,10159,29073
2021-05-24,MO,Gasconade,22,10181,29073
2021-05-25,MO,Gasconade,26,10207,29073
2021-05-26,MO,Gasconade,8,10215,29073
2021-05-27,MO,Gasconade,20,10235,29073
2020-12-21,MO,Gentry,2,2,29075
2020-12-22,MO,Gentry,2,4,29075
2020-12-23,MO,Gentry,10,14,29075
2020-12-27,MO,Gentry,6,20,29075
2020-12-28,MO,Gentry,14,34,29075
2020-12-29,MO,Gentry,10,44,29075
2020-12-30,MO,Gentry,10,54,29075
2020-12-31,MO,Gentry,3,57,29075
2021-01-02,MO,Gentry,2,59,29075
2021-01-03,MO,Gentry,31,90,29075
2021-01-04,MO,Gentry,55,145,29075
2021-01-05,MO,Gentry,22,167,29075
2021-01-06,MO,Gentry,5,172,29075
2021-01-07,MO,Gentry,3,175,29075
2021-01-08,MO,Gentry,3,178,29075
2021-01-11,MO,Gentry,5,183,29075
2021-01-12,MO,Gentry,13,196,29075
2021-01-13,MO,Gentry,16,212,29075
2021-01-14,MO,Gentry,32,244,29075
2021-01-15,MO,Gentry,11,255,29075
2021-01-16,MO,Gentry,1,256,29075
2021-01-17,MO,Gentry,1,257,29075
2021-01-18,MO,Gentry,2,259,29075
2021-01-19,MO,Gentry,3,262,29075
2021-01-20,MO,Gentry,67,329,29075
2021-01-21,MO,Gentry,35,364,29075
2021-01-22,MO,Gentry,41,405,29075
2021-01-23,MO,Gentry,1,406,29075
2021-01-25,MO,Gentry,4,410,29075
2021-01-26,MO,Gentry,20,430,29075
2021-01-27,MO,Gentry,84,514,29075
2021-01-28,MO,Gentry,65,579,29075
2021-01-29,MO,Gentry,12,591,29075
2021-01-30,MO,Gentry,3,594,29075
2021-01-31,MO,Gentry,4,598,29075
2021-02-01,MO,Gentry,268,866,29075
2021-02-02,MO,Gentry,31,897,29075
2021-02-03,MO,Gentry,98,995,29075
2021-02-04,MO,Gentry,77,1072,29075
2021-02-05,MO,Gentry,74,1146,29075
2021-02-06,MO,Gentry,1,1147,29075
2021-02-08,MO,Gentry,4,1151,29075
2021-02-09,MO,Gentry,32,1183,29075
2021-02-10,MO,Gentry,34,1217,29075
2021-02-11,MO,Gentry,68,1285,29075
2021-02-12,MO,Gentry,45,1330,29075
2021-02-13,MO,Gentry,8,1338,29075
2021-02-14,MO,Gentry,2,1340,29075
2021-02-15,MO,Gentry,5,1345,29075
2021-02-16,MO,Gentry,4,1349,29075
2021-02-17,MO,Gentry,55,1404,29075
2021-02-18,MO,Gentry,90,1494,29075
2021-02-19,MO,Gentry,26,1520,29075
2021-02-20,MO,Gentry,2,1522,29075
2021-02-22,MO,Gentry,259,1781,29075
2021-02-23,MO,Gentry,34,1815,29075
2021-02-24,MO,Gentry,29,1844,29075
2021-02-25,MO,Gentry,49,1893,29075
2021-02-26,MO,Gentry,146,2039,29075
2021-02-27,MO,Gentry,51,2090,29075
2021-03-01,MO,Gentry,2,2092,29075
2021-03-02,MO,Gentry,42,2134,29075
2021-03-03,MO,Gentry,54,2188,29075
2021-03-04,MO,Gentry,69,2257,29075
2021-03-05,MO,Gentry,60,2317,29075
2021-03-06,MO,Gentry,20,2337,29075
2021-03-07,MO,Gentry,3,2340,29075
2021-03-08,MO,Gentry,25,2365,29075
2021-03-09,MO,Gentry,14,2379,29075
2021-03-10,MO,Gentry,71,2450,29075
2021-03-11,MO,Gentry,18,2468,29075
2021-03-12,MO,Gentry,15,2483,29075
2021-03-13,MO,Gentry,11,2494,29075
2021-03-15,MO,Gentry,30,2524,29075
2021-03-16,MO,Gentry,42,2566,29075
2021-03-17,MO,Gentry,69,2635,29075
2021-03-18,MO,Gentry,43,2678,29075
2021-03-19,MO,Gentry,97,2775,29075
2021-03-20,MO,Gentry,6,2781,29075
2021-03-21,MO,Gentry,2,2783,29075
2021-03-22,MO,Gentry,13,2796,29075
2021-03-23,MO,Gentry,16,2812,29075
2021-03-24,MO,Gentry,24,2836,29075
2021-03-25,MO,Gentry,45,2881,29075
2021-03-26,MO,Gentry,41,2922,29075
2021-03-27,MO,Gentry,6,2928,29075
2021-03-28,MO,Gentry,2,2930,29075
2021-03-29,MO,Gentry,20,2950,29075
2021-03-30,MO,Gentry,32,2982,29075
2021-03-31,MO,Gentry,24,3006,29075
2021-04-01,MO,Gentry,35,3041,29075
2021-04-02,MO,Gentry,21,3062,29075
2021-04-03,MO,Gentry,7,3069,29075
2021-04-04,MO,Gentry,1,3070,29075
2021-04-05,MO,Gentry,14,3084,29075
2021-04-06,MO,Gentry,30,3114,29075
2021-04-07,MO,Gentry,39,3153,29075
2021-04-08,MO,Gentry,16,3169,29075
2021-04-09,MO,Gentry,86,3255,29075
2021-04-10,MO,Gentry,4,3259,29075
2021-04-11,MO,Gentry,3,3262,29075
2021-04-12,MO,Gentry,49,3311,29075
2021-04-13,MO,Gentry,16,3327,29075
2021-04-14,MO,Gentry,34,3361,29075
2021-04-15,MO,Gentry,20,3381,29075
2021-04-16,MO,Gentry,28,3409,29075
2021-04-17,MO,Gentry,3,3412,29075
2021-04-18,MO,Gentry,3,3415,29075
2021-04-19,MO,Gentry,8,3423,29075
2021-04-20,MO,Gentry,20,3443,29075
2021-04-21,MO,Gentry,8,3451,29075
2021-04-22,MO,Gentry,43,3494,29075
2021-04-23,MO,Gentry,12,3506,29075
2021-04-25,MO,Gentry,2,3508,29075
2021-04-26,MO,Gentry,3,3511,29075
2021-04-27,MO,Gentry,22,3533,29075
2021-04-28,MO,Gentry,6,3539,29075
2021-04-29,MO,Gentry,16,3555,29075
2021-04-30,MO,Gentry,11,3566,29075
2021-05-01,MO,Gentry,4,3570,29075
2021-05-03,MO,Gentry,47,3617,29075
2021-05-04,MO,Gentry,15,3632,29075
2021-05-05,MO,Gentry,14,3646,29075
2021-05-06,MO,Gentry,14,3660,29075
2021-05-07,MO,Gentry,16,3676,29075
2021-05-10,MO,Gentry,6,3682,29075
2021-05-11,MO,Gentry,8,3690,29075
2021-05-12,MO,Gentry,7,3697,29075
2021-05-13,MO,Gentry,10,3707,29075
2021-05-14,MO,Gentry,9,3716,29075
2021-05-15,MO,Gentry,4,3720,29075
2021-05-16,MO,Gentry,1,3721,29075
2021-05-17,MO,Gentry,9,3730,29075
2021-05-18,MO,Gentry,5,3735,29075
2021-05-19,MO,Gentry,9,3744,29075
2021-05-20,MO,Gentry,15,3759,29075
2021-05-21,MO,Gentry,3,3762,29075
2021-05-23,MO,Gentry,1,3763,29075
2021-05-24,MO,Gentry,7,3770,29075
2021-05-25,MO,Gentry,3,3773,29075
2021-05-26,MO,Gentry,8,3781,29075
2021-05-27,MO,Gentry,13,3794,29075
2020-12-14,MO,Greene,12,12,29077
2020-12-15,MO,Greene,97,109,29077
2020-12-16,MO,Greene,355,464,29077
2020-12-17,MO,Greene,379,843,29077
2020-12-18,MO,Greene,297,1140,29077
2020-12-19,MO,Greene,96,1236,29077
2020-12-20,MO,Greene,52,1288,29077
2020-12-21,MO,Greene,429,1717,29077
2020-12-22,MO,Greene,828,2545,29077
2020-12-23,MO,Greene,856,3401,29077
2020-12-24,MO,Greene,538,3939,29077
2020-12-26,MO,Greene,305,4244,29077
2020-12-27,MO,Greene,119,4363,29077
2020-12-28,MO,Greene,496,4859,29077
2020-12-29,MO,Greene,648,5507,29077
2020-12-30,MO,Greene,699,6206,29077
2020-12-31,MO,Greene,703,6909,29077
2021-01-01,MO,Greene,2,6911,29077
2021-01-02,MO,Greene,141,7052,29077
2021-01-03,MO,Greene,78,7130,29077
2021-01-04,MO,Greene,320,7450,29077
2021-01-05,MO,Greene,379,7829,29077
2021-01-06,MO,Greene,311,8140,29077
2021-01-07,MO,Greene,240,8380,29077
2021-01-08,MO,Greene,789,9169,29077
2021-01-09,MO,Greene,140,9309,29077
2021-01-10,MO,Greene,130,9439,29077
2021-01-11,MO,Greene,372,9811,29077
2021-01-12,MO,Greene,602,10413,29077
2021-01-13,MO,Greene,688,11101,29077
2021-01-14,MO,Greene,526,11627,29077
2021-01-15,MO,Greene,504,12131,29077
2021-01-16,MO,Greene,423,12554,29077
2021-01-17,MO,Greene,187,12741,29077
2021-01-18,MO,Greene,541,13282,29077
2021-01-19,MO,Greene,697,13979,29077
2021-01-20,MO,Greene,999,14978,29077
2021-01-21,MO,Greene,1157,16135,29077
2021-01-22,MO,Greene,1285,17420,29077
2021-01-23,MO,Greene,574,17994,29077
2021-01-24,MO,Greene,339,18333,29077
2021-01-25,MO,Greene,1264,19597,29077
2021-01-26,MO,Greene,1400,20997,29077
2021-01-27,MO,Greene,1508,22505,29077
2021-01-28,MO,Greene,1661,24166,29077
2021-01-29,MO,Greene,582,24748,29077
2021-01-30,MO,Greene,295,25043,29077
2021-01-31,MO,Greene,10,25053,29077
2021-02-01,MO,Greene,756,25809,29077
2021-02-02,MO,Greene,358,26167,29077
2021-02-03,MO,Greene,934,27101,29077
2021-02-04,MO,Greene,837,27938,29077
2021-02-05,MO,Greene,2095,30033,29077
2021-02-06,MO,Greene,1779,31812,29077
2021-02-07,MO,Greene,65,31877,29077
2021-02-08,MO,Greene,1654,33531,29077
2021-02-09,MO,Greene,1150,34681,29077
2021-02-10,MO,Greene,936,35617,29077
2021-02-11,MO,Greene,1592,37209,29077
2021-02-12,MO,Greene,1721,38930,29077
2021-02-13,MO,Greene,1004,39934,29077
2021-02-14,MO,Greene,766,40700,29077
2021-02-15,MO,Greene,402,41102,29077
2021-02-16,MO,Greene,817,41919,29077
2021-02-17,MO,Greene,654,42573,29077
2021-02-18,MO,Greene,1530,44103,29077
2021-02-19,MO,Greene,797,44900,29077
2021-02-20,MO,Greene,72,44972,29077
2021-02-21,MO,Greene,123,45095,29077
2021-02-22,MO,Greene,532,45627,29077
2021-02-23,MO,Greene,871,46498,29077
2021-02-24,MO,Greene,1590,48088,29077
2021-02-25,MO,Greene,1639,49727,29077
2021-02-26,MO,Greene,2746,52473,29077
2021-02-27,MO,Greene,2573,55046,29077
2021-02-28,MO,Greene,259,55305,29077
2021-03-01,MO,Greene,2264,57569,29077
2021-03-02,MO,Greene,735,58304,29077
2021-03-03,MO,Greene,2692,60996,29077
2021-03-04,MO,Greene,3253,64249,29077
2021-03-05,MO,Greene,2439,66688,29077
2021-03-06,MO,Greene,2446,69134,29077
2021-03-07,MO,Greene,347,69481,29077
2021-03-08,MO,Greene,2664,72145,29077
2021-03-09,MO,Greene,2851,74996,29077
2021-03-10,MO,Greene,1432,76428,29077
2021-03-11,MO,Greene,1844,78272,29077
2021-03-12,MO,Greene,1721,79993,29077
2021-03-13,MO,Greene,933,80926,29077
2021-03-14,MO,Greene,424,81350,29077
2021-03-15,MO,Greene,1956,83306,29077
2021-03-16,MO,Greene,1761,85067,29077
2021-03-17,MO,Greene,1656,86723,29077
2021-03-18,MO,Greene,3130,89853,29077
2021-03-19,MO,Greene,3157,93010,29077
2021-03-20,MO,Greene,1194,94204,29077
2021-03-21,MO,Greene,665,94869,29077
2021-03-22,MO,Greene,2625,97494,29077
2021-03-23,MO,Greene,2085,99579,29077
2021-03-24,MO,Greene,2637,102216,29077
2021-03-25,MO,Greene,2117,104333,29077
2021-03-26,MO,Greene,3354,107687,29077
2021-03-27,MO,Greene,2107,109794,29077
2021-03-28,MO,Greene,432,110226,29077
2021-03-29,MO,Greene,2462,112688,29077
2021-03-30,MO,Greene,1823,114511,29077
2021-03-31,MO,Greene,3027,117538,29077
2021-04-01,MO,Greene,3360,120898,29077
2021-04-02,MO,Greene,2841,123739,29077
2021-04-03,MO,Greene,2104,125843,29077
2021-04-04,MO,Greene,375,126218,29077
2021-04-05,MO,Greene,2742,128960,29077
2021-04-06,MO,Greene,3321,132281,29077
2021-04-07,MO,Greene,2266,134547,29077
2021-04-08,MO,Greene,3654,138201,29077
2021-04-09,MO,Greene,4409,142610,29077
2021-04-10,MO,Greene,1230,143840,29077
2021-04-11,MO,Greene,547,144387,29077
2021-04-12,MO,Greene,2598,146985,29077
2021-04-13,MO,Greene,1897,148882,29077
2021-04-14,MO,Greene,2172,151054,29077
2021-04-15,MO,Greene,1479,152533,29077
2021-04-16,MO,Greene,1339,153872,29077
2021-04-17,MO,Greene,694,154566,29077
2021-04-18,MO,Greene,283,154849,29077
2021-04-19,MO,Greene,1369,156218,29077
2021-04-20,MO,Greene,1345,157563,29077
2021-04-21,MO,Greene,1239,158802,29077
2021-04-22,MO,Greene,1544,160346,29077
2021-04-23,MO,Greene,1174,161520,29077
2021-04-24,MO,Greene,1862,163382,29077
2021-04-25,MO,Greene,322,163704,29077
2021-04-26,MO,Greene,1497,165201,29077
2021-04-27,MO,Greene,755,165956,29077
2021-04-28,MO,Greene,1269,167225,29077
2021-04-29,MO,Greene,832,168057,29077
2021-04-30,MO,Greene,1199,169256,29077
2021-05-01,MO,Greene,520,169776,29077
2021-05-02,MO,Greene,316,170092,29077
2021-05-03,MO,Greene,785,170877,29077
2021-05-04,MO,Greene,694,171571,29077
2021-05-05,MO,Greene,1504,173075,29077
2021-05-06,MO,Greene,652,173727,29077
2021-05-07,MO,Greene,990,174717,29077
2021-05-08,MO,Greene,336,175053,29077
2021-05-09,MO,Greene,187,175240,29077
2021-05-10,MO,Greene,599,175839,29077
2021-05-11,MO,Greene,669,176508,29077
2021-05-12,MO,Greene,467,176975,29077
2021-05-13,MO,Greene,724,177699,29077
2021-05-14,MO,Greene,994,178693,29077
2021-05-15,MO,Greene,628,179321,29077
2021-05-16,MO,Greene,262,179583,29077
2021-05-17,MO,Greene,876,180459,29077
2021-05-18,MO,Greene,603,181062,29077
2021-05-19,MO,Greene,826,181888,29077
2021-05-20,MO,Greene,713,182601,29077
2021-05-21,MO,Greene,723,183324,29077
2021-05-22,MO,Greene,386,183710,29077
2021-05-23,MO,Greene,180,183890,29077
2021-05-24,MO,Greene,465,184355,29077
2021-05-25,MO,Greene,425,184780,29077
2021-05-26,MO,Greene,439,185219,29077
2021-05-27,MO,Greene,283,185502,29077
2020-12-18,MO,Grundy,1,1,29079
2020-12-21,MO,Grundy,1,2,29079
2020-12-22,MO,Grundy,4,6,29079
2020-12-23,MO,Grundy,6,12,29079
2020-12-24,MO,Grundy,2,14,29079
2020-12-28,MO,Grundy,6,20,29079
2020-12-29,MO,Grundy,4,24,29079
2020-12-30,MO,Grundy,13,37,29079
2020-12-31,MO,Grundy,6,43,29079
2021-01-02,MO,Grundy,1,44,29079
2021-01-03,MO,Grundy,1,45,29079
2021-01-04,MO,Grundy,9,54,29079
2021-01-05,MO,Grundy,3,57,29079
2021-01-06,MO,Grundy,7,64,29079
2021-01-07,MO,Grundy,2,66,29079
2021-01-08,MO,Grundy,6,72,29079
2021-01-09,MO,Grundy,4,76,29079
2021-01-11,MO,Grundy,37,113,29079
2021-01-12,MO,Grundy,19,132,29079
2021-01-13,MO,Grundy,14,146,29079
2021-01-14,MO,Grundy,69,215,29079
2021-01-15,MO,Grundy,30,245,29079
2021-01-16,MO,Grundy,2,247,29079
2021-01-18,MO,Grundy,6,253,29079
2021-01-19,MO,Grundy,2,255,29079
2021-01-20,MO,Grundy,9,264,29079
2021-01-22,MO,Grundy,71,335,29079
2021-01-23,MO,Grundy,3,338,29079
2021-01-24,MO,Grundy,1,339,29079
2021-01-25,MO,Grundy,15,354,29079
2021-01-26,MO,Grundy,6,360,29079
2021-01-27,MO,Grundy,20,380,29079
2021-01-28,MO,Grundy,64,444,29079
2021-01-29,MO,Grundy,73,517,29079
2021-01-30,MO,Grundy,4,521,29079
2021-02-01,MO,Grundy,12,533,29079
2021-02-02,MO,Grundy,9,542,29079
2021-02-03,MO,Grundy,17,559,29079
2021-02-04,MO,Grundy,213,772,29079
2021-02-05,MO,Grundy,38,810,29079
2021-02-06,MO,Grundy,3,813,29079
2021-02-08,MO,Grundy,46,859,29079
2021-02-09,MO,Grundy,58,917,29079
2021-02-10,MO,Grundy,55,972,29079
2021-02-11,MO,Grundy,146,1118,29079
2021-02-12,MO,Grundy,57,1175,29079
2021-02-13,MO,Grundy,31,1206,29079
2021-02-15,MO,Grundy,3,1209,29079
2021-02-16,MO,Grundy,8,1217,29079
2021-02-17,MO,Grundy,17,1234,29079
2021-02-18,MO,Grundy,70,1304,29079
2021-02-19,MO,Grundy,69,1373,29079
2021-02-20,MO,Grundy,2,1375,29079
2021-02-21,MO,Grundy,1,1376,29079
2021-02-22,MO,Grundy,11,1387,29079
2021-02-23,MO,Grundy,86,1473,29079
2021-02-24,MO,Grundy,85,1558,29079
2021-02-25,MO,Grundy,258,1816,29079
2021-02-26,MO,Grundy,138,1954,29079
2021-02-27,MO,Grundy,90,2044,29079
2021-03-01,MO,Grundy,24,2068,29079
2021-03-02,MO,Grundy,8,2076,29079
2021-03-03,MO,Grundy,34,2110,29079
2021-03-04,MO,Grundy,84,2194,29079
2021-03-05,MO,Grundy,40,2234,29079
2021-03-06,MO,Grundy,29,2263,29079
2021-03-07,MO,Grundy,1,2264,29079
2021-03-08,MO,Grundy,17,2281,29079
2021-03-09,MO,Grundy,35,2316,29079
2021-03-10,MO,Grundy,21,2337,29079
2021-03-11,MO,Grundy,76,2413,29079
2021-03-12,MO,Grundy,40,2453,29079
2021-03-13,MO,Grundy,31,2484,29079
2021-03-15,MO,Grundy,9,2493,29079
2021-03-16,MO,Grundy,124,2617,29079
2021-03-17,MO,Grundy,102,2719,29079
2021-03-18,MO,Grundy,92,2811,29079
2021-03-19,MO,Grundy,168,2979,29079
2021-03-20,MO,Grundy,19,2998,29079
2021-03-22,MO,Grundy,23,3021,29079
2021-03-23,MO,Grundy,35,3056,29079
2021-03-24,MO,Grundy,38,3094,29079
2021-03-25,MO,Grundy,116,3210,29079
2021-03-26,MO,Grundy,126,3336,29079
2021-03-27,MO,Grundy,16,3352,29079
2021-03-28,MO,Grundy,3,3355,29079
2021-03-29,MO,Grundy,28,3383,29079
2021-03-30,MO,Grundy,20,3403,29079
2021-03-31,MO,Grundy,15,3418,29079
2021-04-01,MO,Grundy,126,3544,29079
2021-04-02,MO,Grundy,36,3580,29079
2021-04-03,MO,Grundy,19,3599,29079
2021-04-04,MO,Grundy,1,3600,29079
2021-04-05,MO,Grundy,18,3618,29079
2021-04-06,MO,Grundy,14,3632,29079
2021-04-07,MO,Grundy,22,3654,29079
2021-04-08,MO,Grundy,30,3684,29079
2021-04-09,MO,Grundy,119,3803,29079
2021-04-10,MO,Grundy,9,3812,29079
2021-04-11,MO,Grundy,1,3813,29079
2021-04-12,MO,Grundy,23,3836,29079
2021-04-13,MO,Grundy,20,3856,29079
2021-04-14,MO,Grundy,19,3875,29079
2021-04-15,MO,Grundy,23,3898,29079
2021-04-16,MO,Grundy,31,3929,29079
2021-04-17,MO,Grundy,5,3934,29079
2021-04-18,MO,Grundy,1,3935,29079
2021-04-19,MO,Grundy,10,3945,29079
2021-04-20,MO,Grundy,26,3971,29079
2021-04-21,MO,Grundy,13,3984,29079
2021-04-22,MO,Grundy,20,4004,29079
2021-04-23,MO,Grundy,73,4077,29079
2021-04-24,MO,Grundy,10,4087,29079
2021-04-25,MO,Grundy,1,4088,29079
2021-04-26,MO,Grundy,1,4089,29079
2021-04-27,MO,Grundy,10,4099,29079
2021-04-28,MO,Grundy,30,4129,29079
2021-04-29,MO,Grundy,47,4176,29079
2021-04-30,MO,Grundy,35,4211,29079
2021-05-01,MO,Grundy,11,4222,29079
2021-05-02,MO,Grundy,2,4224,29079
2021-05-04,MO,Grundy,21,4245,29079
2021-05-05,MO,Grundy,12,4257,29079
2021-05-06,MO,Grundy,23,4280,29079
2021-05-07,MO,Grundy,11,4291,29079
2021-05-08,MO,Grundy,2,4293,29079
2021-05-10,MO,Grundy,3,4296,29079
2021-05-11,MO,Grundy,3,4299,29079
2021-05-12,MO,Grundy,6,4305,29079
2021-05-13,MO,Grundy,25,4330,29079
2021-05-14,MO,Grundy,16,4346,29079
2021-05-15,MO,Grundy,5,4351,29079
2021-05-16,MO,Grundy,1,4352,29079
2021-05-17,MO,Grundy,5,4357,29079
2021-05-18,MO,Grundy,12,4369,29079
2021-05-19,MO,Grundy,8,4377,29079
2021-05-20,MO,Grundy,8,4385,29079
2021-05-21,MO,Grundy,37,4422,29079
2021-05-22,MO,Grundy,4,4426,29079
2021-05-24,MO,Grundy,25,4451,29079
2021-05-25,MO,Grundy,7,4458,29079
2021-05-26,MO,Grundy,13,4471,29079
2021-05-27,MO,Grundy,13,4484,29079
2020-12-20,MO,Harrison,1,1,29081
2020-12-21,MO,Harrison,2,3,29081
2020-12-22,MO,Harrison,2,5,29081
2020-12-23,MO,Harrison,3,8,29081
2020-12-24,MO,Harrison,2,10,29081
2020-12-27,MO,Harrison,5,15,29081
2020-12-28,MO,Harrison,10,25,29081
2020-12-29,MO,Harrison,18,43,29081
2020-12-30,MO,Harrison,59,102,29081
2020-12-31,MO,Harrison,3,105,29081
2021-01-03,MO,Harrison,2,107,29081
2021-01-04,MO,Harrison,6,113,29081
2021-01-05,MO,Harrison,3,116,29081
2021-01-06,MO,Harrison,9,125,29081
2021-01-07,MO,Harrison,10,135,29081
2021-01-08,MO,Harrison,9,144,29081
2021-01-09,MO,Harrison,2,146,29081
2021-01-12,MO,Harrison,8,154,29081
2021-01-13,MO,Harrison,35,189,29081
2021-01-14,MO,Harrison,14,203,29081
2021-01-15,MO,Harrison,15,218,29081
2021-01-16,MO,Harrison,1,219,29081
2021-01-18,MO,Harrison,2,221,29081
2021-01-19,MO,Harrison,5,226,29081
2021-01-20,MO,Harrison,17,243,29081
2021-01-21,MO,Harrison,12,255,29081
2021-01-22,MO,Harrison,6,261,29081
2021-01-23,MO,Harrison,1,262,29081
2021-01-25,MO,Harrison,6,268,29081
2021-01-26,MO,Harrison,6,274,29081
2021-01-27,MO,Harrison,84,358,29081
2021-01-28,MO,Harrison,33,391,29081
2021-01-29,MO,Harrison,247,638,29081
2021-01-30,MO,Harrison,2,640,29081
2021-01-31,MO,Harrison,1,641,29081
2021-02-01,MO,Harrison,63,704,29081
2021-02-02,MO,Harrison,13,717,29081
2021-02-03,MO,Harrison,63,780,29081
2021-02-04,MO,Harrison,22,802,29081
2021-02-05,MO,Harrison,40,842,29081
2021-02-06,MO,Harrison,2,844,29081
2021-02-07,MO,Harrison,1,845,29081
2021-02-08,MO,Harrison,21,866,29081
2021-02-09,MO,Harrison,90,956,29081
2021-02-10,MO,Harrison,101,1057,29081
2021-02-11,MO,Harrison,28,1085,29081
2021-02-12,MO,Harrison,58,1143,29081
2021-02-13,MO,Harrison,7,1150,29081
2021-02-14,MO,Harrison,3,1153,29081
2021-02-15,MO,Harrison,9,1162,29081
2021-02-16,MO,Harrison,8,1170,29081
2021-02-17,MO,Harrison,52,1222,29081
2021-02-18,MO,Harrison,14,1236,29081
2021-02-19,MO,Harrison,246,1482,29081
2021-02-20,MO,Harrison,7,1489,29081
2021-02-22,MO,Harrison,12,1501,29081
2021-02-23,MO,Harrison,5,1506,29081
2021-02-24,MO,Harrison,62,1568,29081
2021-02-25,MO,Harrison,27,1595,29081
2021-02-26,MO,Harrison,58,1653,29081
2021-02-27,MO,Harrison,192,1845,29081
2021-03-01,MO,Harrison,6,1851,29081
2021-03-02,MO,Harrison,21,1872,29081
2021-03-03,MO,Harrison,107,1979,29081
2021-03-04,MO,Harrison,20,1999,29081
2021-03-05,MO,Harrison,49,2048,29081
2021-03-06,MO,Harrison,86,2134,29081
2021-03-07,MO,Harrison,2,2136,29081
2021-03-08,MO,Harrison,13,2149,29081
2021-03-09,MO,Harrison,13,2162,29081
2021-03-10,MO,Harrison,9,2171,29081
2021-03-11,MO,Harrison,18,2189,29081
2021-03-12,MO,Harrison,15,2204,29081
2021-03-13,MO,Harrison,8,2212,29081
2021-03-14,MO,Harrison,1,2213,29081
2021-03-15,MO,Harrison,25,2238,29081
2021-03-16,MO,Harrison,40,2278,29081
2021-03-17,MO,Harrison,53,2331,29081
2021-03-18,MO,Harrison,56,2387,29081
2021-03-19,MO,Harrison,47,2434,29081
2021-03-20,MO,Harrison,5,2439,29081
2021-03-21,MO,Harrison,9,2448,29081
2021-03-22,MO,Harrison,13,2461,29081
2021-03-23,MO,Harrison,9,2470,29081
2021-03-24,MO,Harrison,25,2495,29081
2021-03-25,MO,Harrison,28,2523,29081
2021-03-26,MO,Harrison,21,2544,29081
2021-03-27,MO,Harrison,5,2549,29081
2021-03-28,MO,Harrison,3,2552,29081
2021-03-29,MO,Harrison,10,2562,29081
2021-03-30,MO,Harrison,8,2570,29081
2021-03-31,MO,Harrison,25,2595,29081
2021-04-01,MO,Harrison,5,2600,29081
2021-04-02,MO,Harrison,6,2606,29081
2021-04-03,MO,Harrison,5,2611,29081
2021-04-04,MO,Harrison,4,2615,29081
2021-04-05,MO,Harrison,6,2621,29081
2021-04-06,MO,Harrison,13,2634,29081
2021-04-07,MO,Harrison,25,2659,29081
2021-04-08,MO,Harrison,19,2678,29081
2021-04-09,MO,Harrison,49,2727,29081
2021-04-10,MO,Harrison,5,2732,29081
2021-04-11,MO,Harrison,11,2743,29081
2021-04-12,MO,Harrison,34,2777,29081
2021-04-13,MO,Harrison,7,2784,29081
2021-04-14,MO,Harrison,11,2795,29081
2021-04-15,MO,Harrison,33,2828,29081
2021-04-16,MO,Harrison,27,2855,29081
2021-04-17,MO,Harrison,8,2863,29081
2021-04-18,MO,Harrison,3,2866,29081
2021-04-19,MO,Harrison,9,2875,29081
2021-04-20,MO,Harrison,15,2890,29081
2021-04-21,MO,Harrison,10,2900,29081
2021-04-22,MO,Harrison,12,2912,29081
2021-04-23,MO,Harrison,21,2933,29081
2021-04-24,MO,Harrison,4,2937,29081
2021-04-25,MO,Harrison,1,2938,29081
2021-04-26,MO,Harrison,4,2942,29081
2021-04-27,MO,Harrison,8,2950,29081
2021-04-28,MO,Harrison,11,2961,29081
2021-04-29,MO,Harrison,7,2968,29081
2021-04-30,MO,Harrison,11,2979,29081
2021-05-01,MO,Harrison,16,2995,29081
2021-05-02,MO,Harrison,4,2999,29081
2021-05-03,MO,Harrison,11,3010,29081
2021-05-04,MO,Harrison,9,3019,29081
2021-05-05,MO,Harrison,4,3023,29081
2021-05-06,MO,Harrison,6,3029,29081
2021-05-07,MO,Harrison,11,3040,29081
2021-05-08,MO,Harrison,2,3042,29081
2021-05-10,MO,Harrison,28,3070,29081
2021-05-11,MO,Harrison,7,3077,29081
2021-05-12,MO,Harrison,7,3084,29081
2021-05-13,MO,Harrison,5,3089,29081
2021-05-14,MO,Harrison,23,3112,29081
2021-05-15,MO,Harrison,3,3115,29081
2021-05-17,MO,Harrison,8,3123,29081
2021-05-18,MO,Harrison,15,3138,29081
2021-05-19,MO,Harrison,8,3146,29081
2021-05-20,MO,Harrison,9,3155,29081
2021-05-21,MO,Harrison,25,3180,29081
2021-05-22,MO,Harrison,5,3185,29081
2021-05-24,MO,Harrison,3,3188,29081
2021-05-25,MO,Harrison,7,3195,29081
2021-05-26,MO,Harrison,5,3200,29081
2021-05-27,MO,Harrison,7,3207,29081
2020-12-15,MO,Henry,2,2,29083
2020-12-16,MO,Henry,2,4,29083
2020-12-17,MO,Henry,7,11,29083
2020-12-18,MO,Henry,47,58,29083
2020-12-19,MO,Henry,8,66,29083
2020-12-20,MO,Henry,1,67,29083
2020-12-21,MO,Henry,57,124,29083
2020-12-22,MO,Henry,36,160,29083
2020-12-23,MO,Henry,5,165,29083
2020-12-24,MO,Henry,5,170,29083
2020-12-26,MO,Henry,1,171,29083
2020-12-27,MO,Henry,1,172,29083
2020-12-28,MO,Henry,10,182,29083
2020-12-29,MO,Henry,80,262,29083
2020-12-30,MO,Henry,62,324,29083
2020-12-31,MO,Henry,31,355,29083
2021-01-03,MO,Henry,1,356,29083
2021-01-04,MO,Henry,13,369,29083
2021-01-05,MO,Henry,16,385,29083
2021-01-06,MO,Henry,58,443,29083
2021-01-07,MO,Henry,12,455,29083
2021-01-08,MO,Henry,27,482,29083
2021-01-09,MO,Henry,1,483,29083
2021-01-11,MO,Henry,98,581,29083
2021-01-12,MO,Henry,45,626,29083
2021-01-13,MO,Henry,60,686,29083
2021-01-14,MO,Henry,66,752,29083
2021-01-15,MO,Henry,30,782,29083
2021-01-16,MO,Henry,5,787,29083
2021-01-17,MO,Henry,1,788,29083
2021-01-18,MO,Henry,6,794,29083
2021-01-19,MO,Henry,163,957,29083
2021-01-20,MO,Henry,67,1024,29083
2021-01-21,MO,Henry,47,1071,29083
2021-01-22,MO,Henry,26,1097,29083
2021-01-23,MO,Henry,292,1389,29083
2021-01-24,MO,Henry,1,1390,29083
2021-01-25,MO,Henry,32,1422,29083
2021-01-26,MO,Henry,201,1623,29083
2021-01-27,MO,Henry,159,1782,29083
2021-01-28,MO,Henry,223,2005,29083
2021-01-29,MO,Henry,84,2089,29083
2021-01-30,MO,Henry,10,2099,29083
2021-01-31,MO,Henry,4,2103,29083
2021-02-01,MO,Henry,44,2147,29083
2021-02-02,MO,Henry,50,2197,29083
2021-02-03,MO,Henry,61,2258,29083
2021-02-04,MO,Henry,32,2290,29083
2021-02-05,MO,Henry,513,2803,29083
2021-02-06,MO,Henry,2,2805,29083
2021-02-08,MO,Henry,51,2856,29083
2021-02-09,MO,Henry,197,3053,29083
2021-02-10,MO,Henry,106,3159,29083
2021-02-11,MO,Henry,93,3252,29083
2021-02-12,MO,Henry,65,3317,29083
2021-02-13,MO,Henry,603,3920,29083
2021-02-14,MO,Henry,279,4199,29083
2021-02-15,MO,Henry,51,4250,29083
2021-02-16,MO,Henry,135,4385,29083
2021-02-17,MO,Henry,131,4516,29083
2021-02-18,MO,Henry,135,4651,29083
2021-02-19,MO,Henry,15,4666,29083
2021-02-20,MO,Henry,7,4673,29083
2021-02-21,MO,Henry,3,4676,29083
2021-02-22,MO,Henry,33,4709,29083
2021-02-23,MO,Henry,88,4797,29083
2021-02-24,MO,Henry,77,4874,29083
2021-02-25,MO,Henry,73,4947,29083
2021-02-26,MO,Henry,318,5265,29083
2021-02-27,MO,Henry,252,5517,29083
2021-02-28,MO,Henry,138,5655,29083
2021-03-01,MO,Henry,46,5701,29083
2021-03-02,MO,Henry,205,5906,29083
2021-03-03,MO,Henry,77,5983,29083
2021-03-04,MO,Henry,75,6058,29083
2021-03-05,MO,Henry,352,6410,29083
2021-03-06,MO,Henry,5,6415,29083
2021-03-07,MO,Henry,3,6418,29083
2021-03-08,MO,Henry,26,6444,29083
2021-03-09,MO,Henry,50,6494,29083
2021-03-10,MO,Henry,63,6557,29083
2021-03-11,MO,Henry,82,6639,29083
2021-03-12,MO,Henry,181,6820,29083
2021-03-13,MO,Henry,527,7347,29083
2021-03-14,MO,Henry,280,7627,29083
2021-03-15,MO,Henry,68,7695,29083
2021-03-16,MO,Henry,72,7767,29083
2021-03-17,MO,Henry,118,7885,29083
2021-03-18,MO,Henry,95,7980,29083
2021-03-19,MO,Henry,75,8055,29083
2021-03-20,MO,Henry,40,8095,29083
2021-03-21,MO,Henry,13,8108,29083
2021-03-22,MO,Henry,58,8166,29083
2021-03-23,MO,Henry,81,8247,29083
2021-03-24,MO,Henry,80,8327,29083
2021-03-25,MO,Henry,199,8526,29083
2021-03-26,MO,Henry,130,8656,29083
2021-03-27,MO,Henry,262,8918,29083
2021-03-28,MO,Henry,151,9069,29083
2021-03-29,MO,Henry,37,9106,29083
2021-03-30,MO,Henry,150,9256,29083
2021-03-31,MO,Henry,52,9308,29083
2021-04-01,MO,Henry,80,9388,29083
2021-04-02,MO,Henry,80,9468,29083
2021-04-03,MO,Henry,46,9514,29083
2021-04-04,MO,Henry,7,9521,29083
2021-04-05,MO,Henry,64,9585,29083
2021-04-06,MO,Henry,100,9685,29083
2021-04-07,MO,Henry,71,9756,29083
2021-04-08,MO,Henry,76,9832,29083
2021-04-09,MO,Henry,224,10056,29083
2021-04-10,MO,Henry,285,10341,29083
2021-04-11,MO,Henry,8,10349,29083
2021-04-12,MO,Henry,88,10437,29083
2021-04-13,MO,Henry,83,10520,29083
2021-04-14,MO,Henry,70,10590,29083
2021-04-15,MO,Henry,184,10774,29083
2021-04-16,MO,Henry,119,10893,29083
2021-04-17,MO,Henry,44,10937,29083
2021-04-18,MO,Henry,11,10948,29083
2021-04-19,MO,Henry,44,10992,29083
2021-04-20,MO,Henry,60,11052,29083
2021-04-21,MO,Henry,48,11100,29083
2021-04-22,MO,Henry,48,11148,29083
2021-04-23,MO,Henry,60,11208,29083
2021-04-24,MO,Henry,37,11245,29083
2021-04-25,MO,Henry,8,11253,29083
2021-04-26,MO,Henry,25,11278,29083
2021-04-27,MO,Henry,83,11361,29083
2021-04-28,MO,Henry,24,11385,29083
2021-04-29,MO,Henry,45,11430,29083
2021-04-30,MO,Henry,73,11503,29083
2021-05-01,MO,Henry,15,11518,29083
2021-05-02,MO,Henry,4,11522,29083
2021-05-03,MO,Henry,43,11565,29083
2021-05-04,MO,Henry,72,11637,29083
2021-05-05,MO,Henry,54,11691,29083
2021-05-06,MO,Henry,43,11734,29083
2021-05-07,MO,Henry,38,11772,29083
2021-05-08,MO,Henry,27,11799,29083
2021-05-09,MO,Henry,7,11806,29083
2021-05-10,MO,Henry,45,11851,29083
2021-05-11,MO,Henry,45,11896,29083
2021-05-12,MO,Henry,39,11935,29083
2021-05-13,MO,Henry,30,11965,29083
2021-05-14,MO,Henry,44,12009,29083
2021-05-15,MO,Henry,35,12044,29083
2021-05-16,MO,Henry,22,12066,29083
2021-05-17,MO,Henry,58,12124,29083
2021-05-18,MO,Henry,38,12162,29083
2021-05-19,MO,Henry,66,12228,29083
2021-05-20,MO,Henry,43,12271,29083
2021-05-21,MO,Henry,34,12305,29083
2021-05-22,MO,Henry,14,12319,29083
2021-05-23,MO,Henry,5,12324,29083
2021-05-24,MO,Henry,21,12345,29083
2021-05-25,MO,Henry,31,12376,29083
2021-05-26,MO,Henry,35,12411,29083
2021-05-27,MO,Henry,23,12434,29083
2020-12-18,MO,Hickory,4,4,29085
2020-12-21,MO,Hickory,1,5,29085
2020-12-22,MO,Hickory,5,10,29085
2020-12-23,MO,Hickory,5,15,29085
2020-12-24,MO,Hickory,1,16,29085
2020-12-28,MO,Hickory,6,22,29085
2020-12-29,MO,Hickory,22,44,29085
2020-12-30,MO,Hickory,13,57,29085
2020-12-31,MO,Hickory,8,65,29085
2021-01-02,MO,Hickory,2,67,29085
2021-01-04,MO,Hickory,6,73,29085
2021-01-05,MO,Hickory,10,83,29085
2021-01-06,MO,Hickory,3,86,29085
2021-01-07,MO,Hickory,3,89,29085
2021-01-08,MO,Hickory,4,93,29085
2021-01-12,MO,Hickory,10,103,29085
2021-01-13,MO,Hickory,7,110,29085
2021-01-14,MO,Hickory,2,112,29085
2021-01-15,MO,Hickory,2,114,29085
2021-01-16,MO,Hickory,3,117,29085
2021-01-18,MO,Hickory,4,121,29085
2021-01-19,MO,Hickory,74,195,29085
2021-01-20,MO,Hickory,15,210,29085
2021-01-21,MO,Hickory,34,244,29085
2021-01-22,MO,Hickory,125,369,29085
2021-01-23,MO,Hickory,3,372,29085
2021-01-24,MO,Hickory,1,373,29085
2021-01-25,MO,Hickory,114,487,29085
2021-01-26,MO,Hickory,36,523,29085
2021-01-27,MO,Hickory,266,789,29085
2021-01-28,MO,Hickory,132,921,29085
2021-01-29,MO,Hickory,131,1052,29085
2021-01-30,MO,Hickory,2,1054,29085
2021-02-01,MO,Hickory,165,1219,29085
2021-02-02,MO,Hickory,65,1284,29085
2021-02-03,MO,Hickory,122,1406,29085
2021-02-04,MO,Hickory,2,1408,29085
2021-02-05,MO,Hickory,26,1434,29085
2021-02-06,MO,Hickory,4,1438,29085
2021-02-08,MO,Hickory,6,1444,29085
2021-02-09,MO,Hickory,18,1462,29085
2021-02-10,MO,Hickory,88,1550,29085
2021-02-11,MO,Hickory,51,1601,29085
2021-02-12,MO,Hickory,68,1669,29085
2021-02-13,MO,Hickory,5,1674,29085
2021-02-14,MO,Hickory,7,1681,29085
2021-02-15,MO,Hickory,3,1684,29085
2021-02-16,MO,Hickory,54,1738,29085
2021-02-17,MO,Hickory,70,1808,29085
2021-02-18,MO,Hickory,15,1823,29085
2021-02-19,MO,Hickory,110,1933,29085
2021-02-20,MO,Hickory,19,1952,29085
2021-02-22,MO,Hickory,127,2079,29085
2021-02-23,MO,Hickory,50,2129,29085
2021-02-24,MO,Hickory,271,2400,29085
2021-02-25,MO,Hickory,156,2556,29085
2021-02-26,MO,Hickory,173,2729,29085
2021-02-27,MO,Hickory,4,2733,29085
2021-02-28,MO,Hickory,3,2736,29085
2021-03-01,MO,Hickory,135,2871,29085
2021-03-02,MO,Hickory,26,2897,29085
2021-03-03,MO,Hickory,181,3078,29085
2021-03-04,MO,Hickory,85,3163,29085
2021-03-05,MO,Hickory,109,3272,29085
2021-03-06,MO,Hickory,13,3285,29085
2021-03-07,MO,Hickory,1,3286,29085
2021-03-08,MO,Hickory,20,3306,29085
2021-03-09,MO,Hickory,32,3338,29085
2021-03-10,MO,Hickory,137,3475,29085
2021-03-11,MO,Hickory,64,3539,29085
2021-03-12,MO,Hickory,95,3634,29085
2021-03-13,MO,Hickory,19,3653,29085
2021-03-14,MO,Hickory,2,3655,29085
2021-03-15,MO,Hickory,12,3667,29085
2021-03-16,MO,Hickory,43,3710,29085
2021-03-17,MO,Hickory,103,3813,29085
2021-03-18,MO,Hickory,34,3847,29085
2021-03-19,MO,Hickory,36,3883,29085
2021-03-20,MO,Hickory,5,3888,29085
2021-03-21,MO,Hickory,2,3890,29085
2021-03-22,MO,Hickory,10,3900,29085
2021-03-23,MO,Hickory,31,3931,29085
2021-03-24,MO,Hickory,41,3972,29085
2021-03-25,MO,Hickory,104,4076,29085
2021-03-26,MO,Hickory,94,4170,29085
2021-03-27,MO,Hickory,6,4176,29085
2021-03-28,MO,Hickory,4,4180,29085
2021-03-29,MO,Hickory,11,4191,29085
2021-03-30,MO,Hickory,27,4218,29085
2021-03-31,MO,Hickory,65,4283,29085
2021-04-01,MO,Hickory,12,4295,29085
2021-04-02,MO,Hickory,67,4362,29085
2021-04-03,MO,Hickory,8,4370,29085
2021-04-04,MO,Hickory,2,4372,29085
2021-04-05,MO,Hickory,12,4384,29085
2021-04-06,MO,Hickory,16,4400,29085
2021-04-07,MO,Hickory,11,4411,29085
2021-04-08,MO,Hickory,36,4447,29085
2021-04-09,MO,Hickory,103,4550,29085
2021-04-10,MO,Hickory,10,4560,29085
2021-04-11,MO,Hickory,5,4565,29085
2021-04-12,MO,Hickory,11,4576,29085
2021-04-13,MO,Hickory,24,4600,29085
2021-04-14,MO,Hickory,16,4616,29085
2021-04-15,MO,Hickory,7,4623,29085
2021-04-16,MO,Hickory,43,4666,29085
2021-04-17,MO,Hickory,8,4674,29085
2021-04-18,MO,Hickory,2,4676,29085
2021-04-19,MO,Hickory,10,4686,29085
2021-04-20,MO,Hickory,5,4691,29085
2021-04-21,MO,Hickory,10,4701,29085
2021-04-22,MO,Hickory,28,4729,29085
2021-04-23,MO,Hickory,22,4751,29085
2021-04-24,MO,Hickory,3,4754,29085
2021-04-25,MO,Hickory,2,4756,29085
2021-04-26,MO,Hickory,4,4760,29085
2021-04-27,MO,Hickory,11,4771,29085
2021-04-28,MO,Hickory,3,4774,29085
2021-04-29,MO,Hickory,26,4800,29085
2021-04-30,MO,Hickory,16,4816,29085
2021-05-01,MO,Hickory,2,4818,29085
2021-05-02,MO,Hickory,1,4819,29085
2021-05-03,MO,Hickory,4,4823,29085
2021-05-04,MO,Hickory,8,4831,29085
2021-05-05,MO,Hickory,11,4842,29085
2021-05-06,MO,Hickory,8,4850,29085
2021-05-07,MO,Hickory,11,4861,29085
2021-05-08,MO,Hickory,1,4862,29085
2021-05-09,MO,Hickory,1,4863,29085
2021-05-10,MO,Hickory,22,4885,29085
2021-05-11,MO,Hickory,11,4896,29085
2021-05-12,MO,Hickory,10,4906,29085
2021-05-13,MO,Hickory,23,4929,29085
2021-05-14,MO,Hickory,17,4946,29085
2021-05-15,MO,Hickory,4,4950,29085
2021-05-16,MO,Hickory,1,4951,29085
2021-05-17,MO,Hickory,6,4957,29085
2021-05-18,MO,Hickory,4,4961,29085
2021-05-19,MO,Hickory,9,4970,29085
2021-05-20,MO,Hickory,31,5001,29085
2021-05-21,MO,Hickory,8,5009,29085
2021-05-22,MO,Hickory,1,5010,29085
2021-05-23,MO,Hickory,1,5011,29085
2021-05-24,MO,Hickory,4,5015,29085
2021-05-25,MO,Hickory,7,5022,29085
2021-05-26,MO,Hickory,3,5025,29085
2021-05-27,MO,Hickory,20,5045,29085
2020-12-23,MO,Holt,6,6,29087
2020-12-27,MO,Holt,3,9,29087
2020-12-28,MO,Holt,48,57,29087
2020-12-29,MO,Holt,5,62,29087
2020-12-30,MO,Holt,2,64,29087
2020-12-31,MO,Holt,44,108,29087
2021-01-01,MO,Holt,1,109,29087
2021-01-02,MO,Holt,9,118,29087
2021-01-04,MO,Holt,4,122,29087
2021-01-05,MO,Holt,5,127,29087
2021-01-06,MO,Holt,6,133,29087
2021-01-07,MO,Holt,6,139,29087
2021-01-09,MO,Holt,1,140,29087
2021-01-11,MO,Holt,1,141,29087
2021-01-13,MO,Holt,9,150,29087
2021-01-14,MO,Holt,11,161,29087
2021-01-15,MO,Holt,3,164,29087
2021-01-19,MO,Holt,1,165,29087
2021-01-20,MO,Holt,9,174,29087
2021-01-21,MO,Holt,5,179,29087
2021-01-22,MO,Holt,8,187,29087
2021-01-23,MO,Holt,1,188,29087
2021-01-25,MO,Holt,1,189,29087
2021-01-26,MO,Holt,8,197,29087
2021-01-27,MO,Holt,38,235,29087
2021-01-28,MO,Holt,26,261,29087
2021-01-29,MO,Holt,280,541,29087
2021-01-31,MO,Holt,4,545,29087
2021-02-01,MO,Holt,9,554,29087
2021-02-02,MO,Holt,55,609,29087
2021-02-03,MO,Holt,38,647,29087
2021-02-04,MO,Holt,76,723,29087
2021-02-05,MO,Holt,11,734,29087
2021-02-06,MO,Holt,1,735,29087
2021-02-08,MO,Holt,5,740,29087
2021-02-09,MO,Holt,9,749,29087
2021-02-10,MO,Holt,6,755,29087
2021-02-11,MO,Holt,26,781,29087
2021-02-12,MO,Holt,14,795,29087
2021-02-13,MO,Holt,3,798,29087
2021-02-16,MO,Holt,5,803,29087
2021-02-17,MO,Holt,9,812,29087
2021-02-18,MO,Holt,7,819,29087
2021-02-19,MO,Holt,6,825,29087
2021-02-22,MO,Holt,162,987,29087
2021-02-23,MO,Holt,37,1024,29087
2021-02-24,MO,Holt,4,1028,29087
2021-02-25,MO,Holt,114,1142,29087
2021-02-26,MO,Holt,71,1213,29087
2021-02-27,MO,Holt,3,1216,29087
2021-02-28,MO,Holt,1,1217,29087
2021-03-01,MO,Holt,13,1230,29087
2021-03-02,MO,Holt,24,1254,29087
2021-03-03,MO,Holt,8,1262,29087
2021-03-04,MO,Holt,17,1279,29087
2021-03-05,MO,Holt,15,1294,29087
2021-03-06,MO,Holt,3,1297,29087
2021-03-08,MO,Holt,26,1323,29087
2021-03-09,MO,Holt,62,1385,29087
2021-03-10,MO,Holt,13,1398,29087
2021-03-11,MO,Holt,61,1459,29087
2021-03-12,MO,Holt,19,1478,29087
2021-03-13,MO,Holt,3,1481,29087
2021-03-15,MO,Holt,50,1531,29087
2021-03-16,MO,Holt,10,1541,29087
2021-03-17,MO,Holt,8,1549,29087
2021-03-18,MO,Holt,87,1636,29087
2021-03-19,MO,Holt,10,1646,29087
2021-03-20,MO,Holt,4,1650,29087
2021-03-22,MO,Holt,15,1665,29087
2021-03-23,MO,Holt,3,1668,29087
2021-03-24,MO,Holt,13,1681,29087
2021-03-25,MO,Holt,11,1692,29087
2021-03-26,MO,Holt,11,1703,29087
2021-03-27,MO,Holt,2,1705,29087
2021-03-29,MO,Holt,16,1721,29087
2021-03-30,MO,Holt,47,1768,29087
2021-03-31,MO,Holt,15,1783,29087
2021-04-01,MO,Holt,5,1788,29087
2021-04-02,MO,Holt,15,1803,29087
2021-04-03,MO,Holt,1,1804,29087
2021-04-05,MO,Holt,23,1827,29087
2021-04-06,MO,Holt,13,1840,29087
2021-04-07,MO,Holt,23,1863,29087
2021-04-08,MO,Holt,28,1891,29087
2021-04-09,MO,Holt,14,1905,29087
2021-04-10,MO,Holt,2,1907,29087
2021-04-11,MO,Holt,1,1908,29087
2021-04-12,MO,Holt,9,1917,29087
2021-04-13,MO,Holt,13,1930,29087
2021-04-14,MO,Holt,27,1957,29087
2021-04-15,MO,Holt,26,1983,29087
2021-04-16,MO,Holt,15,1998,29087
2021-04-17,MO,Holt,2,2000,29087
2021-04-19,MO,Holt,10,2010,29087
2021-04-20,MO,Holt,10,2020,29087
2021-04-21,MO,Holt,1,2021,29087
2021-04-22,MO,Holt,2,2023,29087
2021-04-23,MO,Holt,4,2027,29087
2021-04-26,MO,Holt,7,2034,29087
2021-04-27,MO,Holt,10,2044,29087
2021-04-28,MO,Holt,6,2050,29087
2021-04-29,MO,Holt,6,2056,29087
2021-04-30,MO,Holt,10,2066,29087
2021-05-01,MO,Holt,1,2067,29087
2021-05-03,MO,Holt,4,2071,29087
2021-05-04,MO,Holt,7,2078,29087
2021-05-05,MO,Holt,8,2086,29087
2021-05-06,MO,Holt,23,2109,29087
2021-05-07,MO,Holt,11,2120,29087
2021-05-09,MO,Holt,3,2123,29087
2021-05-10,MO,Holt,8,2131,29087
2021-05-11,MO,Holt,6,2137,29087
2021-05-12,MO,Holt,4,2141,29087
2021-05-13,MO,Holt,18,2159,29087
2021-05-14,MO,Holt,22,2181,29087
2021-05-15,MO,Holt,2,2183,29087
2021-05-17,MO,Holt,2,2185,29087
2021-05-18,MO,Holt,3,2188,29087
2021-05-19,MO,Holt,3,2191,29087
2021-05-20,MO,Holt,2,2193,29087
2021-05-21,MO,Holt,2,2195,29087
2021-05-22,MO,Holt,1,2196,29087
2021-05-23,MO,Holt,2,2198,29087
2021-05-24,MO,Holt,5,2203,29087
2021-05-25,MO,Holt,10,2213,29087
2021-05-26,MO,Holt,2,2215,29087
2021-05-27,MO,Holt,4,2219,29087
2020-12-16,MO,Howard,2,2,29089
2020-12-17,MO,Howard,5,7,29089
2020-12-18,MO,Howard,6,13,29089
2020-12-19,MO,Howard,10,23,29089
2020-12-20,MO,Howard,2,25,29089
2020-12-21,MO,Howard,13,38,29089
2020-12-22,MO,Howard,14,52,29089
2020-12-23,MO,Howard,2,54,29089
2020-12-28,MO,Howard,11,65,29089
2020-12-29,MO,Howard,10,75,29089
2020-12-30,MO,Howard,20,95,29089
2020-12-31,MO,Howard,6,101,29089
2021-01-02,MO,Howard,6,107,29089
2021-01-03,MO,Howard,4,111,29089
2021-01-04,MO,Howard,3,114,29089
2021-01-05,MO,Howard,4,118,29089
2021-01-06,MO,Howard,8,126,29089
2021-01-07,MO,Howard,8,134,29089
2021-01-08,MO,Howard,8,142,29089
2021-01-09,MO,Howard,6,148,29089
2021-01-10,MO,Howard,4,152,29089
2021-01-11,MO,Howard,25,177,29089
2021-01-12,MO,Howard,54,231,29089
2021-01-13,MO,Howard,8,239,29089
2021-01-14,MO,Howard,11,250,29089
2021-01-15,MO,Howard,31,281,29089
2021-01-16,MO,Howard,12,293,29089
2021-01-18,MO,Howard,15,308,29089
2021-01-19,MO,Howard,9,317,29089
2021-01-20,MO,Howard,27,344,29089
2021-01-21,MO,Howard,18,362,29089
2021-01-22,MO,Howard,9,371,29089
2021-01-23,MO,Howard,9,380,29089
2021-01-24,MO,Howard,5,385,29089
2021-01-25,MO,Howard,11,396,29089
2021-01-26,MO,Howard,23,419,29089
2021-01-27,MO,Howard,13,432,29089
2021-01-28,MO,Howard,89,521,29089
2021-01-29,MO,Howard,94,615,29089
2021-01-30,MO,Howard,14,629,29089
2021-01-31,MO,Howard,4,633,29089
2021-02-01,MO,Howard,6,639,29089
2021-02-02,MO,Howard,14,653,29089
2021-02-03,MO,Howard,183,836,29089
2021-02-04,MO,Howard,79,915,29089
2021-02-05,MO,Howard,20,935,29089
2021-02-06,MO,Howard,20,955,29089
2021-02-08,MO,Howard,173,1128,29089
2021-02-09,MO,Howard,36,1164,29089
2021-02-10,MO,Howard,17,1181,29089
2021-02-11,MO,Howard,99,1280,29089
2021-02-12,MO,Howard,44,1324,29089
2021-02-13,MO,Howard,15,1339,29089
2021-02-15,MO,Howard,13,1352,29089
2021-02-16,MO,Howard,51,1403,29089
2021-02-17,MO,Howard,108,1511,29089
2021-02-18,MO,Howard,43,1554,29089
2021-02-19,MO,Howard,31,1585,29089
2021-02-20,MO,Howard,3,1588,29089
2021-02-22,MO,Howard,5,1593,29089
2021-02-23,MO,Howard,24,1617,29089
2021-02-24,MO,Howard,223,1840,29089
2021-02-25,MO,Howard,345,2185,29089
2021-02-26,MO,Howard,31,2216,29089
2021-02-27,MO,Howard,24,2240,29089
2021-02-28,MO,Howard,2,2242,29089
2021-03-01,MO,Howard,78,2320,29089
2021-03-02,MO,Howard,25,2345,29089
2021-03-03,MO,Howard,244,2589,29089
2021-03-04,MO,Howard,77,2666,29089
2021-03-05,MO,Howard,39,2705,29089
2021-03-06,MO,Howard,32,2737,29089
2021-03-07,MO,Howard,3,2740,29089
2021-03-08,MO,Howard,176,2916,29089
2021-03-09,MO,Howard,25,2941,29089
2021-03-10,MO,Howard,27,2968,29089
2021-03-11,MO,Howard,93,3061,29089
2021-03-12,MO,Howard,19,3080,29089
2021-03-13,MO,Howard,5,3085,29089
2021-03-14,MO,Howard,9,3094,29089
2021-03-15,MO,Howard,96,3190,29089
2021-03-16,MO,Howard,142,3332,29089
2021-03-17,MO,Howard,178,3510,29089
2021-03-18,MO,Howard,15,3525,29089
2021-03-19,MO,Howard,36,3561,29089
2021-03-20,MO,Howard,5,3566,29089
2021-03-21,MO,Howard,3,3569,29089
2021-03-22,MO,Howard,38,3607,29089
2021-03-23,MO,Howard,36,3643,29089
2021-03-24,MO,Howard,188,3831,29089
2021-03-25,MO,Howard,276,4107,29089
2021-03-26,MO,Howard,89,4196,29089
2021-03-27,MO,Howard,24,4220,29089
2021-03-28,MO,Howard,5,4225,29089
2021-03-29,MO,Howard,81,4306,29089
2021-03-30,MO,Howard,14,4320,29089
2021-03-31,MO,Howard,209,4529,29089
2021-04-01,MO,Howard,32,4561,29089
2021-04-02,MO,Howard,36,4597,29089
2021-04-03,MO,Howard,9,4606,29089
2021-04-05,MO,Howard,110,4716,29089
2021-04-06,MO,Howard,33,4749,29089
2021-04-07,MO,Howard,188,4937,29089
2021-04-08,MO,Howard,17,4954,29089
2021-04-09,MO,Howard,25,4979,29089
2021-04-10,MO,Howard,8,4987,29089
2021-04-11,MO,Howard,10,4997,29089
2021-04-12,MO,Howard,35,5032,29089
2021-04-13,MO,Howard,27,5059,29089
2021-04-14,MO,Howard,72,5131,29089
2021-04-15,MO,Howard,45,5176,29089
2021-04-16,MO,Howard,48,5224,29089
2021-04-17,MO,Howard,29,5253,29089
2021-04-18,MO,Howard,4,5257,29089
2021-04-19,MO,Howard,15,5272,29089
2021-04-20,MO,Howard,19,5291,29089
2021-04-21,MO,Howard,122,5413,29089
2021-04-22,MO,Howard,6,5419,29089
2021-04-23,MO,Howard,46,5465,29089
2021-04-24,MO,Howard,4,5469,29089
2021-04-25,MO,Howard,4,5473,29089
2021-04-26,MO,Howard,25,5498,29089
2021-04-27,MO,Howard,29,5527,29089
2021-04-28,MO,Howard,14,5541,29089
2021-04-29,MO,Howard,23,5564,29089
2021-04-30,MO,Howard,14,5578,29089
2021-05-01,MO,Howard,2,5580,29089
2021-05-02,MO,Howard,1,5581,29089
2021-05-03,MO,Howard,16,5597,29089
2021-05-04,MO,Howard,14,5611,29089
2021-05-05,MO,Howard,88,5699,29089
2021-05-06,MO,Howard,41,5740,29089
2021-05-07,MO,Howard,14,5754,29089
2021-05-08,MO,Howard,23,5777,29089
2021-05-09,MO,Howard,1,5778,29089
2021-05-10,MO,Howard,12,5790,29089
2021-05-11,MO,Howard,29,5819,29089
2021-05-12,MO,Howard,20,5839,29089
2021-05-13,MO,Howard,2,5841,29089
2021-05-14,MO,Howard,9,5850,29089
2021-05-15,MO,Howard,6,5856,29089
2021-05-16,MO,Howard,2,5858,29089
2021-05-17,MO,Howard,10,5868,29089
2021-05-18,MO,Howard,14,5882,29089
2021-05-19,MO,Howard,12,5894,29089
2021-05-20,MO,Howard,17,5911,29089
2021-05-21,MO,Howard,14,5925,29089
2021-05-22,MO,Howard,3,5928,29089
2021-05-23,MO,Howard,4,5932,29089
2021-05-24,MO,Howard,7,5939,29089
2021-05-25,MO,Howard,4,5943,29089
2021-05-26,MO,Howard,17,5960,29089
2021-05-27,MO,Howard,2,5962,29089
2020-12-15,MO,Howell,2,2,29091
2020-12-16,MO,Howell,3,5,29091
2020-12-17,MO,Howell,6,11,29091
2020-12-18,MO,Howell,7,18,29091
2020-12-19,MO,Howell,3,21,29091
2020-12-20,MO,Howell,2,23,29091
2020-12-21,MO,Howell,15,38,29091
2020-12-22,MO,Howell,114,152,29091
2020-12-23,MO,Howell,62,214,29091
2020-12-24,MO,Howell,10,224,29091
2020-12-26,MO,Howell,1,225,29091
2020-12-27,MO,Howell,1,226,29091
2020-12-28,MO,Howell,36,262,29091
2020-12-29,MO,Howell,52,314,29091
2020-12-30,MO,Howell,66,380,29091
2020-12-31,MO,Howell,29,409,29091
2021-01-01,MO,Howell,1,410,29091
2021-01-02,MO,Howell,43,453,29091
2021-01-04,MO,Howell,21,474,29091
2021-01-05,MO,Howell,65,539,29091
2021-01-06,MO,Howell,23,562,29091
2021-01-07,MO,Howell,7,569,29091
2021-01-08,MO,Howell,22,591,29091
2021-01-09,MO,Howell,69,660,29091
2021-01-10,MO,Howell,2,662,29091
2021-01-11,MO,Howell,16,678,29091
2021-01-12,MO,Howell,27,705,29091
2021-01-13,MO,Howell,13,718,29091
2021-01-14,MO,Howell,4,722,29091
2021-01-15,MO,Howell,11,733,29091
2021-01-16,MO,Howell,2,735,29091
2021-01-18,MO,Howell,68,803,29091
2021-01-19,MO,Howell,81,884,29091
2021-01-20,MO,Howell,124,1008,29091
2021-01-21,MO,Howell,66,1074,29091
2021-01-22,MO,Howell,90,1164,29091
2021-01-23,MO,Howell,6,1170,29091
2021-01-24,MO,Howell,2,1172,29091
2021-01-25,MO,Howell,102,1274,29091
2021-01-26,MO,Howell,112,1386,29091
2021-01-27,MO,Howell,542,1928,29091
2021-01-28,MO,Howell,520,2448,29091
2021-01-29,MO,Howell,1063,3511,29091
2021-01-30,MO,Howell,17,3528,29091
2021-01-31,MO,Howell,2,3530,29091
2021-02-01,MO,Howell,110,3640,29091
2021-02-02,MO,Howell,230,3870,29091
2021-02-03,MO,Howell,22,3892,29091
2021-02-04,MO,Howell,25,3917,29091
2021-02-05,MO,Howell,197,4114,29091
2021-02-06,MO,Howell,79,4193,29091
2021-02-08,MO,Howell,45,4238,29091
2021-02-09,MO,Howell,43,4281,29091
2021-02-10,MO,Howell,127,4408,29091
2021-02-11,MO,Howell,107,4515,29091
2021-02-12,MO,Howell,141,4656,29091
2021-02-13,MO,Howell,25,4681,29091
2021-02-14,MO,Howell,15,4696,29091
2021-02-15,MO,Howell,25,4721,29091
2021-02-16,MO,Howell,83,4804,29091
2021-02-17,MO,Howell,21,4825,29091
2021-02-18,MO,Howell,39,4864,29091
2021-02-19,MO,Howell,111,4975,29091
2021-02-20,MO,Howell,44,5019,29091
2021-02-21,MO,Howell,6,5025,29091
2021-02-22,MO,Howell,26,5051,29091
2021-02-23,MO,Howell,351,5402,29091
2021-02-24,MO,Howell,42,5444,29091
2021-02-25,MO,Howell,358,5802,29091
2021-02-26,MO,Howell,928,6730,29091
2021-02-27,MO,Howell,49,6779,29091
2021-02-28,MO,Howell,79,6858,29091
2021-03-01,MO,Howell,43,6901,29091
2021-03-02,MO,Howell,306,7207,29091
2021-03-03,MO,Howell,171,7378,29091
2021-03-04,MO,Howell,110,7488,29091
2021-03-05,MO,Howell,43,7531,29091
2021-03-06,MO,Howell,15,7546,29091
2021-03-07,MO,Howell,4,7550,29091
2021-03-08,MO,Howell,117,7667,29091
2021-03-09,MO,Howell,193,7860,29091
2021-03-10,MO,Howell,232,8092,29091
2021-03-11,MO,Howell,58,8150,29091
2021-03-12,MO,Howell,110,8260,29091
2021-03-13,MO,Howell,16,8276,29091
2021-03-14,MO,Howell,8,8284,29091
2021-03-15,MO,Howell,145,8429,29091
2021-03-16,MO,Howell,133,8562,29091
2021-03-17,MO,Howell,93,8655,29091
2021-03-18,MO,Howell,59,8714,29091
2021-03-19,MO,Howell,57,8771,29091
2021-03-20,MO,Howell,44,8815,29091
2021-03-21,MO,Howell,8,8823,29091
2021-03-22,MO,Howell,40,8863,29091
2021-03-23,MO,Howell,200,9063,29091
2021-03-24,MO,Howell,151,9214,29091
2021-03-25,MO,Howell,148,9362,29091
2021-03-26,MO,Howell,66,9428,29091
2021-03-27,MO,Howell,52,9480,29091
2021-03-28,MO,Howell,4,9484,29091
2021-03-29,MO,Howell,25,9509,29091
2021-03-30,MO,Howell,199,9708,29091
2021-03-31,MO,Howell,177,9885,29091
2021-04-01,MO,Howell,108,9993,29091
2021-04-02,MO,Howell,41,10034,29091
2021-04-03,MO,Howell,26,10060,29091
2021-04-04,MO,Howell,2,10062,29091
2021-04-05,MO,Howell,198,10260,29091
2021-04-06,MO,Howell,168,10428,29091
2021-04-07,MO,Howell,179,10607,29091
2021-04-08,MO,Howell,89,10696,29091
2021-04-09,MO,Howell,258,10954,29091
2021-04-10,MO,Howell,40,10994,29091
2021-04-11,MO,Howell,14,11008,29091
2021-04-12,MO,Howell,123,11131,29091
2021-04-13,MO,Howell,97,11228,29091
2021-04-14,MO,Howell,136,11364,29091
2021-04-15,MO,Howell,123,11487,29091
2021-04-16,MO,Howell,71,11558,29091
2021-04-17,MO,Howell,25,11583,29091
2021-04-18,MO,Howell,4,11587,29091
2021-04-19,MO,Howell,69,11656,29091
2021-04-20,MO,Howell,67,11723,29091
2021-04-21,MO,Howell,177,11900,29091
2021-04-22,MO,Howell,57,11957,29091
2021-04-23,MO,Howell,46,12003,29091
2021-04-24,MO,Howell,33,12036,29091
2021-04-25,MO,Howell,6,12042,29091
2021-04-26,MO,Howell,64,12106,29091
2021-04-27,MO,Howell,97,12203,29091
2021-04-28,MO,Howell,106,12309,29091
2021-04-29,MO,Howell,45,12354,29091
2021-04-30,MO,Howell,104,12458,29091
2021-05-01,MO,Howell,15,12473,29091
2021-05-02,MO,Howell,12,12485,29091
2021-05-03,MO,Howell,92,12577,29091
2021-05-04,MO,Howell,85,12662,29091
2021-05-05,MO,Howell,44,12706,29091
2021-05-06,MO,Howell,34,12740,29091
2021-05-07,MO,Howell,54,12794,29091
2021-05-08,MO,Howell,27,12821,29091
2021-05-09,MO,Howell,14,12835,29091
2021-05-10,MO,Howell,89,12924,29091
2021-05-11,MO,Howell,63,12987,29091
2021-05-12,MO,Howell,68,13055,29091
2021-05-13,MO,Howell,50,13105,29091
2021-05-14,MO,Howell,88,13193,29091
2021-05-15,MO,Howell,39,13232,29091
2021-05-16,MO,Howell,10,13242,29091
2021-05-17,MO,Howell,72,13314,29091
2021-05-18,MO,Howell,51,13365,29091
2021-05-19,MO,Howell,30,13395,29091
2021-05-20,MO,Howell,65,13460,29091
2021-05-21,MO,Howell,65,13525,29091
2021-05-22,MO,Howell,33,13558,29091
2021-05-23,MO,Howell,6,13564,29091
2021-05-24,MO,Howell,41,13605,29091
2021-05-25,MO,Howell,79,13684,29091
2021-05-26,MO,Howell,30,13714,29091
2021-05-27,MO,Howell,20,13734,29091
2020-12-13,MO,Iron,1,1,29093
2020-12-15,MO,Iron,1,2,29093
2020-12-16,MO,Iron,1,3,29093
2020-12-17,MO,Iron,5,8,29093
2020-12-18,MO,Iron,4,12,29093
2020-12-21,MO,Iron,2,14,29093
2020-12-22,MO,Iron,7,21,29093
2020-12-23,MO,Iron,29,50,29093
2020-12-28,MO,Iron,2,52,29093
2020-12-29,MO,Iron,6,58,29093
2020-12-30,MO,Iron,42,100,29093
2020-12-31,MO,Iron,69,169,29093
2021-01-02,MO,Iron,48,217,29093
2021-01-04,MO,Iron,5,222,29093
2021-01-05,MO,Iron,5,227,29093
2021-01-06,MO,Iron,6,233,29093
2021-01-07,MO,Iron,5,238,29093
2021-01-08,MO,Iron,7,245,29093
2021-01-09,MO,Iron,8,253,29093
2021-01-11,MO,Iron,5,258,29093
2021-01-12,MO,Iron,20,278,29093
2021-01-13,MO,Iron,35,313,29093
2021-01-14,MO,Iron,6,319,29093
2021-01-15,MO,Iron,29,348,29093
2021-01-17,MO,Iron,1,349,29093
2021-01-18,MO,Iron,6,355,29093
2021-01-19,MO,Iron,8,363,29093
2021-01-20,MO,Iron,22,385,29093
2021-01-21,MO,Iron,13,398,29093
2021-01-22,MO,Iron,34,432,29093
2021-01-23,MO,Iron,2,434,29093
2021-01-25,MO,Iron,28,462,29093
2021-01-26,MO,Iron,10,472,29093
2021-01-27,MO,Iron,36,508,29093
2021-01-28,MO,Iron,179,687,29093
2021-01-29,MO,Iron,33,720,29093
2021-01-30,MO,Iron,11,731,29093
2021-02-01,MO,Iron,19,750,29093
2021-02-02,MO,Iron,11,761,29093
2021-02-03,MO,Iron,8,769,29093
2021-02-04,MO,Iron,72,841,29093
2021-02-05,MO,Iron,26,867,29093
2021-02-06,MO,Iron,23,890,29093
2021-02-08,MO,Iron,25,915,29093
2021-02-09,MO,Iron,47,962,29093
2021-02-10,MO,Iron,10,972,29093
2021-02-11,MO,Iron,36,1008,29093
2021-02-12,MO,Iron,90,1098,29093
2021-02-13,MO,Iron,15,1113,29093
2021-02-14,MO,Iron,4,1117,29093
2021-02-15,MO,Iron,3,1120,29093
2021-02-16,MO,Iron,9,1129,29093
2021-02-17,MO,Iron,12,1141,29093
2021-02-18,MO,Iron,16,1157,29093
2021-02-19,MO,Iron,210,1367,29093
2021-02-20,MO,Iron,115,1482,29093
2021-02-21,MO,Iron,3,1485,29093
2021-02-22,MO,Iron,44,1529,29093
2021-02-23,MO,Iron,21,1550,29093
2021-02-24,MO,Iron,45,1595,29093
2021-02-25,MO,Iron,96,1691,29093
2021-02-26,MO,Iron,91,1782,29093
2021-02-27,MO,Iron,15,1797,29093
2021-03-01,MO,Iron,60,1857,29093
2021-03-02,MO,Iron,18,1875,29093
2021-03-03,MO,Iron,19,1894,29093
2021-03-04,MO,Iron,30,1924,29093
2021-03-05,MO,Iron,42,1966,29093
2021-03-06,MO,Iron,15,1981,29093
2021-03-07,MO,Iron,1,1982,29093
2021-03-08,MO,Iron,75,2057,29093
2021-03-09,MO,Iron,47,2104,29093
2021-03-10,MO,Iron,23,2127,29093
2021-03-11,MO,Iron,33,2160,29093
2021-03-12,MO,Iron,52,2212,29093
2021-03-13,MO,Iron,17,2229,29093
2021-03-14,MO,Iron,2,2231,29093
2021-03-15,MO,Iron,21,2252,29093
2021-03-16,MO,Iron,26,2278,29093
2021-03-17,MO,Iron,34,2312,29093
2021-03-18,MO,Iron,70,2382,29093
2021-03-19,MO,Iron,218,2600,29093
2021-03-20,MO,Iron,114,2714,29093
2021-03-21,MO,Iron,1,2715,29093
2021-03-22,MO,Iron,108,2823,29093
2021-03-23,MO,Iron,91,2914,29093
2021-03-24,MO,Iron,47,2961,29093
2021-03-25,MO,Iron,58,3019,29093
2021-03-26,MO,Iron,70,3089,29093
2021-03-27,MO,Iron,24,3113,29093
2021-03-28,MO,Iron,1,3114,29093
2021-03-29,MO,Iron,84,3198,29093
2021-03-30,MO,Iron,31,3229,29093
2021-03-31,MO,Iron,26,3255,29093
2021-04-01,MO,Iron,22,3277,29093
2021-04-02,MO,Iron,58,3335,29093
2021-04-03,MO,Iron,5,3340,29093
2021-04-04,MO,Iron,1,3341,29093
2021-04-05,MO,Iron,85,3426,29093
2021-04-06,MO,Iron,38,3464,29093
2021-04-07,MO,Iron,33,3497,29093
2021-04-08,MO,Iron,34,3531,29093
2021-04-09,MO,Iron,120,3651,29093
2021-04-10,MO,Iron,26,3677,29093
2021-04-12,MO,Iron,23,3700,29093
2021-04-13,MO,Iron,22,3722,29093
2021-04-14,MO,Iron,36,3758,29093
2021-04-15,MO,Iron,24,3782,29093
2021-04-16,MO,Iron,73,3855,29093
2021-04-17,MO,Iron,20,3875,29093
2021-04-18,MO,Iron,4,3879,29093
2021-04-19,MO,Iron,32,3911,29093
2021-04-20,MO,Iron,14,3925,29093
2021-04-21,MO,Iron,34,3959,29093
2021-04-22,MO,Iron,112,4071,29093
2021-04-23,MO,Iron,78,4149,29093
2021-04-24,MO,Iron,7,4156,29093
2021-04-25,MO,Iron,2,4158,29093
2021-04-26,MO,Iron,14,4172,29093
2021-04-27,MO,Iron,26,4198,29093
2021-04-28,MO,Iron,30,4228,29093
2021-04-29,MO,Iron,73,4301,29093
2021-04-30,MO,Iron,50,4351,29093
2021-05-01,MO,Iron,10,4361,29093
2021-05-02,MO,Iron,2,4363,29093
2021-05-03,MO,Iron,23,4386,29093
2021-05-04,MO,Iron,32,4418,29093
2021-05-05,MO,Iron,18,4436,29093
2021-05-06,MO,Iron,23,4459,29093
2021-05-07,MO,Iron,67,4526,29093
2021-05-08,MO,Iron,7,4533,29093
2021-05-10,MO,Iron,7,4540,29093
2021-05-11,MO,Iron,12,4552,29093
2021-05-12,MO,Iron,21,4573,29093
2021-05-13,MO,Iron,23,4596,29093
2021-05-14,MO,Iron,54,4650,29093
2021-05-15,MO,Iron,5,4655,29093
2021-05-16,MO,Iron,5,4660,29093
2021-05-17,MO,Iron,12,4672,29093
2021-05-18,MO,Iron,13,4685,29093
2021-05-19,MO,Iron,14,4699,29093
2021-05-20,MO,Iron,28,4727,29093
2021-05-21,MO,Iron,10,4737,29093
2021-05-22,MO,Iron,5,4742,29093
2021-05-23,MO,Iron,4,4746,29093
2021-05-24,MO,Iron,25,4771,29093
2021-05-25,MO,Iron,13,4784,29093
2021-05-26,MO,Iron,18,4802,29093
2021-05-27,MO,Iron,8,4810,29093
2020-12-13,MO,Jackson,2,2,29095
2020-12-14,MO,Jackson,9,11,29095
2020-12-15,MO,Jackson,40,51,29095
2020-12-16,MO,Jackson,75,126,29095
2020-12-17,MO,Jackson,123,249,29095
2020-12-18,MO,Jackson,309,558,29095
2020-12-19,MO,Jackson,83,641,29095
2020-12-20,MO,Jackson,25,666,29095
2020-12-21,MO,Jackson,421,1087,29095
2020-12-22,MO,Jackson,702,1789,29095
2020-12-23,MO,Jackson,630,2419,29095
2020-12-24,MO,Jackson,136,2555,29095
2020-12-25,MO,Jackson,1,2556,29095
2020-12-26,MO,Jackson,49,2605,29095
2020-12-27,MO,Jackson,35,2640,29095
2020-12-28,MO,Jackson,328,2968,29095
2020-12-29,MO,Jackson,327,3295,29095
2020-12-30,MO,Jackson,635,3930,29095
2020-12-31,MO,Jackson,661,4591,29095
2021-01-01,MO,Jackson,5,4596,29095
2021-01-02,MO,Jackson,119,4715,29095
2021-01-03,MO,Jackson,23,4738,29095
2021-01-04,MO,Jackson,145,4883,29095
2021-01-05,MO,Jackson,413,5296,29095
2021-01-06,MO,Jackson,865,6161,29095
2021-01-07,MO,Jackson,1093,7254,29095
2021-01-08,MO,Jackson,1188,8442,29095
2021-01-09,MO,Jackson,340,8782,29095
2021-01-10,MO,Jackson,64,8846,29095
2021-01-11,MO,Jackson,900,9746,29095
2021-01-12,MO,Jackson,816,10562,29095
2021-01-13,MO,Jackson,933,11495,29095
2021-01-14,MO,Jackson,772,12267,29095
2021-01-15,MO,Jackson,828,13095,29095
2021-01-16,MO,Jackson,92,13187,29095
2021-01-17,MO,Jackson,8,13195,29095
2021-01-18,MO,Jackson,384,13579,29095
2021-01-19,MO,Jackson,674,14253,29095
2021-01-20,MO,Jackson,1105,15358,29095
2021-01-21,MO,Jackson,1581,16939,29095
2021-01-22,MO,Jackson,1199,18138,29095
2021-01-23,MO,Jackson,240,18378,29095
2021-01-24,MO,Jackson,93,18471,29095
2021-01-25,MO,Jackson,1215,19686,29095
2021-01-26,MO,Jackson,1240,20926,29095
2021-01-27,MO,Jackson,1402,22328,29095
2021-01-28,MO,Jackson,1581,23909,29095
2021-01-29,MO,Jackson,1972,25881,29095
2021-01-30,MO,Jackson,650,26531,29095
2021-01-31,MO,Jackson,207,26738,29095
2021-02-01,MO,Jackson,994,27732,29095
2021-02-02,MO,Jackson,953,28685,29095
2021-02-03,MO,Jackson,2264,30949,29095
2021-02-04,MO,Jackson,1504,32453,29095
2021-02-05,MO,Jackson,1873,34326,29095
2021-02-06,MO,Jackson,496,34822,29095
2021-02-07,MO,Jackson,120,34942,29095
2021-02-08,MO,Jackson,1107,36049,29095
2021-02-09,MO,Jackson,1185,37234,29095
2021-02-10,MO,Jackson,976,38210,29095
2021-02-11,MO,Jackson,1873,40083,29095
2021-02-12,MO,Jackson,1849,41932,29095
2021-02-13,MO,Jackson,589,42521,29095
2021-02-14,MO,Jackson,301,42822,29095
2021-02-15,MO,Jackson,753,43575,29095
2021-02-16,MO,Jackson,975,44550,29095
2021-02-17,MO,Jackson,1148,45698,29095
2021-02-18,MO,Jackson,1700,47398,29095
2021-02-19,MO,Jackson,1855,49253,29095
2021-02-20,MO,Jackson,583,49836,29095
2021-02-21,MO,Jackson,262,50098,29095
2021-02-22,MO,Jackson,1556,51654,29095
2021-02-23,MO,Jackson,2024,53678,29095
2021-02-24,MO,Jackson,2928,56606,29095
2021-02-25,MO,Jackson,2798,59404,29095
2021-02-26,MO,Jackson,3930,63334,29095
2021-02-27,MO,Jackson,1459,64793,29095
2021-02-28,MO,Jackson,797,65590,29095
2021-03-01,MO,Jackson,1932,67522,29095
2021-03-02,MO,Jackson,2628,70150,29095
2021-03-03,MO,Jackson,3376,73526,29095
2021-03-04,MO,Jackson,3454,76980,29095
2021-03-05,MO,Jackson,3613,80593,29095
2021-03-06,MO,Jackson,1320,81913,29095
2021-03-07,MO,Jackson,359,82272,29095
2021-03-08,MO,Jackson,2313,84585,29095
2021-03-09,MO,Jackson,1980,86565,29095
2021-03-10,MO,Jackson,3113,89678,29095
2021-03-11,MO,Jackson,2985,92663,29095
2021-03-12,MO,Jackson,2771,95434,29095
2021-03-13,MO,Jackson,1492,96926,29095
2021-03-14,MO,Jackson,730,97656,29095
2021-03-15,MO,Jackson,2497,100153,29095
2021-03-16,MO,Jackson,2850,103003,29095
2021-03-17,MO,Jackson,2756,105759,29095
2021-03-18,MO,Jackson,2552,108311,29095
2021-03-19,MO,Jackson,4257,112568,29095
2021-03-20,MO,Jackson,3945,116513,29095
2021-03-21,MO,Jackson,1491,118004,29095
2021-03-22,MO,Jackson,2867,120871,29095
2021-03-23,MO,Jackson,3554,124425,29095
2021-03-24,MO,Jackson,3615,128040,29095
2021-03-25,MO,Jackson,4639,132679,29095
2021-03-26,MO,Jackson,4546,137225,29095
2021-03-27,MO,Jackson,1746,138971,29095
2021-03-28,MO,Jackson,438,139409,29095
2021-03-29,MO,Jackson,3967,143376,29095
2021-03-30,MO,Jackson,3487,146863,29095
2021-03-31,MO,Jackson,3535,150398,29095
2021-04-01,MO,Jackson,4424,154822,29095
2021-04-02,MO,Jackson,4100,158922,29095
2021-04-03,MO,Jackson,1170,160092,29095
2021-04-04,MO,Jackson,405,160497,29095
2021-04-05,MO,Jackson,3973,164470,29095
2021-04-06,MO,Jackson,4338,168808,29095
2021-04-07,MO,Jackson,4221,173029,29095
2021-04-08,MO,Jackson,4093,177122,29095
2021-04-09,MO,Jackson,4538,181660,29095
2021-04-10,MO,Jackson,3103,184763,29095
2021-04-11,MO,Jackson,1146,185909,29095
2021-04-12,MO,Jackson,3210,189119,29095
2021-04-13,MO,Jackson,3534,192653,29095
2021-04-14,MO,Jackson,3673,196326,29095
2021-04-15,MO,Jackson,3888,200214,29095
2021-04-16,MO,Jackson,3042,203256,29095
2021-04-17,MO,Jackson,958,204214,29095
2021-04-18,MO,Jackson,445,204659,29095
2021-04-19,MO,Jackson,2169,206828,29095
2021-04-20,MO,Jackson,2478,209306,29095
2021-04-21,MO,Jackson,2012,211318,29095
2021-04-22,MO,Jackson,1821,213139,29095
2021-04-23,MO,Jackson,2057,215196,29095
2021-04-24,MO,Jackson,887,216083,29095
2021-04-25,MO,Jackson,408,216491,29095
2021-04-26,MO,Jackson,1700,218191,29095
2021-04-27,MO,Jackson,2273,220464,29095
2021-04-28,MO,Jackson,2237,222701,29095
2021-04-29,MO,Jackson,2406,225107,29095
2021-04-30,MO,Jackson,2573,227680,29095
2021-05-01,MO,Jackson,1582,229262,29095
2021-05-02,MO,Jackson,664,229926,29095
2021-05-03,MO,Jackson,2198,232124,29095
2021-05-04,MO,Jackson,2216,234340,29095
2021-05-05,MO,Jackson,2266,236606,29095
2021-05-06,MO,Jackson,2402,239008,29095
2021-05-07,MO,Jackson,1831,240839,29095
2021-05-08,MO,Jackson,676,241515,29095
2021-05-09,MO,Jackson,501,242016,29095
2021-05-10,MO,Jackson,924,242940,29095
2021-05-11,MO,Jackson,1242,244182,29095
2021-05-12,MO,Jackson,1176,245358,29095
2021-05-13,MO,Jackson,1160,246518,29095
2021-05-14,MO,Jackson,1768,248286,29095
2021-05-15,MO,Jackson,1661,249947,29095
2021-05-16,MO,Jackson,668,250615,29095
2021-05-17,MO,Jackson,1685,252300,29095
2021-05-18,MO,Jackson,1442,253742,29095
2021-05-19,MO,Jackson,1375,255117,29095
2021-05-20,MO,Jackson,1169,256286,29095
2021-05-21,MO,Jackson,1375,257661,29095
2021-05-22,MO,Jackson,742,258403,29095
2021-05-23,MO,Jackson,350,258753,29095
2021-05-24,MO,Jackson,865,259618,29095
2021-05-25,MO,Jackson,867,260485,29095
2021-05-26,MO,Jackson,947,261432,29095
2021-05-27,MO,Jackson,259,261691,29095
2020-12-15,MO,Jasper,2,2,29097
2020-12-16,MO,Jasper,11,13,29097
2020-12-17,MO,Jasper,49,62,29097
2020-12-18,MO,Jasper,35,97,29097
2020-12-19,MO,Jasper,12,109,29097
2020-12-20,MO,Jasper,3,112,29097
2020-12-21,MO,Jasper,52,164,29097
2020-12-22,MO,Jasper,56,220,29097
2020-12-23,MO,Jasper,66,286,29097
2020-12-26,MO,Jasper,2,288,29097
2020-12-28,MO,Jasper,36,324,29097
2020-12-29,MO,Jasper,23,347,29097
2020-12-30,MO,Jasper,226,573,29097
2020-12-31,MO,Jasper,141,714,29097
2021-01-02,MO,Jasper,1,715,29097
2021-01-04,MO,Jasper,16,731,29097
2021-01-05,MO,Jasper,27,758,29097
2021-01-06,MO,Jasper,76,834,29097
2021-01-07,MO,Jasper,99,933,29097
2021-01-08,MO,Jasper,93,1026,29097
2021-01-09,MO,Jasper,19,1045,29097
2021-01-10,MO,Jasper,6,1051,29097
2021-01-11,MO,Jasper,81,1132,29097
2021-01-12,MO,Jasper,165,1297,29097
2021-01-13,MO,Jasper,57,1354,29097
2021-01-14,MO,Jasper,130,1484,29097
2021-01-15,MO,Jasper,75,1559,29097
2021-01-16,MO,Jasper,29,1588,29097
2021-01-17,MO,Jasper,2,1590,29097
2021-01-18,MO,Jasper,123,1713,29097
2021-01-19,MO,Jasper,76,1789,29097
2021-01-20,MO,Jasper,209,1998,29097
2021-01-21,MO,Jasper,185,2183,29097
2021-01-22,MO,Jasper,101,2284,29097
2021-01-23,MO,Jasper,65,2349,29097
2021-01-25,MO,Jasper,99,2448,29097
2021-01-26,MO,Jasper,227,2675,29097
2021-01-27,MO,Jasper,293,2968,29097
2021-01-28,MO,Jasper,255,3223,29097
2021-01-29,MO,Jasper,254,3477,29097
2021-01-30,MO,Jasper,5,3482,29097
2021-02-01,MO,Jasper,319,3801,29097
2021-02-02,MO,Jasper,309,4110,29097
2021-02-03,MO,Jasper,518,4628,29097
2021-02-04,MO,Jasper,240,4868,29097
2021-02-05,MO,Jasper,302,5170,29097
2021-02-06,MO,Jasper,4,5174,29097
2021-02-07,MO,Jasper,1,5175,29097
2021-02-08,MO,Jasper,110,5285,29097
2021-02-09,MO,Jasper,274,5559,29097
2021-02-10,MO,Jasper,102,5661,29097
2021-02-11,MO,Jasper,501,6162,29097
2021-02-12,MO,Jasper,239,6401,29097
2021-02-13,MO,Jasper,183,6584,29097
2021-02-14,MO,Jasper,16,6600,29097
2021-02-15,MO,Jasper,108,6708,29097
2021-02-16,MO,Jasper,266,6974,29097
2021-02-17,MO,Jasper,235,7209,29097
2021-02-18,MO,Jasper,222,7431,29097
2021-02-19,MO,Jasper,158,7589,29097
2021-02-20,MO,Jasper,85,7674,29097
2021-02-22,MO,Jasper,293,7967,29097
2021-02-23,MO,Jasper,345,8312,29097
2021-02-24,MO,Jasper,439,8751,29097
2021-02-25,MO,Jasper,377,9128,29097
2021-02-26,MO,Jasper,472,9600,29097
2021-02-27,MO,Jasper,22,9622,29097
2021-02-28,MO,Jasper,15,9637,29097
2021-03-01,MO,Jasper,224,9861,29097
2021-03-02,MO,Jasper,713,10574,29097
2021-03-03,MO,Jasper,468,11042,29097
2021-03-04,MO,Jasper,194,11236,29097
2021-03-05,MO,Jasper,359,11595,29097
2021-03-06,MO,Jasper,94,11689,29097
2021-03-07,MO,Jasper,17,11706,29097
2021-03-08,MO,Jasper,115,11821,29097
2021-03-09,MO,Jasper,578,12399,29097
2021-03-10,MO,Jasper,207,12606,29097
2021-03-11,MO,Jasper,501,13107,29097
2021-03-12,MO,Jasper,302,13409,29097
2021-03-13,MO,Jasper,171,13580,29097
2021-03-14,MO,Jasper,54,13634,29097
2021-03-15,MO,Jasper,451,14085,29097
2021-03-16,MO,Jasper,508,14593,29097
2021-03-17,MO,Jasper,322,14915,29097
2021-03-18,MO,Jasper,450,15365,29097
2021-03-19,MO,Jasper,331,15696,29097
2021-03-20,MO,Jasper,94,15790,29097
2021-03-21,MO,Jasper,24,15814,29097
2021-03-22,MO,Jasper,148,15962,29097
2021-03-23,MO,Jasper,743,16705,29097
2021-03-24,MO,Jasper,447,17152,29097
2021-03-25,MO,Jasper,470,17622,29097
2021-03-26,MO,Jasper,374,17996,29097
2021-03-27,MO,Jasper,168,18164,29097
2021-03-28,MO,Jasper,52,18216,29097
2021-03-29,MO,Jasper,274,18490,29097
2021-03-30,MO,Jasper,436,18926,29097
2021-03-31,MO,Jasper,335,19261,29097
2021-04-01,MO,Jasper,428,19689,29097
2021-04-02,MO,Jasper,236,19925,29097
2021-04-03,MO,Jasper,69,19994,29097
2021-04-04,MO,Jasper,21,20015,29097
2021-04-05,MO,Jasper,421,20436,29097
2021-04-06,MO,Jasper,545,20981,29097
2021-04-07,MO,Jasper,299,21280,29097
2021-04-08,MO,Jasper,314,21594,29097
2021-04-09,MO,Jasper,668,22262,29097
2021-04-10,MO,Jasper,108,22370,29097
2021-04-11,MO,Jasper,36,22406,29097
2021-04-12,MO,Jasper,215,22621,29097
2021-04-13,MO,Jasper,307,22928,29097
2021-04-14,MO,Jasper,308,23236,29097
2021-04-15,MO,Jasper,364,23600,29097
2021-04-16,MO,Jasper,313,23913,29097
2021-04-17,MO,Jasper,83,23996,29097
2021-04-18,MO,Jasper,33,24029,29097
2021-04-19,MO,Jasper,143,24172,29097
2021-04-20,MO,Jasper,422,24594,29097
2021-04-21,MO,Jasper,194,24788,29097
2021-04-22,MO,Jasper,280,25068,29097
2021-04-23,MO,Jasper,290,25358,29097
2021-04-24,MO,Jasper,56,25414,29097
2021-04-25,MO,Jasper,25,25439,29097
2021-04-26,MO,Jasper,121,25560,29097
2021-04-27,MO,Jasper,194,25754,29097
2021-04-28,MO,Jasper,173,25927,29097
2021-04-29,MO,Jasper,332,26259,29097
2021-04-30,MO,Jasper,205,26464,29097
2021-05-01,MO,Jasper,64,26528,29097
2021-05-02,MO,Jasper,32,26560,29097
2021-05-03,MO,Jasper,167,26727,29097
2021-05-04,MO,Jasper,318,27045,29097
2021-05-05,MO,Jasper,155,27200,29097
2021-05-06,MO,Jasper,197,27397,29097
2021-05-07,MO,Jasper,167,27564,29097
2021-05-08,MO,Jasper,71,27635,29097
2021-05-09,MO,Jasper,36,27671,29097
2021-05-10,MO,Jasper,118,27789,29097
2021-05-11,MO,Jasper,191,27980,29097
2021-05-12,MO,Jasper,113,28093,29097
2021-05-13,MO,Jasper,159,28252,29097
2021-05-14,MO,Jasper,163,28415,29097
2021-05-15,MO,Jasper,61,28476,29097
2021-05-16,MO,Jasper,33,28509,29097
2021-05-17,MO,Jasper,103,28612,29097
2021-05-18,MO,Jasper,173,28785,29097
2021-05-19,MO,Jasper,173,28958,29097
2021-05-20,MO,Jasper,165,29123,29097
2021-05-21,MO,Jasper,147,29270,29097
2021-05-22,MO,Jasper,65,29335,29097
2021-05-23,MO,Jasper,38,29373,29097
2021-05-24,MO,Jasper,131,29504,29097
2021-05-25,MO,Jasper,125,29629,29097
2021-05-26,MO,Jasper,104,29733,29097
2021-05-27,MO,Jasper,69,29802,29097
2020-12-14,MO,Jefferson,5,5,29099
2020-12-15,MO,Jefferson,30,35,29099
2020-12-16,MO,Jefferson,106,141,29099
2020-12-17,MO,Jefferson,237,378,29099
2020-12-18,MO,Jefferson,272,650,29099
2020-12-19,MO,Jefferson,77,727,29099
2020-12-20,MO,Jefferson,37,764,29099
2020-12-21,MO,Jefferson,257,1021,29099
2020-12-22,MO,Jefferson,294,1315,29099
2020-12-23,MO,Jefferson,208,1523,29099
2020-12-24,MO,Jefferson,22,1545,29099
2020-12-26,MO,Jefferson,60,1605,29099
2020-12-27,MO,Jefferson,45,1650,29099
2020-12-28,MO,Jefferson,251,1901,29099
2020-12-29,MO,Jefferson,315,2216,29099
2020-12-30,MO,Jefferson,282,2498,29099
2020-12-31,MO,Jefferson,134,2632,29099
2021-01-01,MO,Jefferson,10,2642,29099
2021-01-02,MO,Jefferson,81,2723,29099
2021-01-03,MO,Jefferson,11,2734,29099
2021-01-04,MO,Jefferson,329,3063,29099
2021-01-05,MO,Jefferson,287,3350,29099
2021-01-06,MO,Jefferson,343,3693,29099
2021-01-07,MO,Jefferson,320,4013,29099
2021-01-08,MO,Jefferson,554,4567,29099
2021-01-09,MO,Jefferson,88,4655,29099
2021-01-10,MO,Jefferson,45,4700,29099
2021-01-11,MO,Jefferson,437,5137,29099
2021-01-12,MO,Jefferson,478,5615,29099
2021-01-13,MO,Jefferson,438,6053,29099
2021-01-14,MO,Jefferson,345,6398,29099
2021-01-15,MO,Jefferson,471,6869,29099
2021-01-16,MO,Jefferson,107,6976,29099
2021-01-17,MO,Jefferson,9,6985,29099
2021-01-18,MO,Jefferson,513,7498,29099
2021-01-19,MO,Jefferson,650,8148,29099
2021-01-20,MO,Jefferson,771,8919,29099
2021-01-21,MO,Jefferson,610,9529,29099
2021-01-22,MO,Jefferson,656,10185,29099
2021-01-23,MO,Jefferson,250,10435,29099
2021-01-24,MO,Jefferson,53,10488,29099
2021-01-25,MO,Jefferson,529,11017,29099
2021-01-26,MO,Jefferson,492,11509,29099
2021-01-27,MO,Jefferson,517,12026,29099
2021-01-28,MO,Jefferson,572,12598,29099
2021-01-29,MO,Jefferson,819,13417,29099
2021-01-30,MO,Jefferson,212,13629,29099
2021-01-31,MO,Jefferson,20,13649,29099
2021-02-01,MO,Jefferson,479,14128,29099
2021-02-02,MO,Jefferson,502,14630,29099
2021-02-03,MO,Jefferson,566,15196,29099
2021-02-04,MO,Jefferson,664,15860,29099
2021-02-05,MO,Jefferson,1150,17010,29099
2021-02-06,MO,Jefferson,116,17126,29099
2021-02-07,MO,Jefferson,23,17149,29099
2021-02-08,MO,Jefferson,536,17685,29099
2021-02-09,MO,Jefferson,737,18422,29099
2021-02-10,MO,Jefferson,749,19171,29099
2021-02-11,MO,Jefferson,902,20073,29099
2021-02-12,MO,Jefferson,1056,21129,29099
2021-02-13,MO,Jefferson,622,21751,29099
2021-02-14,MO,Jefferson,59,21810,29099
2021-02-15,MO,Jefferson,251,22061,29099
2021-02-16,MO,Jefferson,449,22510,29099
2021-02-17,MO,Jefferson,698,23208,29099
2021-02-18,MO,Jefferson,816,24024,29099
2021-02-19,MO,Jefferson,822,24846,29099
2021-02-20,MO,Jefferson,670,25516,29099
2021-02-21,MO,Jefferson,27,25543,29099
2021-02-22,MO,Jefferson,656,26199,29099
2021-02-23,MO,Jefferson,717,26916,29099
2021-02-24,MO,Jefferson,694,27610,29099
2021-02-25,MO,Jefferson,879,28489,29099
2021-02-26,MO,Jefferson,1119,29608,29099
2021-02-27,MO,Jefferson,570,30178,29099
2021-02-28,MO,Jefferson,103,30281,29099
2021-03-01,MO,Jefferson,1639,31920,29099
2021-03-02,MO,Jefferson,1580,33500,29099
2021-03-03,MO,Jefferson,802,34302,29099
2021-03-04,MO,Jefferson,1299,35601,29099
2021-03-05,MO,Jefferson,1119,36720,29099
2021-03-06,MO,Jefferson,660,37380,29099
2021-03-07,MO,Jefferson,187,37567,29099
2021-03-08,MO,Jefferson,1823,39390,29099
2021-03-09,MO,Jefferson,1304,40694,29099
2021-03-10,MO,Jefferson,1667,42361,29099
2021-03-11,MO,Jefferson,1252,43613,29099
2021-03-12,MO,Jefferson,1078,44691,29099
2021-03-13,MO,Jefferson,538,45229,29099
2021-03-14,MO,Jefferson,96,45325,29099
2021-03-15,MO,Jefferson,817,46142,29099
2021-03-16,MO,Jefferson,1244,47386,29099
2021-03-17,MO,Jefferson,1134,48520,29099
2021-03-18,MO,Jefferson,2023,50543,29099
2021-03-19,MO,Jefferson,1463,52006,29099
2021-03-20,MO,Jefferson,938,52944,29099
2021-03-21,MO,Jefferson,256,53200,29099
2021-03-22,MO,Jefferson,1165,54365,29099
2021-03-23,MO,Jefferson,1111,55476,29099
2021-03-24,MO,Jefferson,1323,56799,29099
2021-03-25,MO,Jefferson,1874,58673,29099
2021-03-26,MO,Jefferson,1271,59944,29099
2021-03-27,MO,Jefferson,746,60690,29099
2021-03-28,MO,Jefferson,255,60945,29099
2021-03-29,MO,Jefferson,2026,62971,29099
2021-03-30,MO,Jefferson,2656,65627,29099
2021-03-31,MO,Jefferson,1668,67295,29099
2021-04-01,MO,Jefferson,2376,69671,29099
2021-04-02,MO,Jefferson,1292,70963,29099
2021-04-03,MO,Jefferson,703,71666,29099
2021-04-04,MO,Jefferson,107,71773,29099
2021-04-05,MO,Jefferson,2080,73853,29099
2021-04-06,MO,Jefferson,2161,76014,29099
2021-04-07,MO,Jefferson,2600,78614,29099
2021-04-08,MO,Jefferson,2078,80692,29099
2021-04-09,MO,Jefferson,1572,82264,29099
2021-04-10,MO,Jefferson,702,82966,29099
2021-04-11,MO,Jefferson,249,83215,29099
2021-04-12,MO,Jefferson,1604,84819,29099
2021-04-13,MO,Jefferson,1712,86531,29099
2021-04-14,MO,Jefferson,1739,88270,29099
2021-04-15,MO,Jefferson,1852,90122,29099
2021-04-16,MO,Jefferson,1441,91563,29099
2021-04-17,MO,Jefferson,775,92338,29099
2021-04-18,MO,Jefferson,252,92590,29099
2021-04-19,MO,Jefferson,898,93488,29099
2021-04-20,MO,Jefferson,1540,95028,29099
2021-04-21,MO,Jefferson,1295,96323,29099
2021-04-22,MO,Jefferson,1623,97946,29099
2021-04-23,MO,Jefferson,1020,98966,29099
2021-04-24,MO,Jefferson,686,99652,29099
2021-04-25,MO,Jefferson,215,99867,29099
2021-04-26,MO,Jefferson,712,100579,29099
2021-04-27,MO,Jefferson,1208,101787,29099
2021-04-28,MO,Jefferson,1181,102968,29099
2021-04-29,MO,Jefferson,1670,104638,29099
2021-04-30,MO,Jefferson,793,105431,29099
2021-05-01,MO,Jefferson,433,105864,29099
2021-05-02,MO,Jefferson,234,106098,29099
2021-05-03,MO,Jefferson,1395,107493,29099
2021-05-04,MO,Jefferson,1406,108899,29099
2021-05-05,MO,Jefferson,1649,110548,29099
2021-05-06,MO,Jefferson,675,111223,29099
2021-05-07,MO,Jefferson,887,112110,29099
2021-05-08,MO,Jefferson,494,112604,29099
2021-05-09,MO,Jefferson,155,112759,29099
2021-05-10,MO,Jefferson,625,113384,29099
2021-05-11,MO,Jefferson,1108,114492,29099
2021-05-12,MO,Jefferson,676,115168,29099
2021-05-13,MO,Jefferson,583,115751,29099
2021-05-14,MO,Jefferson,952,116703,29099
2021-05-15,MO,Jefferson,620,117323,29099
2021-05-16,MO,Jefferson,278,117601,29099
2021-05-17,MO,Jefferson,767,118368,29099
2021-05-18,MO,Jefferson,756,119124,29099
2021-05-19,MO,Jefferson,1287,120411,29099
2021-05-20,MO,Jefferson,563,120974,29099
2021-05-21,MO,Jefferson,674,121648,29099
2021-05-22,MO,Jefferson,449,122097,29099
2021-05-23,MO,Jefferson,179,122276,29099
2021-05-24,MO,Jefferson,470,122746,29099
2021-05-25,MO,Jefferson,452,123198,29099
2021-05-26,MO,Jefferson,717,123915,29099
2021-05-27,MO,Jefferson,161,124076,29099
2020-12-16,MO,Johnson,1,1,29101
2020-12-17,MO,Johnson,5,6,29101
2020-12-18,MO,Johnson,40,46,29101
2020-12-19,MO,Johnson,16,62,29101
2020-12-20,MO,Johnson,14,76,29101
2020-12-21,MO,Johnson,75,151,29101
2020-12-22,MO,Johnson,72,223,29101
2020-12-23,MO,Johnson,50,273,29101
2020-12-24,MO,Johnson,6,279,29101
2020-12-27,MO,Johnson,1,280,29101
2020-12-28,MO,Johnson,51,331,29101
2020-12-29,MO,Johnson,69,400,29101
2020-12-30,MO,Johnson,64,464,29101
2020-12-31,MO,Johnson,30,494,29101
2021-01-02,MO,Johnson,4,498,29101
2021-01-03,MO,Johnson,1,499,29101
2021-01-04,MO,Johnson,12,511,29101
2021-01-05,MO,Johnson,89,600,29101
2021-01-06,MO,Johnson,72,672,29101
2021-01-07,MO,Johnson,31,703,29101
2021-01-08,MO,Johnson,54,757,29101
2021-01-09,MO,Johnson,12,769,29101
2021-01-10,MO,Johnson,3,772,29101
2021-01-11,MO,Johnson,80,852,29101
2021-01-12,MO,Johnson,82,934,29101
2021-01-13,MO,Johnson,97,1031,29101
2021-01-14,MO,Johnson,40,1071,29101
2021-01-15,MO,Johnson,53,1124,29101
2021-01-16,MO,Johnson,107,1231,29101
2021-01-17,MO,Johnson,1,1232,29101
2021-01-18,MO,Johnson,40,1272,29101
2021-01-19,MO,Johnson,131,1403,29101
2021-01-20,MO,Johnson,64,1467,29101
2021-01-21,MO,Johnson,52,1519,29101
2021-01-22,MO,Johnson,338,1857,29101
2021-01-23,MO,Johnson,17,1874,29101
2021-01-25,MO,Johnson,38,1912,29101
2021-01-26,MO,Johnson,91,2003,29101
2021-01-27,MO,Johnson,371,2374,29101
2021-01-28,MO,Johnson,57,2431,29101
2021-01-29,MO,Johnson,644,3075,29101
2021-01-30,MO,Johnson,28,3103,29101
2021-01-31,MO,Johnson,18,3121,29101
2021-02-01,MO,Johnson,62,3183,29101
2021-02-02,MO,Johnson,244,3427,29101
2021-02-03,MO,Johnson,126,3553,29101
2021-02-04,MO,Johnson,263,3816,29101
2021-02-05,MO,Johnson,92,3908,29101
2021-02-06,MO,Johnson,10,3918,29101
2021-02-08,MO,Johnson,33,3951,29101
2021-02-09,MO,Johnson,56,4007,29101
2021-02-10,MO,Johnson,75,4082,29101
2021-02-11,MO,Johnson,55,4137,29101
2021-02-12,MO,Johnson,629,4766,29101
2021-02-13,MO,Johnson,189,4955,29101
2021-02-14,MO,Johnson,23,4978,29101
2021-02-15,MO,Johnson,34,5012,29101
2021-02-16,MO,Johnson,156,5168,29101
2021-02-17,MO,Johnson,40,5208,29101
2021-02-18,MO,Johnson,57,5265,29101
2021-02-19,MO,Johnson,381,5646,29101
2021-02-20,MO,Johnson,22,5668,29101
2021-02-21,MO,Johnson,15,5683,29101
2021-02-22,MO,Johnson,17,5700,29101
2021-02-23,MO,Johnson,163,5863,29101
2021-02-24,MO,Johnson,445,6308,29101
2021-02-25,MO,Johnson,86,6394,29101
2021-02-26,MO,Johnson,362,6756,29101
2021-02-27,MO,Johnson,129,6885,29101
2021-02-28,MO,Johnson,51,6936,29101
2021-03-01,MO,Johnson,430,7366,29101
2021-03-02,MO,Johnson,463,7829,29101
2021-03-03,MO,Johnson,296,8125,29101
2021-03-04,MO,Johnson,86,8211,29101
2021-03-05,MO,Johnson,88,8299,29101
2021-03-06,MO,Johnson,26,8325,29101
2021-03-07,MO,Johnson,11,8336,29101
2021-03-08,MO,Johnson,61,8397,29101
2021-03-09,MO,Johnson,140,8537,29101
2021-03-10,MO,Johnson,210,8747,29101
2021-03-11,MO,Johnson,172,8919,29101
2021-03-12,MO,Johnson,416,9335,29101
2021-03-13,MO,Johnson,173,9508,29101
2021-03-14,MO,Johnson,31,9539,29101
2021-03-15,MO,Johnson,139,9678,29101
2021-03-16,MO,Johnson,168,9846,29101
2021-03-17,MO,Johnson,765,10611,29101
2021-03-18,MO,Johnson,346,10957,29101
2021-03-19,MO,Johnson,150,11107,29101
2021-03-20,MO,Johnson,60,11167,29101
2021-03-21,MO,Johnson,17,11184,29101
2021-03-22,MO,Johnson,68,11252,29101
2021-03-23,MO,Johnson,81,11333,29101
2021-03-24,MO,Johnson,160,11493,29101
2021-03-25,MO,Johnson,400,11893,29101
2021-03-26,MO,Johnson,265,12158,29101
2021-03-27,MO,Johnson,132,12290,29101
2021-03-28,MO,Johnson,62,12352,29101
2021-03-29,MO,Johnson,467,12819,29101
2021-03-30,MO,Johnson,534,13353,29101
2021-03-31,MO,Johnson,341,13694,29101
2021-04-01,MO,Johnson,382,14076,29101
2021-04-02,MO,Johnson,158,14234,29101
2021-04-03,MO,Johnson,78,14312,29101
2021-04-04,MO,Johnson,8,14320,29101
2021-04-05,MO,Johnson,121,14441,29101
2021-04-06,MO,Johnson,147,14588,29101
2021-04-07,MO,Johnson,148,14736,29101
2021-04-08,MO,Johnson,205,14941,29101
2021-04-09,MO,Johnson,563,15504,29101
2021-04-10,MO,Johnson,179,15683,29101
2021-04-11,MO,Johnson,26,15709,29101
2021-04-12,MO,Johnson,250,15959,29101
2021-04-13,MO,Johnson,133,16092,29101
2021-04-14,MO,Johnson,809,16901,29101
2021-04-15,MO,Johnson,608,17509,29101
2021-04-16,MO,Johnson,203,17712,29101
2021-04-17,MO,Johnson,47,17759,29101
2021-04-18,MO,Johnson,20,17779,29101
2021-04-19,MO,Johnson,74,17853,29101
2021-04-20,MO,Johnson,234,18087,29101
2021-04-21,MO,Johnson,109,18196,29101
2021-04-22,MO,Johnson,323,18519,29101
2021-04-23,MO,Johnson,176,18695,29101
2021-04-24,MO,Johnson,67,18762,29101
2021-04-25,MO,Johnson,15,18777,29101
2021-04-26,MO,Johnson,55,18832,29101
2021-04-27,MO,Johnson,81,18913,29101
2021-04-28,MO,Johnson,93,19006,29101
2021-04-29,MO,Johnson,102,19108,29101
2021-04-30,MO,Johnson,435,19543,29101
2021-05-01,MO,Johnson,61,19604,29101
2021-05-02,MO,Johnson,16,19620,29101
2021-05-03,MO,Johnson,182,19802,29101
2021-05-04,MO,Johnson,120,19922,29101
2021-05-05,MO,Johnson,106,20028,29101
2021-05-06,MO,Johnson,88,20116,29101
2021-05-07,MO,Johnson,138,20254,29101
2021-05-08,MO,Johnson,50,20304,29101
2021-05-09,MO,Johnson,24,20328,29101
2021-05-10,MO,Johnson,53,20381,29101
2021-05-11,MO,Johnson,52,20433,29101
2021-05-12,MO,Johnson,125,20558,29101
2021-05-13,MO,Johnson,51,20609,29101
2021-05-14,MO,Johnson,107,20716,29101
2021-05-15,MO,Johnson,72,20788,29101
2021-05-16,MO,Johnson,32,20820,29101
2021-05-17,MO,Johnson,81,20901,29101
2021-05-18,MO,Johnson,88,20989,29101
2021-05-19,MO,Johnson,111,21100,29101
2021-05-20,MO,Johnson,90,21190,29101
2021-05-21,MO,Johnson,61,21251,29101
2021-05-22,MO,Johnson,36,21287,29101
2021-05-23,MO,Johnson,12,21299,29101
2021-05-24,MO,Johnson,54,21353,29101
2021-05-25,MO,Johnson,59,21412,29101
2021-05-26,MO,Johnson,72,21484,29101
2021-05-27,MO,Johnson,22,21506,29101
2020-12-15,MO,Joplin,11,11,29097
2020-12-16,MO,Joplin,53,64,29097
2020-12-17,MO,Joplin,130,194,29097
2020-12-18,MO,Joplin,100,294,29097
2020-12-19,MO,Joplin,12,306,29097
2020-12-20,MO,Joplin,9,315,29097
2020-12-21,MO,Joplin,66,381,29097
2020-12-22,MO,Joplin,131,512,29097
2020-12-23,MO,Joplin,126,638,29097
2020-12-24,MO,Joplin,7,645,29097
2020-12-26,MO,Joplin,1,646,29097
2020-12-28,MO,Joplin,61,707,29097
2020-12-29,MO,Joplin,40,747,29097
2020-12-30,MO,Joplin,329,1076,29097
2020-12-31,MO,Joplin,252,1328,29097
2021-01-01,MO,Joplin,1,1329,29097
2021-01-02,MO,Joplin,6,1335,29097
2021-01-03,MO,Joplin,3,1338,29097
2021-01-04,MO,Joplin,26,1364,29097
2021-01-05,MO,Joplin,54,1418,29097
2021-01-06,MO,Joplin,189,1607,29097
2021-01-07,MO,Joplin,167,1774,29097
2021-01-08,MO,Joplin,195,1969,29097
2021-01-09,MO,Joplin,53,2022,29097
2021-01-10,MO,Joplin,19,2041,29097
2021-01-11,MO,Joplin,153,2194,29097
2021-01-12,MO,Joplin,347,2541,29097
2021-01-13,MO,Joplin,83,2624,29097
2021-01-14,MO,Joplin,81,2705,29097
2021-01-15,MO,Joplin,74,2779,29097
2021-01-16,MO,Joplin,31,2810,29097
2021-01-17,MO,Joplin,3,2813,29097
2021-01-18,MO,Joplin,225,3038,29097
2021-01-19,MO,Joplin,205,3243,29097
2021-01-20,MO,Joplin,420,3663,29097
2021-01-21,MO,Joplin,360,4023,29097
2021-01-22,MO,Joplin,270,4293,29097
2021-01-23,MO,Joplin,34,4327,29097
2021-01-24,MO,Joplin,1,4328,29097
2021-01-25,MO,Joplin,174,4502,29097
2021-01-26,MO,Joplin,351,4853,29097
2021-01-27,MO,Joplin,393,5246,29097
2021-01-28,MO,Joplin,145,5391,29097
2021-01-29,MO,Joplin,552,5943,29097
2021-01-30,MO,Joplin,6,5949,29097
2021-01-31,MO,Joplin,1,5950,29097
2021-02-01,MO,Joplin,132,6082,29097
2021-02-02,MO,Joplin,593,6675,29097
2021-02-03,MO,Joplin,567,7242,29097
2021-02-04,MO,Joplin,443,7685,29097
2021-02-05,MO,Joplin,450,8135,29097
2021-02-06,MO,Joplin,7,8142,29097
2021-02-08,MO,Joplin,267,8409,29097
2021-02-09,MO,Joplin,547,8956,29097
2021-02-10,MO,Joplin,252,9208,29097
2021-02-11,MO,Joplin,771,9979,29097
2021-02-12,MO,Joplin,395,10374,29097
2021-02-13,MO,Joplin,211,10585,29097
2021-02-14,MO,Joplin,43,10628,29097
2021-02-15,MO,Joplin,152,10780,29097
2021-02-16,MO,Joplin,260,11040,29097
2021-02-17,MO,Joplin,178,11218,29097
2021-02-18,MO,Joplin,213,11431,29097
2021-02-19,MO,Joplin,145,11576,29097
2021-02-20,MO,Joplin,47,11623,29097
2021-02-21,MO,Joplin,2,11625,29097
2021-02-22,MO,Joplin,73,11698,29097
2021-02-23,MO,Joplin,684,12382,29097
2021-02-24,MO,Joplin,456,12838,29097
2021-02-25,MO,Joplin,691,13529,29097
2021-02-26,MO,Joplin,628,14157,29097
2021-02-27,MO,Joplin,39,14196,29097
2021-02-28,MO,Joplin,10,14206,29097
2021-03-01,MO,Joplin,284,14490,29097
2021-03-02,MO,Joplin,777,15267,29097
2021-03-03,MO,Joplin,642,15909,29097
2021-03-04,MO,Joplin,476,16385,29097
2021-03-05,MO,Joplin,662,17047,29097
2021-03-06,MO,Joplin,178,17225,29097
2021-03-07,MO,Joplin,27,17252,29097
2021-03-08,MO,Joplin,193,17445,29097
2021-03-09,MO,Joplin,767,18212,29097
2021-03-10,MO,Joplin,309,18521,29097
2021-03-11,MO,Joplin,902,19423,29097
2021-03-12,MO,Joplin,383,19806,29097
2021-03-13,MO,Joplin,209,20015,29097
2021-03-14,MO,Joplin,86,20101,29097
2021-03-15,MO,Joplin,528,20629,29097
2021-03-16,MO,Joplin,568,21197,29097
2021-03-17,MO,Joplin,479,21676,29097
2021-03-18,MO,Joplin,562,22238,29097
2021-03-19,MO,Joplin,391,22629,29097
2021-03-20,MO,Joplin,81,22710,29097
2021-03-21,MO,Joplin,31,22741,29097
2021-03-22,MO,Joplin,106,22847,29097
2021-03-23,MO,Joplin,730,23577,29097
2021-03-24,MO,Joplin,733,24310,29097
2021-03-25,MO,Joplin,682,24992,29097
2021-03-26,MO,Joplin,387,25379,29097
2021-03-27,MO,Joplin,303,25682,29097
2021-03-28,MO,Joplin,46,25728,29097
2021-03-29,MO,Joplin,344,26072,29097
2021-03-30,MO,Joplin,547,26619,29097
2021-03-31,MO,Joplin,412,27031,29097
2021-04-01,MO,Joplin,479,27510,29097
2021-04-02,MO,Joplin,257,27767,29097
2021-04-03,MO,Joplin,132,27899,29097
2021-04-04,MO,Joplin,36,27935,29097
2021-04-05,MO,Joplin,443,28378,29097
2021-04-06,MO,Joplin,904,29282,29097
2021-04-07,MO,Joplin,396,29678,29097
2021-04-08,MO,Joplin,324,30002,29097
2021-04-09,MO,Joplin,847,30849,29097
2021-04-10,MO,Joplin,128,30977,29097
2021-04-11,MO,Joplin,61,31038,29097
2021-04-12,MO,Joplin,316,31354,29097
2021-04-13,MO,Joplin,370,31724,29097
2021-04-14,MO,Joplin,387,32111,29097
2021-04-15,MO,Joplin,517,32628,29097
2021-04-16,MO,Joplin,247,32875,29097
2021-04-17,MO,Joplin,113,32988,29097
2021-04-18,MO,Joplin,32,33020,29097
2021-04-19,MO,Joplin,149,33169,29097
2021-04-20,MO,Joplin,595,33764,29097
2021-04-21,MO,Joplin,263,34027,29097
2021-04-22,MO,Joplin,453,34480,29097
2021-04-23,MO,Joplin,319,34799,29097
2021-04-24,MO,Joplin,67,34866,29097
2021-04-25,MO,Joplin,36,34902,29097
2021-04-26,MO,Joplin,121,35023,29097
2021-04-27,MO,Joplin,223,35246,29097
2021-04-28,MO,Joplin,216,35462,29097
2021-04-29,MO,Joplin,435,35897,29097
2021-04-30,MO,Joplin,232,36129,29097
2021-05-01,MO,Joplin,94,36223,29097
2021-05-02,MO,Joplin,52,36275,29097
2021-05-03,MO,Joplin,253,36528,29097
2021-05-04,MO,Joplin,463,36991,29097
2021-05-05,MO,Joplin,208,37199,29097
2021-05-06,MO,Joplin,161,37360,29097
2021-05-07,MO,Joplin,200,37560,29097
2021-05-08,MO,Joplin,67,37627,29097
2021-05-09,MO,Joplin,45,37672,29097
2021-05-10,MO,Joplin,95,37767,29097
2021-05-11,MO,Joplin,232,37999,29097
2021-05-12,MO,Joplin,130,38129,29097
2021-05-13,MO,Joplin,265,38394,29097
2021-05-14,MO,Joplin,205,38599,29097
2021-05-15,MO,Joplin,108,38707,29097
2021-05-16,MO,Joplin,54,38761,29097
2021-05-17,MO,Joplin,136,38897,29097
2021-05-18,MO,Joplin,180,39077,29097
2021-05-19,MO,Joplin,172,39249,29097
2021-05-20,MO,Joplin,241,39490,29097
2021-05-21,MO,Joplin,131,39621,29097
2021-05-22,MO,Joplin,87,39708,29097
2021-05-23,MO,Joplin,46,39754,29097
2021-05-24,MO,Joplin,97,39851,29097
2021-05-25,MO,Joplin,160,40011,29097
2021-05-26,MO,Joplin,127,40138,29097
2021-05-27,MO,Joplin,96,40234,29097
2020-12-13,MO,Kansas City,1,1,29095
2020-12-14,MO,Kansas City,23,24,29095
2020-12-15,MO,Kansas City,57,81,29095
2020-12-16,MO,Kansas City,105,186,29095
2020-12-17,MO,Kansas City,317,503,29095
2020-12-18,MO,Kansas City,208,711,29095
2020-12-19,MO,Kansas City,220,931,29095
2020-12-20,MO,Kansas City,14,945,29095
2020-12-21,MO,Kansas City,768,1713,29095
2020-12-22,MO,Kansas City,1099,2812,29095
2020-12-23,MO,Kansas City,620,3432,29095
2020-12-24,MO,Kansas City,124,3556,29095
2020-12-26,MO,Kansas City,33,3589,29095
2020-12-27,MO,Kansas City,43,3632,29095
2020-12-28,MO,Kansas City,535,4167,29095
2020-12-29,MO,Kansas City,796,4963,29095
2020-12-30,MO,Kansas City,1297,6260,29095
2020-12-31,MO,Kansas City,984,7244,29095
2021-01-01,MO,Kansas City,8,7252,29095
2021-01-02,MO,Kansas City,251,7503,29095
2021-01-03,MO,Kansas City,34,7537,29095
2021-01-04,MO,Kansas City,262,7799,29095
2021-01-05,MO,Kansas City,762,8561,29095
2021-01-06,MO,Kansas City,698,9259,29095
2021-01-07,MO,Kansas City,1668,10927,29095
2021-01-08,MO,Kansas City,1714,12641,29095
2021-01-09,MO,Kansas City,698,13339,29095
2021-01-10,MO,Kansas City,72,13411,29095
2021-01-11,MO,Kansas City,1368,14779,29095
2021-01-12,MO,Kansas City,1713,16492,29095
2021-01-13,MO,Kansas City,1209,17701,29095
2021-01-14,MO,Kansas City,1111,18812,29095
2021-01-15,MO,Kansas City,1278,20090,29095
2021-01-16,MO,Kansas City,187,20277,29095
2021-01-17,MO,Kansas City,8,20285,29095
2021-01-18,MO,Kansas City,597,20882,29095
2021-01-19,MO,Kansas City,1320,22202,29095
2021-01-20,MO,Kansas City,1799,24001,29095
2021-01-21,MO,Kansas City,2510,26511,29095
2021-01-22,MO,Kansas City,2153,28664,29095
2021-01-23,MO,Kansas City,459,29123,29095
2021-01-24,MO,Kansas City,49,29172,29095
2021-01-25,MO,Kansas City,1442,30614,29095
2021-01-26,MO,Kansas City,1962,32576,29095
2021-01-27,MO,Kansas City,1896,34472,29095
2021-01-28,MO,Kansas City,2575,37047,29095
2021-01-29,MO,Kansas City,2348,39395,29095
2021-01-30,MO,Kansas City,707,40102,29095
2021-01-31,MO,Kansas City,230,40332,29095
2021-02-01,MO,Kansas City,1143,41475,29095
2021-02-02,MO,Kansas City,1385,42860,29095
2021-02-03,MO,Kansas City,1922,44782,29095
2021-02-04,MO,Kansas City,2870,47652,29095
2021-02-05,MO,Kansas City,3810,51462,29095
2021-02-06,MO,Kansas City,1215,52677,29095
2021-02-07,MO,Kansas City,223,52900,29095
2021-02-08,MO,Kansas City,1582,54482,29095
2021-02-09,MO,Kansas City,1598,56080,29095
2021-02-10,MO,Kansas City,1627,57707,29095
2021-02-11,MO,Kansas City,2529,60236,29095
2021-02-12,MO,Kansas City,2670,62906,29095
2021-02-13,MO,Kansas City,599,63505,29095
2021-02-14,MO,Kansas City,283,63788,29095
2021-02-15,MO,Kansas City,1447,65235,29095
2021-02-16,MO,Kansas City,1635,66870,29095
2021-02-17,MO,Kansas City,1849,68719,29095
2021-02-18,MO,Kansas City,3242,71961,29095
2021-02-19,MO,Kansas City,2457,74418,29095
2021-02-20,MO,Kansas City,684,75102,29095
2021-02-21,MO,Kansas City,211,75313,29095
2021-02-22,MO,Kansas City,1593,76906,29095
2021-02-23,MO,Kansas City,1706,78612,29095
2021-02-24,MO,Kansas City,2346,80958,29095
2021-02-25,MO,Kansas City,4531,85489,29095
2021-02-26,MO,Kansas City,5453,90942,29095
2021-02-27,MO,Kansas City,1505,92447,29095
2021-02-28,MO,Kansas City,835,93282,29095
2021-03-01,MO,Kansas City,1700,94982,29095
2021-03-02,MO,Kansas City,2871,97853,29095
2021-03-03,MO,Kansas City,3668,101521,29095
2021-03-04,MO,Kansas City,4892,106413,29095
2021-03-05,MO,Kansas City,4780,111193,29095
2021-03-06,MO,Kansas City,2312,113505,29095
2021-03-07,MO,Kansas City,606,114111,29095
2021-03-08,MO,Kansas City,3311,117422,29095
2021-03-09,MO,Kansas City,3062,120484,29095
2021-03-10,MO,Kansas City,3249,123733,29095
2021-03-11,MO,Kansas City,3217,126950,29095
2021-03-12,MO,Kansas City,2921,129871,29095
2021-03-13,MO,Kansas City,1428,131299,29095
2021-03-14,MO,Kansas City,805,132104,29095
2021-03-15,MO,Kansas City,2681,134785,29095
2021-03-16,MO,Kansas City,2923,137708,29095
2021-03-17,MO,Kansas City,3632,141340,29095
2021-03-18,MO,Kansas City,4933,146273,29095
2021-03-19,MO,Kansas City,5727,152000,29095
2021-03-20,MO,Kansas City,3009,155009,29095
2021-03-21,MO,Kansas City,1352,156361,29095
2021-03-22,MO,Kansas City,3862,160223,29095
2021-03-23,MO,Kansas City,4112,164335,29095
2021-03-24,MO,Kansas City,4703,169038,29095
2021-03-25,MO,Kansas City,6067,175105,29095
2021-03-26,MO,Kansas City,6993,182098,29095
2021-03-27,MO,Kansas City,1925,184023,29095
2021-03-28,MO,Kansas City,717,184740,29095
2021-03-29,MO,Kansas City,5465,190205,29095
2021-03-30,MO,Kansas City,5490,195695,29095
2021-03-31,MO,Kansas City,4668,200363,29095
2021-04-01,MO,Kansas City,6704,207067,29095
2021-04-02,MO,Kansas City,5927,212994,29095
2021-04-03,MO,Kansas City,1894,214888,29095
2021-04-04,MO,Kansas City,550,215438,29095
2021-04-05,MO,Kansas City,3970,219408,29095
2021-04-06,MO,Kansas City,5380,224788,29095
2021-04-07,MO,Kansas City,4561,229349,29095
2021-04-08,MO,Kansas City,5928,235277,29095
2021-04-09,MO,Kansas City,6371,241648,29095
2021-04-10,MO,Kansas City,3546,245194,29095
2021-04-11,MO,Kansas City,1049,246243,29095
2021-04-12,MO,Kansas City,3891,250134,29095
2021-04-13,MO,Kansas City,4497,254631,29095
2021-04-14,MO,Kansas City,3931,258562,29095
2021-04-15,MO,Kansas City,4895,263457,29095
2021-04-16,MO,Kansas City,5072,268529,29095
2021-04-17,MO,Kansas City,1221,269750,29095
2021-04-18,MO,Kansas City,609,270359,29095
2021-04-19,MO,Kansas City,2277,272636,29095
2021-04-20,MO,Kansas City,3231,275867,29095
2021-04-21,MO,Kansas City,2686,278553,29095
2021-04-22,MO,Kansas City,3743,282296,29095
2021-04-23,MO,Kansas City,3742,286038,29095
2021-04-24,MO,Kansas City,1331,287369,29095
2021-04-25,MO,Kansas City,617,287986,29095
2021-04-26,MO,Kansas City,1949,289935,29095
2021-04-27,MO,Kansas City,3358,293293,29095
2021-04-28,MO,Kansas City,2642,295935,29095
2021-04-29,MO,Kansas City,2982,298917,29095
2021-04-30,MO,Kansas City,2926,301843,29095
2021-05-01,MO,Kansas City,1822,303665,29095
2021-05-02,MO,Kansas City,742,304407,29095
2021-05-03,MO,Kansas City,2000,306407,29095
2021-05-04,MO,Kansas City,3108,309515,29095
2021-05-05,MO,Kansas City,2011,311526,29095
2021-05-06,MO,Kansas City,4099,315625,29095
2021-05-07,MO,Kansas City,2319,317944,29095
2021-05-08,MO,Kansas City,870,318814,29095
2021-05-09,MO,Kansas City,443,319257,29095
2021-05-10,MO,Kansas City,1096,320353,29095
2021-05-11,MO,Kansas City,1753,322106,29095
2021-05-12,MO,Kansas City,1252,323358,29095
2021-05-13,MO,Kansas City,1513,324871,29095
2021-05-14,MO,Kansas City,2053,326924,29095
2021-05-15,MO,Kansas City,1655,328579,29095
2021-05-16,MO,Kansas City,752,329331,29095
2021-05-17,MO,Kansas City,2255,331586,29095
2021-05-18,MO,Kansas City,1865,333451,29095
2021-05-19,MO,Kansas City,1924,335375,29095
2021-05-20,MO,Kansas City,1258,336633,29095
2021-05-21,MO,Kansas City,1340,337973,29095
2021-05-22,MO,Kansas City,1060,339033,29095
2021-05-23,MO,Kansas City,372,339405,29095
2021-05-24,MO,Kansas City,1247,340652,29095
2021-05-25,MO,Kansas City,1316,341968,29095
2021-05-26,MO,Kansas City,1074,343042,29095
2021-05-27,MO,Kansas City,391,343433,29095
2020-12-16,MO,Knox,1,1,29103
2020-12-17,MO,Knox,1,2,29103
2020-12-21,MO,Knox,21,23,29103
2020-12-22,MO,Knox,1,24,29103
2020-12-23,MO,Knox,9,33,29103
2020-12-28,MO,Knox,2,35,29103
2020-12-29,MO,Knox,1,36,29103
2020-12-30,MO,Knox,1,37,29103
2021-01-04,MO,Knox,1,38,29103
2021-01-05,MO,Knox,1,39,29103
2021-01-06,MO,Knox,2,41,29103
2021-01-08,MO,Knox,1,42,29103
2021-01-09,MO,Knox,2,44,29103
2021-01-11,MO,Knox,23,67,29103
2021-01-12,MO,Knox,1,68,29103
2021-01-13,MO,Knox,11,79,29103
2021-01-14,MO,Knox,5,84,29103
2021-01-15,MO,Knox,35,119,29103
2021-01-16,MO,Knox,1,120,29103
2021-01-18,MO,Knox,4,124,29103
2021-01-19,MO,Knox,27,151,29103
2021-01-20,MO,Knox,86,237,29103
2021-01-21,MO,Knox,30,267,29103
2021-01-22,MO,Knox,16,283,29103
2021-01-27,MO,Knox,100,383,29103
2021-01-28,MO,Knox,84,467,29103
2021-01-29,MO,Knox,73,540,29103
2021-02-01,MO,Knox,3,543,29103
2021-02-02,MO,Knox,5,548,29103
2021-02-04,MO,Knox,5,553,29103
2021-02-05,MO,Knox,113,666,29103
2021-02-06,MO,Knox,7,673,29103
2021-02-08,MO,Knox,7,680,29103
2021-02-09,MO,Knox,17,697,29103
2021-02-10,MO,Knox,64,761,29103
2021-02-11,MO,Knox,22,783,29103
2021-02-12,MO,Knox,70,853,29103
2021-02-15,MO,Knox,7,860,29103
2021-02-16,MO,Knox,42,902,29103
2021-02-17,MO,Knox,3,905,29103
2021-02-18,MO,Knox,92,997,29103
2021-02-19,MO,Knox,8,1005,29103
2021-02-22,MO,Knox,4,1009,29103
2021-02-23,MO,Knox,11,1020,29103
2021-02-24,MO,Knox,15,1035,29103
2021-02-25,MO,Knox,178,1213,29103
2021-02-26,MO,Knox,25,1238,29103
2021-02-27,MO,Knox,4,1242,29103
2021-02-28,MO,Knox,3,1245,29103
2021-03-01,MO,Knox,3,1248,29103
2021-03-02,MO,Knox,44,1292,29103
2021-03-03,MO,Knox,9,1301,29103
2021-03-04,MO,Knox,107,1408,29103
2021-03-05,MO,Knox,40,1448,29103
2021-03-06,MO,Knox,7,1455,29103
2021-03-07,MO,Knox,1,1456,29103
2021-03-08,MO,Knox,7,1463,29103
2021-03-09,MO,Knox,6,1469,29103
2021-03-10,MO,Knox,4,1473,29103
2021-03-11,MO,Knox,90,1563,29103
2021-03-12,MO,Knox,25,1588,29103
2021-03-13,MO,Knox,1,1589,29103
2021-03-15,MO,Knox,5,1594,29103
2021-03-16,MO,Knox,17,1611,29103
2021-03-17,MO,Knox,5,1616,29103
2021-03-18,MO,Knox,7,1623,29103
2021-03-19,MO,Knox,23,1646,29103
2021-03-21,MO,Knox,5,1651,29103
2021-03-22,MO,Knox,1,1652,29103
2021-03-23,MO,Knox,53,1705,29103
2021-03-24,MO,Knox,2,1707,29103
2021-03-25,MO,Knox,31,1738,29103
2021-03-26,MO,Knox,24,1762,29103
2021-03-28,MO,Knox,1,1763,29103
2021-03-29,MO,Knox,56,1819,29103
2021-03-30,MO,Knox,7,1826,29103
2021-03-31,MO,Knox,13,1839,29103
2021-04-01,MO,Knox,6,1845,29103
2021-04-02,MO,Knox,8,1853,29103
2021-04-05,MO,Knox,5,1858,29103
2021-04-06,MO,Knox,4,1862,29103
2021-04-07,MO,Knox,1,1863,29103
2021-04-08,MO,Knox,79,1942,29103
2021-04-09,MO,Knox,8,1950,29103
2021-04-10,MO,Knox,6,1956,29103
2021-04-12,MO,Knox,14,1970,29103
2021-04-13,MO,Knox,15,1985,29103
2021-04-14,MO,Knox,6,1991,29103
2021-04-15,MO,Knox,2,1993,29103
2021-04-16,MO,Knox,16,2009,29103
2021-04-17,MO,Knox,1,2010,29103
2021-04-18,MO,Knox,1,2011,29103
2021-04-19,MO,Knox,1,2012,29103
2021-04-20,MO,Knox,6,2018,29103
2021-04-21,MO,Knox,3,2021,29103
2021-04-22,MO,Knox,14,2035,29103
2021-04-23,MO,Knox,4,2039,29103
2021-04-24,MO,Knox,1,2040,29103
2021-04-26,MO,Knox,46,2086,29103
2021-04-29,MO,Knox,2,2088,29103
2021-04-30,MO,Knox,5,2093,29103
2021-05-01,MO,Knox,1,2094,29103
2021-05-03,MO,Knox,1,2095,29103
2021-05-04,MO,Knox,1,2096,29103
2021-05-05,MO,Knox,2,2098,29103
2021-05-06,MO,Knox,2,2100,29103
2021-05-07,MO,Knox,1,2101,29103
2021-05-08,MO,Knox,5,2106,29103
2021-05-10,MO,Knox,11,2117,29103
2021-05-11,MO,Knox,1,2118,29103
2021-05-12,MO,Knox,2,2120,29103
2021-05-13,MO,Knox,1,2121,29103
2021-05-14,MO,Knox,3,2124,29103
2021-05-15,MO,Knox,4,2128,29103
2021-05-17,MO,Knox,4,2132,29103
2021-05-18,MO,Knox,4,2136,29103
2021-05-19,MO,Knox,1,2137,29103
2021-05-20,MO,Knox,4,2141,29103
2021-05-21,MO,Knox,5,2146,29103
2021-05-22,MO,Knox,1,2147,29103
2021-05-24,MO,Knox,17,2164,29103
2021-05-25,MO,Knox,5,2169,29103
2021-05-27,MO,Knox,1,2170,29103
2020-12-15,MO,Laclede,15,15,29105
2020-12-16,MO,Laclede,20,35,29105
2020-12-17,MO,Laclede,39,74,29105
2020-12-18,MO,Laclede,16,90,29105
2020-12-19,MO,Laclede,4,94,29105
2020-12-20,MO,Laclede,2,96,29105
2020-12-21,MO,Laclede,39,135,29105
2020-12-22,MO,Laclede,42,177,29105
2020-12-23,MO,Laclede,33,210,29105
2020-12-24,MO,Laclede,1,211,29105
2020-12-27,MO,Laclede,3,214,29105
2020-12-28,MO,Laclede,99,313,29105
2020-12-29,MO,Laclede,27,340,29105
2020-12-30,MO,Laclede,29,369,29105
2020-12-31,MO,Laclede,19,388,29105
2021-01-02,MO,Laclede,88,476,29105
2021-01-03,MO,Laclede,2,478,29105
2021-01-04,MO,Laclede,24,502,29105
2021-01-05,MO,Laclede,26,528,29105
2021-01-06,MO,Laclede,46,574,29105
2021-01-07,MO,Laclede,45,619,29105
2021-01-08,MO,Laclede,73,692,29105
2021-01-09,MO,Laclede,4,696,29105
2021-01-11,MO,Laclede,60,756,29105
2021-01-12,MO,Laclede,41,797,29105
2021-01-13,MO,Laclede,77,874,29105
2021-01-14,MO,Laclede,70,944,29105
2021-01-15,MO,Laclede,37,981,29105
2021-01-16,MO,Laclede,10,991,29105
2021-01-18,MO,Laclede,118,1109,29105
2021-01-19,MO,Laclede,53,1162,29105
2021-01-20,MO,Laclede,140,1302,29105
2021-01-21,MO,Laclede,88,1390,29105
2021-01-22,MO,Laclede,112,1502,29105
2021-01-23,MO,Laclede,10,1512,29105
2021-01-24,MO,Laclede,1,1513,29105
2021-01-25,MO,Laclede,75,1588,29105
2021-01-26,MO,Laclede,37,1625,29105
2021-01-27,MO,Laclede,84,1709,29105
2021-01-28,MO,Laclede,127,1836,29105
2021-01-29,MO,Laclede,163,1999,29105
2021-01-30,MO,Laclede,150,2149,29105
2021-01-31,MO,Laclede,1,2150,29105
2021-02-01,MO,Laclede,27,2177,29105
2021-02-02,MO,Laclede,32,2209,29105
2021-02-03,MO,Laclede,156,2365,29105
2021-02-04,MO,Laclede,51,2416,29105
2021-02-05,MO,Laclede,148,2564,29105
2021-02-06,MO,Laclede,58,2622,29105
2021-02-08,MO,Laclede,73,2695,29105
2021-02-09,MO,Laclede,52,2747,29105
2021-02-10,MO,Laclede,128,2875,29105
2021-02-11,MO,Laclede,230,3105,29105
2021-02-12,MO,Laclede,273,3378,29105
2021-02-13,MO,Laclede,29,3407,29105
2021-02-14,MO,Laclede,9,3416,29105
2021-02-15,MO,Laclede,62,3478,29105
2021-02-16,MO,Laclede,41,3519,29105
2021-02-17,MO,Laclede,50,3569,29105
2021-02-18,MO,Laclede,168,3737,29105
2021-02-19,MO,Laclede,168,3905,29105
2021-02-20,MO,Laclede,44,3949,29105
2021-02-21,MO,Laclede,5,3954,29105
2021-02-22,MO,Laclede,542,4496,29105
2021-02-23,MO,Laclede,569,5065,29105
2021-02-24,MO,Laclede,35,5100,29105
2021-02-25,MO,Laclede,174,5274,29105
2021-02-26,MO,Laclede,187,5461,29105
2021-02-27,MO,Laclede,147,5608,29105
2021-02-28,MO,Laclede,17,5625,29105
2021-03-01,MO,Laclede,80,5705,29105
2021-03-02,MO,Laclede,94,5799,29105
2021-03-03,MO,Laclede,85,5884,29105
2021-03-04,MO,Laclede,326,6210,29105
2021-03-05,MO,Laclede,87,6297,29105
2021-03-06,MO,Laclede,81,6378,29105
2021-03-07,MO,Laclede,102,6480,29105
2021-03-08,MO,Laclede,70,6550,29105
2021-03-09,MO,Laclede,99,6649,29105
2021-03-10,MO,Laclede,251,6900,29105
2021-03-11,MO,Laclede,198,7098,29105
2021-03-12,MO,Laclede,216,7314,29105
2021-03-13,MO,Laclede,17,7331,29105
2021-03-14,MO,Laclede,8,7339,29105
2021-03-15,MO,Laclede,95,7434,29105
2021-03-16,MO,Laclede,174,7608,29105
2021-03-17,MO,Laclede,123,7731,29105
2021-03-18,MO,Laclede,87,7818,29105
2021-03-19,MO,Laclede,351,8169,29105
2021-03-20,MO,Laclede,29,8198,29105
2021-03-21,MO,Laclede,12,8210,29105
2021-03-22,MO,Laclede,677,8887,29105
2021-03-23,MO,Laclede,629,9516,29105
2021-03-24,MO,Laclede,165,9681,29105
2021-03-25,MO,Laclede,298,9979,29105
2021-03-26,MO,Laclede,106,10085,29105
2021-03-27,MO,Laclede,60,10145,29105
2021-03-28,MO,Laclede,19,10164,29105
2021-03-29,MO,Laclede,91,10255,29105
2021-03-30,MO,Laclede,178,10433,29105
2021-03-31,MO,Laclede,154,10587,29105
2021-04-01,MO,Laclede,258,10845,29105
2021-04-02,MO,Laclede,104,10949,29105
2021-04-03,MO,Laclede,29,10978,29105
2021-04-04,MO,Laclede,7,10985,29105
2021-04-05,MO,Laclede,58,11043,29105
2021-04-06,MO,Laclede,221,11264,29105
2021-04-07,MO,Laclede,306,11570,29105
2021-04-08,MO,Laclede,133,11703,29105
2021-04-09,MO,Laclede,246,11949,29105
2021-04-10,MO,Laclede,43,11992,29105
2021-04-11,MO,Laclede,13,12005,29105
2021-04-12,MO,Laclede,198,12203,29105
2021-04-13,MO,Laclede,173,12376,29105
2021-04-14,MO,Laclede,108,12484,29105
2021-04-15,MO,Laclede,103,12587,29105
2021-04-16,MO,Laclede,303,12890,29105
2021-04-17,MO,Laclede,41,12931,29105
2021-04-18,MO,Laclede,12,12943,29105
2021-04-19,MO,Laclede,84,13027,29105
2021-04-20,MO,Laclede,101,13128,29105
2021-04-21,MO,Laclede,112,13240,29105
2021-04-22,MO,Laclede,118,13358,29105
2021-04-23,MO,Laclede,78,13436,29105
2021-04-24,MO,Laclede,34,13470,29105
2021-04-25,MO,Laclede,18,13488,29105
2021-04-26,MO,Laclede,46,13534,29105
2021-04-27,MO,Laclede,189,13723,29105
2021-04-28,MO,Laclede,148,13871,29105
2021-04-29,MO,Laclede,63,13934,29105
2021-04-30,MO,Laclede,168,14102,29105
2021-05-01,MO,Laclede,13,14115,29105
2021-05-02,MO,Laclede,19,14134,29105
2021-05-03,MO,Laclede,46,14180,29105
2021-05-04,MO,Laclede,127,14307,29105
2021-05-05,MO,Laclede,88,14395,29105
2021-05-06,MO,Laclede,34,14429,29105
2021-05-07,MO,Laclede,69,14498,29105
2021-05-08,MO,Laclede,16,14514,29105
2021-05-09,MO,Laclede,10,14524,29105
2021-05-10,MO,Laclede,41,14565,29105
2021-05-11,MO,Laclede,130,14695,29105
2021-05-12,MO,Laclede,72,14767,29105
2021-05-13,MO,Laclede,88,14855,29105
2021-05-14,MO,Laclede,50,14905,29105
2021-05-15,MO,Laclede,44,14949,29105
2021-05-16,MO,Laclede,20,14969,29105
2021-05-17,MO,Laclede,53,15022,29105
2021-05-18,MO,Laclede,41,15063,29105
2021-05-19,MO,Laclede,93,15156,29105
2021-05-20,MO,Laclede,53,15209,29105
2021-05-21,MO,Laclede,46,15255,29105
2021-05-22,MO,Laclede,28,15283,29105
2021-05-23,MO,Laclede,26,15309,29105
2021-05-24,MO,Laclede,30,15339,29105
2021-05-25,MO,Laclede,94,15433,29105
2021-05-26,MO,Laclede,59,15492,29105
2021-05-27,MO,Laclede,17,15509,29105
2020-12-15,MO,Lafayette,1,1,29107
2020-12-16,MO,Lafayette,2,3,29107
2020-12-17,MO,Lafayette,8,11,29107
2020-12-18,MO,Lafayette,14,25,29107
2020-12-19,MO,Lafayette,4,29,29107
2020-12-20,MO,Lafayette,3,32,29107
2020-12-21,MO,Lafayette,27,59,29107
2020-12-22,MO,Lafayette,35,94,29107
2020-12-23,MO,Lafayette,37,131,29107
2020-12-24,MO,Lafayette,23,154,29107
2020-12-26,MO,Lafayette,2,156,29107
2020-12-27,MO,Lafayette,2,158,29107
2020-12-28,MO,Lafayette,77,235,29107
2020-12-29,MO,Lafayette,142,377,29107
2020-12-30,MO,Lafayette,39,416,29107
2020-12-31,MO,Lafayette,26,442,29107
2021-01-02,MO,Lafayette,5,447,29107
2021-01-04,MO,Lafayette,10,457,29107
2021-01-05,MO,Lafayette,70,527,29107
2021-01-06,MO,Lafayette,102,629,29107
2021-01-07,MO,Lafayette,53,682,29107
2021-01-08,MO,Lafayette,41,723,29107
2021-01-09,MO,Lafayette,15,738,29107
2021-01-10,MO,Lafayette,4,742,29107
2021-01-11,MO,Lafayette,92,834,29107
2021-01-12,MO,Lafayette,54,888,29107
2021-01-13,MO,Lafayette,34,922,29107
2021-01-14,MO,Lafayette,34,956,29107
2021-01-15,MO,Lafayette,99,1055,29107
2021-01-16,MO,Lafayette,4,1059,29107
2021-01-18,MO,Lafayette,30,1089,29107
2021-01-19,MO,Lafayette,44,1133,29107
2021-01-20,MO,Lafayette,106,1239,29107
2021-01-21,MO,Lafayette,69,1308,29107
2021-01-22,MO,Lafayette,46,1354,29107
2021-01-23,MO,Lafayette,15,1369,29107
2021-01-24,MO,Lafayette,1,1370,29107
2021-01-25,MO,Lafayette,55,1425,29107
2021-01-26,MO,Lafayette,256,1681,29107
2021-01-27,MO,Lafayette,128,1809,29107
2021-01-28,MO,Lafayette,165,1974,29107
2021-01-29,MO,Lafayette,204,2178,29107
2021-01-30,MO,Lafayette,130,2308,29107
2021-01-31,MO,Lafayette,6,2314,29107
2021-02-01,MO,Lafayette,169,2483,29107
2021-02-02,MO,Lafayette,325,2808,29107
2021-02-03,MO,Lafayette,355,3163,29107
2021-02-04,MO,Lafayette,377,3540,29107
2021-02-05,MO,Lafayette,96,3636,29107
2021-02-06,MO,Lafayette,17,3653,29107
2021-02-07,MO,Lafayette,4,3657,29107
2021-02-08,MO,Lafayette,79,3736,29107
2021-02-09,MO,Lafayette,200,3936,29107
2021-02-10,MO,Lafayette,312,4248,29107
2021-02-11,MO,Lafayette,533,4781,29107
2021-02-12,MO,Lafayette,248,5029,29107
2021-02-13,MO,Lafayette,30,5059,29107
2021-02-14,MO,Lafayette,5,5064,29107
2021-02-15,MO,Lafayette,31,5095,29107
2021-02-16,MO,Lafayette,167,5262,29107
2021-02-17,MO,Lafayette,100,5362,29107
2021-02-18,MO,Lafayette,223,5585,29107
2021-02-19,MO,Lafayette,80,5665,29107
2021-02-20,MO,Lafayette,116,5781,29107
2021-02-21,MO,Lafayette,5,5786,29107
2021-02-22,MO,Lafayette,62,5848,29107
2021-02-23,MO,Lafayette,171,6019,29107
2021-02-24,MO,Lafayette,195,6214,29107
2021-02-25,MO,Lafayette,167,6381,29107
2021-02-26,MO,Lafayette,140,6521,29107
2021-02-27,MO,Lafayette,58,6579,29107
2021-02-28,MO,Lafayette,13,6592,29107
2021-03-01,MO,Lafayette,203,6795,29107
2021-03-02,MO,Lafayette,314,7109,29107
2021-03-03,MO,Lafayette,294,7403,29107
2021-03-04,MO,Lafayette,228,7631,29107
2021-03-05,MO,Lafayette,546,8177,29107
2021-03-06,MO,Lafayette,33,8210,29107
2021-03-07,MO,Lafayette,14,8224,29107
2021-03-08,MO,Lafayette,97,8321,29107
2021-03-09,MO,Lafayette,343,8664,29107
2021-03-10,MO,Lafayette,403,9067,29107
2021-03-11,MO,Lafayette,548,9615,29107
2021-03-12,MO,Lafayette,416,10031,29107
2021-03-13,MO,Lafayette,85,10116,29107
2021-03-14,MO,Lafayette,25,10141,29107
2021-03-15,MO,Lafayette,119,10260,29107
2021-03-16,MO,Lafayette,125,10385,29107
2021-03-17,MO,Lafayette,172,10557,29107
2021-03-18,MO,Lafayette,308,10865,29107
2021-03-19,MO,Lafayette,181,11046,29107
2021-03-20,MO,Lafayette,50,11096,29107
2021-03-21,MO,Lafayette,19,11115,29107
2021-03-22,MO,Lafayette,80,11195,29107
2021-03-23,MO,Lafayette,190,11385,29107
2021-03-24,MO,Lafayette,141,11526,29107
2021-03-25,MO,Lafayette,249,11775,29107
2021-03-26,MO,Lafayette,185,11960,29107
2021-03-27,MO,Lafayette,79,12039,29107
2021-03-28,MO,Lafayette,11,12050,29107
2021-03-29,MO,Lafayette,291,12341,29107
2021-03-30,MO,Lafayette,242,12583,29107
2021-03-31,MO,Lafayette,185,12768,29107
2021-04-01,MO,Lafayette,187,12955,29107
2021-04-02,MO,Lafayette,576,13531,29107
2021-04-03,MO,Lafayette,48,13579,29107
2021-04-04,MO,Lafayette,6,13585,29107
2021-04-05,MO,Lafayette,144,13729,29107
2021-04-06,MO,Lafayette,343,14072,29107
2021-04-07,MO,Lafayette,146,14218,29107
2021-04-08,MO,Lafayette,113,14331,29107
2021-04-09,MO,Lafayette,389,14720,29107
2021-04-10,MO,Lafayette,78,14798,29107
2021-04-11,MO,Lafayette,27,14825,29107
2021-04-12,MO,Lafayette,264,15089,29107
2021-04-13,MO,Lafayette,187,15276,29107
2021-04-14,MO,Lafayette,382,15658,29107
2021-04-15,MO,Lafayette,305,15963,29107
2021-04-16,MO,Lafayette,195,16158,29107
2021-04-17,MO,Lafayette,119,16277,29107
2021-04-18,MO,Lafayette,12,16289,29107
2021-04-19,MO,Lafayette,142,16431,29107
2021-04-20,MO,Lafayette,128,16559,29107
2021-04-21,MO,Lafayette,115,16674,29107
2021-04-22,MO,Lafayette,131,16805,29107
2021-04-23,MO,Lafayette,148,16953,29107
2021-04-24,MO,Lafayette,43,16996,29107
2021-04-25,MO,Lafayette,7,17003,29107
2021-04-26,MO,Lafayette,155,17158,29107
2021-04-27,MO,Lafayette,115,17273,29107
2021-04-28,MO,Lafayette,98,17371,29107
2021-04-29,MO,Lafayette,126,17497,29107
2021-04-30,MO,Lafayette,112,17609,29107
2021-05-01,MO,Lafayette,43,17652,29107
2021-05-02,MO,Lafayette,7,17659,29107
2021-05-03,MO,Lafayette,134,17793,29107
2021-05-04,MO,Lafayette,87,17880,29107
2021-05-05,MO,Lafayette,147,18027,29107
2021-05-06,MO,Lafayette,92,18119,29107
2021-05-07,MO,Lafayette,83,18202,29107
2021-05-08,MO,Lafayette,22,18224,29107
2021-05-09,MO,Lafayette,18,18242,29107
2021-05-10,MO,Lafayette,112,18354,29107
2021-05-11,MO,Lafayette,81,18435,29107
2021-05-12,MO,Lafayette,81,18516,29107
2021-05-13,MO,Lafayette,70,18586,29107
2021-05-14,MO,Lafayette,82,18668,29107
2021-05-15,MO,Lafayette,112,18780,29107
2021-05-16,MO,Lafayette,35,18815,29107
2021-05-17,MO,Lafayette,80,18895,29107
2021-05-18,MO,Lafayette,101,18996,29107
2021-05-19,MO,Lafayette,76,19072,29107
2021-05-20,MO,Lafayette,105,19177,29107
2021-05-21,MO,Lafayette,73,19250,29107
2021-05-22,MO,Lafayette,47,19297,29107
2021-05-23,MO,Lafayette,17,19314,29107
2021-05-24,MO,Lafayette,64,19378,29107
2021-05-25,MO,Lafayette,79,19457,29107
2021-05-26,MO,Lafayette,50,19507,29107
2021-05-27,MO,Lafayette,45,19552,29107
2020-12-15,MO,Lawrence,2,2,29109
2020-12-16,MO,Lawrence,7,9,29109
2020-12-17,MO,Lawrence,11,20,29109
2020-12-18,MO,Lawrence,27,47,29109
2020-12-19,MO,Lawrence,2,49,29109
2020-12-20,MO,Lawrence,2,51,29109
2020-12-21,MO,Lawrence,22,73,29109
2020-12-22,MO,Lawrence,37,110,29109
2020-12-23,MO,Lawrence,36,146,29109
2020-12-24,MO,Lawrence,12,158,29109
2020-12-26,MO,Lawrence,5,163,29109
2020-12-27,MO,Lawrence,3,166,29109
2020-12-28,MO,Lawrence,43,209,29109
2020-12-29,MO,Lawrence,39,248,29109
2020-12-30,MO,Lawrence,32,280,29109
2020-12-31,MO,Lawrence,25,305,29109
2021-01-02,MO,Lawrence,1,306,29109
2021-01-03,MO,Lawrence,1,307,29109
2021-01-04,MO,Lawrence,13,320,29109
2021-01-05,MO,Lawrence,45,365,29109
2021-01-06,MO,Lawrence,15,380,29109
2021-01-07,MO,Lawrence,7,387,29109
2021-01-08,MO,Lawrence,34,421,29109
2021-01-09,MO,Lawrence,4,425,29109
2021-01-10,MO,Lawrence,7,432,29109
2021-01-11,MO,Lawrence,55,487,29109
2021-01-12,MO,Lawrence,20,507,29109
2021-01-13,MO,Lawrence,78,585,29109
2021-01-14,MO,Lawrence,39,624,29109
2021-01-15,MO,Lawrence,140,764,29109
2021-01-16,MO,Lawrence,7,771,29109
2021-01-17,MO,Lawrence,5,776,29109
2021-01-18,MO,Lawrence,22,798,29109
2021-01-19,MO,Lawrence,97,895,29109
2021-01-20,MO,Lawrence,83,978,29109
2021-01-21,MO,Lawrence,57,1035,29109
2021-01-22,MO,Lawrence,24,1059,29109
2021-01-23,MO,Lawrence,16,1075,29109
2021-01-24,MO,Lawrence,6,1081,29109
2021-01-25,MO,Lawrence,62,1143,29109
2021-01-26,MO,Lawrence,47,1190,29109
2021-01-27,MO,Lawrence,89,1279,29109
2021-01-28,MO,Lawrence,48,1327,29109
2021-01-29,MO,Lawrence,168,1495,29109
2021-01-30,MO,Lawrence,10,1505,29109
2021-01-31,MO,Lawrence,1,1506,29109
2021-02-01,MO,Lawrence,76,1582,29109
2021-02-02,MO,Lawrence,141,1723,29109
2021-02-03,MO,Lawrence,91,1814,29109
2021-02-04,MO,Lawrence,35,1849,29109
2021-02-05,MO,Lawrence,355,2204,29109
2021-02-06,MO,Lawrence,35,2239,29109
2021-02-07,MO,Lawrence,5,2244,29109
2021-02-08,MO,Lawrence,54,2298,29109
2021-02-09,MO,Lawrence,39,2337,29109
2021-02-10,MO,Lawrence,66,2403,29109
2021-02-11,MO,Lawrence,54,2457,29109
2021-02-12,MO,Lawrence,330,2787,29109
2021-02-13,MO,Lawrence,55,2842,29109
2021-02-14,MO,Lawrence,25,2867,29109
2021-02-15,MO,Lawrence,44,2911,29109
2021-02-16,MO,Lawrence,137,3048,29109
2021-02-17,MO,Lawrence,91,3139,29109
2021-02-18,MO,Lawrence,218,3357,29109
2021-02-19,MO,Lawrence,246,3603,29109
2021-02-20,MO,Lawrence,13,3616,29109
2021-02-21,MO,Lawrence,3,3619,29109
2021-02-22,MO,Lawrence,15,3634,29109
2021-02-23,MO,Lawrence,51,3685,29109
2021-02-24,MO,Lawrence,85,3770,29109
2021-02-25,MO,Lawrence,62,3832,29109
2021-02-26,MO,Lawrence,188,4020,29109
2021-02-27,MO,Lawrence,46,4066,29109
2021-02-28,MO,Lawrence,7,4073,29109
2021-03-01,MO,Lawrence,192,4265,29109
2021-03-02,MO,Lawrence,311,4576,29109
2021-03-03,MO,Lawrence,105,4681,29109
2021-03-04,MO,Lawrence,192,4873,29109
2021-03-05,MO,Lawrence,477,5350,29109
2021-03-06,MO,Lawrence,65,5415,29109
2021-03-07,MO,Lawrence,16,5431,29109
2021-03-08,MO,Lawrence,196,5627,29109
2021-03-09,MO,Lawrence,169,5796,29109
2021-03-10,MO,Lawrence,394,6190,29109
2021-03-11,MO,Lawrence,187,6377,29109
2021-03-12,MO,Lawrence,355,6732,29109
2021-03-13,MO,Lawrence,50,6782,29109
2021-03-14,MO,Lawrence,21,6803,29109
2021-03-15,MO,Lawrence,220,7023,29109
2021-03-16,MO,Lawrence,271,7294,29109
2021-03-17,MO,Lawrence,115,7409,29109
2021-03-18,MO,Lawrence,355,7764,29109
2021-03-19,MO,Lawrence,478,8242,29109
2021-03-20,MO,Lawrence,76,8318,29109
2021-03-21,MO,Lawrence,40,8358,29109
2021-03-22,MO,Lawrence,139,8497,29109
2021-03-23,MO,Lawrence,364,8861,29109
2021-03-24,MO,Lawrence,148,9009,29109
2021-03-25,MO,Lawrence,213,9222,29109
2021-03-26,MO,Lawrence,334,9556,29109
2021-03-27,MO,Lawrence,57,9613,29109
2021-03-28,MO,Lawrence,19,9632,29109
2021-03-29,MO,Lawrence,194,9826,29109
2021-03-30,MO,Lawrence,280,10106,29109
2021-03-31,MO,Lawrence,315,10421,29109
2021-04-01,MO,Lawrence,335,10756,29109
2021-04-02,MO,Lawrence,237,10993,29109
2021-04-03,MO,Lawrence,50,11043,29109
2021-04-04,MO,Lawrence,11,11054,29109
2021-04-05,MO,Lawrence,349,11403,29109
2021-04-06,MO,Lawrence,351,11754,29109
2021-04-07,MO,Lawrence,175,11929,29109
2021-04-08,MO,Lawrence,218,12147,29109
2021-04-09,MO,Lawrence,475,12622,29109
2021-04-10,MO,Lawrence,93,12715,29109
2021-04-11,MO,Lawrence,39,12754,29109
2021-04-12,MO,Lawrence,195,12949,29109
2021-04-13,MO,Lawrence,304,13253,29109
2021-04-14,MO,Lawrence,125,13378,29109
2021-04-15,MO,Lawrence,170,13548,29109
2021-04-16,MO,Lawrence,173,13721,29109
2021-04-17,MO,Lawrence,50,13771,29109
2021-04-18,MO,Lawrence,23,13794,29109
2021-04-19,MO,Lawrence,106,13900,29109
2021-04-20,MO,Lawrence,147,14047,29109
2021-04-21,MO,Lawrence,132,14179,29109
2021-04-22,MO,Lawrence,236,14415,29109
2021-04-23,MO,Lawrence,273,14688,29109
2021-04-24,MO,Lawrence,49,14737,29109
2021-04-25,MO,Lawrence,18,14755,29109
2021-04-26,MO,Lawrence,78,14833,29109
2021-04-27,MO,Lawrence,148,14981,29109
2021-04-28,MO,Lawrence,129,15110,29109
2021-04-29,MO,Lawrence,74,15184,29109
2021-04-30,MO,Lawrence,171,15355,29109
2021-05-01,MO,Lawrence,49,15404,29109
2021-05-02,MO,Lawrence,6,15410,29109
2021-05-03,MO,Lawrence,60,15470,29109
2021-05-04,MO,Lawrence,92,15562,29109
2021-05-05,MO,Lawrence,112,15674,29109
2021-05-06,MO,Lawrence,63,15737,29109
2021-05-07,MO,Lawrence,110,15847,29109
2021-05-08,MO,Lawrence,30,15877,29109
2021-05-09,MO,Lawrence,15,15892,29109
2021-05-10,MO,Lawrence,92,15984,29109
2021-05-11,MO,Lawrence,63,16047,29109
2021-05-12,MO,Lawrence,60,16107,29109
2021-05-13,MO,Lawrence,77,16184,29109
2021-05-14,MO,Lawrence,86,16270,29109
2021-05-15,MO,Lawrence,45,16315,29109
2021-05-16,MO,Lawrence,21,16336,29109
2021-05-17,MO,Lawrence,58,16394,29109
2021-05-18,MO,Lawrence,77,16471,29109
2021-05-19,MO,Lawrence,97,16568,29109
2021-05-20,MO,Lawrence,62,16630,29109
2021-05-21,MO,Lawrence,61,16691,29109
2021-05-22,MO,Lawrence,24,16715,29109
2021-05-23,MO,Lawrence,11,16726,29109
2021-05-24,MO,Lawrence,41,16767,29109
2021-05-25,MO,Lawrence,25,16792,29109
2021-05-26,MO,Lawrence,44,16836,29109
2021-05-27,MO,Lawrence,41,16877,29109
2020-12-14,MO,Lewis,1,1,29111
2020-12-16,MO,Lewis,1,2,29111
2020-12-18,MO,Lewis,1,3,29111
2020-12-19,MO,Lewis,1,4,29111
2020-12-21,MO,Lewis,2,6,29111
2020-12-22,MO,Lewis,2,8,29111
2020-12-23,MO,Lewis,7,15,29111
2020-12-28,MO,Lewis,8,23,29111
2020-12-29,MO,Lewis,12,35,29111
2020-12-30,MO,Lewis,7,42,29111
2020-12-31,MO,Lewis,1,43,29111
2021-01-05,MO,Lewis,8,51,29111
2021-01-06,MO,Lewis,38,89,29111
2021-01-07,MO,Lewis,2,91,29111
2021-01-08,MO,Lewis,1,92,29111
2021-01-09,MO,Lewis,1,93,29111
2021-01-11,MO,Lewis,1,94,29111
2021-01-12,MO,Lewis,7,101,29111
2021-01-13,MO,Lewis,5,106,29111
2021-01-14,MO,Lewis,5,111,29111
2021-01-15,MO,Lewis,2,113,29111
2021-01-16,MO,Lewis,1,114,29111
2021-01-17,MO,Lewis,1,115,29111
2021-01-18,MO,Lewis,37,152,29111
2021-01-19,MO,Lewis,52,204,29111
2021-01-20,MO,Lewis,247,451,29111
2021-01-21,MO,Lewis,81,532,29111
2021-01-22,MO,Lewis,101,633,29111
2021-01-24,MO,Lewis,1,634,29111
2021-01-26,MO,Lewis,2,636,29111
2021-01-27,MO,Lewis,5,641,29111
2021-01-28,MO,Lewis,4,645,29111
2021-01-29,MO,Lewis,136,781,29111
2021-02-01,MO,Lewis,5,786,29111
2021-02-02,MO,Lewis,11,797,29111
2021-02-03,MO,Lewis,53,850,29111
2021-02-04,MO,Lewis,51,901,29111
2021-02-05,MO,Lewis,25,926,29111
2021-02-06,MO,Lewis,2,928,29111
2021-02-08,MO,Lewis,54,982,29111
2021-02-09,MO,Lewis,49,1031,29111
2021-02-10,MO,Lewis,15,1046,29111
2021-02-11,MO,Lewis,40,1086,29111
2021-02-12,MO,Lewis,408,1494,29111
2021-02-13,MO,Lewis,1,1495,29111
2021-02-15,MO,Lewis,160,1655,29111
2021-02-16,MO,Lewis,149,1804,29111
2021-02-17,MO,Lewis,101,1905,29111
2021-02-18,MO,Lewis,10,1915,29111
2021-02-19,MO,Lewis,24,1939,29111
2021-02-21,MO,Lewis,1,1940,29111
2021-02-22,MO,Lewis,6,1946,29111
2021-02-23,MO,Lewis,88,2034,29111
2021-02-24,MO,Lewis,9,2043,29111
2021-02-25,MO,Lewis,22,2065,29111
2021-02-26,MO,Lewis,12,2077,29111
2021-02-27,MO,Lewis,1,2078,29111
2021-03-01,MO,Lewis,12,2090,29111
2021-03-02,MO,Lewis,64,2154,29111
2021-03-03,MO,Lewis,5,2159,29111
2021-03-04,MO,Lewis,60,2219,29111
2021-03-05,MO,Lewis,19,2238,29111
2021-03-06,MO,Lewis,3,2241,29111
2021-03-07,MO,Lewis,1,2242,29111
2021-03-08,MO,Lewis,4,2246,29111
2021-03-09,MO,Lewis,10,2256,29111
2021-03-10,MO,Lewis,22,2278,29111
2021-03-11,MO,Lewis,12,2290,29111
2021-03-12,MO,Lewis,291,2581,29111
2021-03-14,MO,Lewis,1,2582,29111
2021-03-15,MO,Lewis,144,2726,29111
2021-03-16,MO,Lewis,41,2767,29111
2021-03-17,MO,Lewis,7,2774,29111
2021-03-18,MO,Lewis,63,2837,29111
2021-03-19,MO,Lewis,18,2855,29111
2021-03-21,MO,Lewis,1,2856,29111
2021-03-22,MO,Lewis,10,2866,29111
2021-03-23,MO,Lewis,54,2920,29111
2021-03-24,MO,Lewis,15,2935,29111
2021-03-25,MO,Lewis,18,2953,29111
2021-03-26,MO,Lewis,8,2961,29111
2021-03-27,MO,Lewis,1,2962,29111
2021-03-28,MO,Lewis,2,2964,29111
2021-03-29,MO,Lewis,27,2991,29111
2021-03-30,MO,Lewis,21,3012,29111
2021-03-31,MO,Lewis,5,3017,29111
2021-04-01,MO,Lewis,46,3063,29111
2021-04-02,MO,Lewis,12,3075,29111
2021-04-05,MO,Lewis,6,3081,29111
2021-04-06,MO,Lewis,6,3087,29111
2021-04-07,MO,Lewis,24,3111,29111
2021-04-08,MO,Lewis,24,3135,29111
2021-04-09,MO,Lewis,37,3172,29111
2021-04-10,MO,Lewis,3,3175,29111
2021-04-11,MO,Lewis,1,3176,29111
2021-04-12,MO,Lewis,183,3359,29111
2021-04-13,MO,Lewis,25,3384,29111
2021-04-14,MO,Lewis,27,3411,29111
2021-04-15,MO,Lewis,44,3455,29111
2021-04-16,MO,Lewis,19,3474,29111
2021-04-17,MO,Lewis,1,3475,29111
2021-04-18,MO,Lewis,3,3478,29111
2021-04-19,MO,Lewis,3,3481,29111
2021-04-20,MO,Lewis,15,3496,29111
2021-04-21,MO,Lewis,4,3500,29111
2021-04-22,MO,Lewis,53,3553,29111
2021-04-23,MO,Lewis,7,3560,29111
2021-04-26,MO,Lewis,6,3566,29111
2021-04-27,MO,Lewis,6,3572,29111
2021-04-28,MO,Lewis,15,3587,29111
2021-04-29,MO,Lewis,54,3641,29111
2021-04-30,MO,Lewis,28,3669,29111
2021-05-01,MO,Lewis,1,3670,29111
2021-05-02,MO,Lewis,1,3671,29111
2021-05-03,MO,Lewis,2,3673,29111
2021-05-04,MO,Lewis,12,3685,29111
2021-05-05,MO,Lewis,3,3688,29111
2021-05-06,MO,Lewis,5,3693,29111
2021-05-07,MO,Lewis,9,3702,29111
2021-05-08,MO,Lewis,2,3704,29111
2021-05-10,MO,Lewis,1,3705,29111
2021-05-11,MO,Lewis,21,3726,29111
2021-05-12,MO,Lewis,47,3773,29111
2021-05-13,MO,Lewis,7,3780,29111
2021-05-14,MO,Lewis,47,3827,29111
2021-05-15,MO,Lewis,1,3828,29111
2021-05-16,MO,Lewis,1,3829,29111
2021-05-17,MO,Lewis,2,3831,29111
2021-05-18,MO,Lewis,11,3842,29111
2021-05-19,MO,Lewis,4,3846,29111
2021-05-20,MO,Lewis,1,3847,29111
2021-05-21,MO,Lewis,2,3849,29111
2021-05-22,MO,Lewis,1,3850,29111
2021-05-24,MO,Lewis,1,3851,29111
2021-05-25,MO,Lewis,4,3855,29111
2021-05-26,MO,Lewis,1,3856,29111
2021-05-27,MO,Lewis,3,3859,29111
2020-12-16,MO,Lincoln,8,8,29113
2020-12-17,MO,Lincoln,70,78,29113
2020-12-18,MO,Lincoln,54,132,29113
2020-12-19,MO,Lincoln,11,143,29113
2020-12-21,MO,Lincoln,32,175,29113
2020-12-22,MO,Lincoln,66,241,29113
2020-12-23,MO,Lincoln,37,278,29113
2020-12-24,MO,Lincoln,12,290,29113
2020-12-26,MO,Lincoln,10,300,29113
2020-12-27,MO,Lincoln,10,310,29113
2020-12-28,MO,Lincoln,49,359,29113
2020-12-29,MO,Lincoln,34,393,29113
2020-12-30,MO,Lincoln,41,434,29113
2020-12-31,MO,Lincoln,13,447,29113
2021-01-01,MO,Lincoln,2,449,29113
2021-01-02,MO,Lincoln,1,450,29113
2021-01-03,MO,Lincoln,9,459,29113
2021-01-04,MO,Lincoln,29,488,29113
2021-01-05,MO,Lincoln,43,531,29113
2021-01-06,MO,Lincoln,61,592,29113
2021-01-07,MO,Lincoln,84,676,29113
2021-01-08,MO,Lincoln,79,755,29113
2021-01-09,MO,Lincoln,20,775,29113
2021-01-10,MO,Lincoln,4,779,29113
2021-01-11,MO,Lincoln,107,886,29113
2021-01-12,MO,Lincoln,49,935,29113
2021-01-13,MO,Lincoln,36,971,29113
2021-01-14,MO,Lincoln,41,1012,29113
2021-01-15,MO,Lincoln,154,1166,29113
2021-01-16,MO,Lincoln,48,1214,29113
2021-01-17,MO,Lincoln,4,1218,29113
2021-01-18,MO,Lincoln,117,1335,29113
2021-01-19,MO,Lincoln,74,1409,29113
2021-01-20,MO,Lincoln,139,1548,29113
2021-01-21,MO,Lincoln,188,1736,29113
2021-01-22,MO,Lincoln,169,1905,29113
2021-01-23,MO,Lincoln,25,1930,29113
2021-01-24,MO,Lincoln,5,1935,29113
2021-01-25,MO,Lincoln,103,2038,29113
2021-01-26,MO,Lincoln,180,2218,29113
2021-01-27,MO,Lincoln,101,2319,29113
2021-01-28,MO,Lincoln,98,2417,29113
2021-01-29,MO,Lincoln,258,2675,29113
2021-01-30,MO,Lincoln,37,2712,29113
2021-01-31,MO,Lincoln,9,2721,29113
2021-02-01,MO,Lincoln,100,2821,29113
2021-02-02,MO,Lincoln,102,2923,29113
2021-02-03,MO,Lincoln,77,3000,29113
2021-02-04,MO,Lincoln,108,3108,29113
2021-02-05,MO,Lincoln,90,3198,29113
2021-02-06,MO,Lincoln,36,3234,29113
2021-02-07,MO,Lincoln,5,3239,29113
2021-02-08,MO,Lincoln,150,3389,29113
2021-02-09,MO,Lincoln,124,3513,29113
2021-02-10,MO,Lincoln,77,3590,29113
2021-02-11,MO,Lincoln,80,3670,29113
2021-02-12,MO,Lincoln,254,3924,29113
2021-02-13,MO,Lincoln,74,3998,29113
2021-02-14,MO,Lincoln,16,4014,29113
2021-02-15,MO,Lincoln,89,4103,29113
2021-02-16,MO,Lincoln,86,4189,29113
2021-02-17,MO,Lincoln,233,4422,29113
2021-02-18,MO,Lincoln,207,4629,29113
2021-02-19,MO,Lincoln,197,4826,29113
2021-02-20,MO,Lincoln,75,4901,29113
2021-02-21,MO,Lincoln,16,4917,29113
2021-02-22,MO,Lincoln,207,5124,29113
2021-02-23,MO,Lincoln,292,5416,29113
2021-02-24,MO,Lincoln,128,5544,29113
2021-02-25,MO,Lincoln,373,5917,29113
2021-02-26,MO,Lincoln,403,6320,29113
2021-02-27,MO,Lincoln,72,6392,29113
2021-02-28,MO,Lincoln,30,6422,29113
2021-03-01,MO,Lincoln,219,6641,29113
2021-03-02,MO,Lincoln,179,6820,29113
2021-03-03,MO,Lincoln,74,6894,29113
2021-03-04,MO,Lincoln,125,7019,29113
2021-03-05,MO,Lincoln,440,7459,29113
2021-03-06,MO,Lincoln,59,7518,29113
2021-03-07,MO,Lincoln,24,7542,29113
2021-03-08,MO,Lincoln,200,7742,29113
2021-03-09,MO,Lincoln,171,7913,29113
2021-03-10,MO,Lincoln,411,8324,29113
2021-03-11,MO,Lincoln,170,8494,29113
2021-03-12,MO,Lincoln,164,8658,29113
2021-03-13,MO,Lincoln,80,8738,29113
2021-03-14,MO,Lincoln,25,8763,29113
2021-03-15,MO,Lincoln,195,8958,29113
2021-03-16,MO,Lincoln,149,9107,29113
2021-03-17,MO,Lincoln,614,9721,29113
2021-03-18,MO,Lincoln,319,10040,29113
2021-03-19,MO,Lincoln,403,10443,29113
2021-03-20,MO,Lincoln,122,10565,29113
2021-03-21,MO,Lincoln,49,10614,29113
2021-03-22,MO,Lincoln,204,10818,29113
2021-03-23,MO,Lincoln,208,11026,29113
2021-03-24,MO,Lincoln,380,11406,29113
2021-03-25,MO,Lincoln,445,11851,29113
2021-03-26,MO,Lincoln,504,12355,29113
2021-03-27,MO,Lincoln,106,12461,29113
2021-03-28,MO,Lincoln,42,12503,29113
2021-03-29,MO,Lincoln,242,12745,29113
2021-03-30,MO,Lincoln,227,12972,29113
2021-03-31,MO,Lincoln,536,13508,29113
2021-04-01,MO,Lincoln,311,13819,29113
2021-04-02,MO,Lincoln,476,14295,29113
2021-04-03,MO,Lincoln,97,14392,29113
2021-04-04,MO,Lincoln,16,14408,29113
2021-04-05,MO,Lincoln,285,14693,29113
2021-04-06,MO,Lincoln,230,14923,29113
2021-04-07,MO,Lincoln,552,15475,29113
2021-04-08,MO,Lincoln,546,16021,29113
2021-04-09,MO,Lincoln,479,16500,29113
2021-04-10,MO,Lincoln,150,16650,29113
2021-04-11,MO,Lincoln,43,16693,29113
2021-04-12,MO,Lincoln,385,17078,29113
2021-04-13,MO,Lincoln,205,17283,29113
2021-04-14,MO,Lincoln,773,18056,29113
2021-04-15,MO,Lincoln,269,18325,29113
2021-04-16,MO,Lincoln,839,19164,29113
2021-04-17,MO,Lincoln,173,19337,29113
2021-04-18,MO,Lincoln,63,19400,29113
2021-04-19,MO,Lincoln,309,19709,29113
2021-04-20,MO,Lincoln,267,19976,29113
2021-04-21,MO,Lincoln,240,20216,29113
2021-04-22,MO,Lincoln,281,20497,29113
2021-04-23,MO,Lincoln,509,21006,29113
2021-04-24,MO,Lincoln,130,21136,29113
2021-04-25,MO,Lincoln,44,21180,29113
2021-04-26,MO,Lincoln,294,21474,29113
2021-04-27,MO,Lincoln,210,21684,29113
2021-04-28,MO,Lincoln,567,22251,29113
2021-04-29,MO,Lincoln,188,22439,29113
2021-04-30,MO,Lincoln,171,22610,29113
2021-05-01,MO,Lincoln,126,22736,29113
2021-05-02,MO,Lincoln,45,22781,29113
2021-05-03,MO,Lincoln,253,23034,29113
2021-05-04,MO,Lincoln,141,23175,29113
2021-05-05,MO,Lincoln,470,23645,29113
2021-05-06,MO,Lincoln,164,23809,29113
2021-05-07,MO,Lincoln,263,24072,29113
2021-05-08,MO,Lincoln,112,24184,29113
2021-05-09,MO,Lincoln,50,24234,29113
2021-05-10,MO,Lincoln,259,24493,29113
2021-05-11,MO,Lincoln,121,24614,29113
2021-05-12,MO,Lincoln,155,24769,29113
2021-05-13,MO,Lincoln,155,24924,29113
2021-05-14,MO,Lincoln,500,25424,29113
2021-05-15,MO,Lincoln,143,25567,29113
2021-05-16,MO,Lincoln,43,25610,29113
2021-05-17,MO,Lincoln,241,25851,29113
2021-05-18,MO,Lincoln,152,26003,29113
2021-05-19,MO,Lincoln,214,26217,29113
2021-05-20,MO,Lincoln,113,26330,29113
2021-05-21,MO,Lincoln,134,26464,29113
2021-05-22,MO,Lincoln,104,26568,29113
2021-05-23,MO,Lincoln,42,26610,29113
2021-05-24,MO,Lincoln,215,26825,29113
2021-05-25,MO,Lincoln,116,26941,29113
2021-05-26,MO,Lincoln,69,27010,29113
2021-05-27,MO,Lincoln,35,27045,29113
2020-12-15,MO,Linn,1,1,29115
2020-12-18,MO,Linn,2,3,29115
2020-12-19,MO,Linn,3,6,29115
2020-12-20,MO,Linn,1,7,29115
2020-12-21,MO,Linn,5,12,29115
2020-12-22,MO,Linn,3,15,29115
2020-12-23,MO,Linn,4,19,29115
2020-12-27,MO,Linn,1,20,29115
2020-12-28,MO,Linn,9,29,29115
2020-12-29,MO,Linn,4,33,29115
2020-12-30,MO,Linn,8,41,29115
2020-12-31,MO,Linn,4,45,29115
2021-01-02,MO,Linn,1,46,29115
2021-01-04,MO,Linn,6,52,29115
2021-01-05,MO,Linn,93,145,29115
2021-01-06,MO,Linn,45,190,29115
2021-01-07,MO,Linn,3,193,29115
2021-01-08,MO,Linn,7,200,29115
2021-01-09,MO,Linn,2,202,29115
2021-01-10,MO,Linn,2,204,29115
2021-01-11,MO,Linn,8,212,29115
2021-01-12,MO,Linn,38,250,29115
2021-01-13,MO,Linn,9,259,29115
2021-01-14,MO,Linn,5,264,29115
2021-01-15,MO,Linn,16,280,29115
2021-01-16,MO,Linn,1,281,29115
2021-01-18,MO,Linn,21,302,29115
2021-01-19,MO,Linn,2,304,29115
2021-01-20,MO,Linn,21,325,29115
2021-01-21,MO,Linn,132,457,29115
2021-01-22,MO,Linn,30,487,29115
2021-01-23,MO,Linn,1,488,29115
2021-01-25,MO,Linn,10,498,29115
2021-01-26,MO,Linn,7,505,29115
2021-01-27,MO,Linn,48,553,29115
2021-01-28,MO,Linn,16,569,29115
2021-01-29,MO,Linn,162,731,29115
2021-01-30,MO,Linn,478,1209,29115
2021-01-31,MO,Linn,4,1213,29115
2021-02-01,MO,Linn,173,1386,29115
2021-02-02,MO,Linn,233,1619,29115
2021-02-03,MO,Linn,128,1747,29115
2021-02-04,MO,Linn,77,1824,29115
2021-02-05,MO,Linn,36,1860,29115
2021-02-06,MO,Linn,10,1870,29115
2021-02-08,MO,Linn,4,1874,29115
2021-02-09,MO,Linn,144,2018,29115
2021-02-10,MO,Linn,91,2109,29115
2021-02-11,MO,Linn,154,2263,29115
2021-02-12,MO,Linn,94,2357,29115
2021-02-13,MO,Linn,24,2381,29115
2021-02-14,MO,Linn,4,2385,29115
2021-02-15,MO,Linn,29,2414,29115
2021-02-16,MO,Linn,42,2456,29115
2021-02-17,MO,Linn,20,2476,29115
2021-02-18,MO,Linn,32,2508,29115
2021-02-19,MO,Linn,157,2665,29115
2021-02-20,MO,Linn,484,3149,29115
2021-02-21,MO,Linn,1,3150,29115
2021-02-22,MO,Linn,152,3302,29115
2021-02-23,MO,Linn,172,3474,29115
2021-02-24,MO,Linn,138,3612,29115
2021-02-25,MO,Linn,47,3659,29115
2021-02-26,MO,Linn,37,3696,29115
2021-02-27,MO,Linn,20,3716,29115
2021-02-28,MO,Linn,1,3717,29115
2021-03-01,MO,Linn,56,3773,29115
2021-03-02,MO,Linn,86,3859,29115
2021-03-03,MO,Linn,59,3918,29115
2021-03-04,MO,Linn,50,3968,29115
2021-03-05,MO,Linn,24,3992,29115
2021-03-06,MO,Linn,9,4001,29115
2021-03-07,MO,Linn,1,4002,29115
2021-03-08,MO,Linn,18,4020,29115
2021-03-09,MO,Linn,174,4194,29115
2021-03-10,MO,Linn,51,4245,29115
2021-03-11,MO,Linn,115,4360,29115
2021-03-12,MO,Linn,185,4545,29115
2021-03-13,MO,Linn,14,4559,29115
2021-03-14,MO,Linn,3,4562,29115
2021-03-15,MO,Linn,31,4593,29115
2021-03-16,MO,Linn,92,4685,29115
2021-03-17,MO,Linn,94,4779,29115
2021-03-18,MO,Linn,74,4853,29115
2021-03-19,MO,Linn,89,4942,29115
2021-03-20,MO,Linn,22,4964,29115
2021-03-21,MO,Linn,4,4968,29115
2021-03-22,MO,Linn,21,4989,29115
2021-03-23,MO,Linn,57,5046,29115
2021-03-24,MO,Linn,66,5112,29115
2021-03-25,MO,Linn,61,5173,29115
2021-03-26,MO,Linn,61,5234,29115
2021-03-27,MO,Linn,13,5247,29115
2021-03-28,MO,Linn,3,5250,29115
2021-03-29,MO,Linn,114,5364,29115
2021-03-30,MO,Linn,59,5423,29115
2021-03-31,MO,Linn,79,5502,29115
2021-04-01,MO,Linn,30,5532,29115
2021-04-02,MO,Linn,50,5582,29115
2021-04-03,MO,Linn,13,5595,29115
2021-04-04,MO,Linn,1,5596,29115
2021-04-05,MO,Linn,23,5619,29115
2021-04-06,MO,Linn,74,5693,29115
2021-04-07,MO,Linn,69,5762,29115
2021-04-08,MO,Linn,35,5797,29115
2021-04-09,MO,Linn,157,5954,29115
2021-04-10,MO,Linn,15,5969,29115
2021-04-11,MO,Linn,9,5978,29115
2021-04-12,MO,Linn,63,6041,29115
2021-04-13,MO,Linn,46,6087,29115
2021-04-14,MO,Linn,90,6177,29115
2021-04-15,MO,Linn,95,6272,29115
2021-04-16,MO,Linn,69,6341,29115
2021-04-17,MO,Linn,8,6349,29115
2021-04-18,MO,Linn,6,6355,29115
2021-04-19,MO,Linn,19,6374,29115
2021-04-20,MO,Linn,23,6397,29115
2021-04-21,MO,Linn,82,6479,29115
2021-04-22,MO,Linn,26,6505,29115
2021-04-23,MO,Linn,33,6538,29115
2021-04-24,MO,Linn,12,6550,29115
2021-04-26,MO,Linn,77,6627,29115
2021-04-27,MO,Linn,36,6663,29115
2021-04-28,MO,Linn,87,6750,29115
2021-04-29,MO,Linn,21,6771,29115
2021-04-30,MO,Linn,26,6797,29115
2021-05-01,MO,Linn,9,6806,29115
2021-05-02,MO,Linn,1,6807,29115
2021-05-03,MO,Linn,52,6859,29115
2021-05-04,MO,Linn,6,6865,29115
2021-05-05,MO,Linn,55,6920,29115
2021-05-06,MO,Linn,26,6946,29115
2021-05-07,MO,Linn,37,6983,29115
2021-05-08,MO,Linn,9,6992,29115
2021-05-09,MO,Linn,5,6997,29115
2021-05-10,MO,Linn,12,7009,29115
2021-05-11,MO,Linn,24,7033,29115
2021-05-12,MO,Linn,51,7084,29115
2021-05-13,MO,Linn,12,7096,29115
2021-05-14,MO,Linn,15,7111,29115
2021-05-15,MO,Linn,12,7123,29115
2021-05-16,MO,Linn,5,7128,29115
2021-05-17,MO,Linn,29,7157,29115
2021-05-18,MO,Linn,16,7173,29115
2021-05-19,MO,Linn,46,7219,29115
2021-05-20,MO,Linn,15,7234,29115
2021-05-21,MO,Linn,30,7264,29115
2021-05-22,MO,Linn,15,7279,29115
2021-05-24,MO,Linn,15,7294,29115
2021-05-25,MO,Linn,26,7320,29115
2021-05-26,MO,Linn,25,7345,29115
2021-05-27,MO,Linn,21,7366,29115
2020-12-17,MO,Livingston,4,4,29117
2020-12-18,MO,Livingston,5,9,29117
2020-12-22,MO,Livingston,2,11,29117
2020-12-23,MO,Livingston,3,14,29117
2020-12-28,MO,Livingston,25,39,29117
2020-12-29,MO,Livingston,16,55,29117
2020-12-30,MO,Livingston,29,84,29117
2020-12-31,MO,Livingston,25,109,29117
2021-01-02,MO,Livingston,3,112,29117
2021-01-03,MO,Livingston,2,114,29117
2021-01-04,MO,Livingston,12,126,29117
2021-01-05,MO,Livingston,6,132,29117
2021-01-06,MO,Livingston,23,155,29117
2021-01-07,MO,Livingston,3,158,29117
2021-01-08,MO,Livingston,53,211,29117
2021-01-09,MO,Livingston,57,268,29117
2021-01-10,MO,Livingston,1,269,29117
2021-01-11,MO,Livingston,23,292,29117
2021-01-12,MO,Livingston,25,317,29117
2021-01-13,MO,Livingston,84,401,29117
2021-01-14,MO,Livingston,12,413,29117
2021-01-15,MO,Livingston,97,510,29117
2021-01-16,MO,Livingston,7,517,29117
2021-01-18,MO,Livingston,48,565,29117
2021-01-19,MO,Livingston,39,604,29117
2021-01-20,MO,Livingston,56,660,29117
2021-01-21,MO,Livingston,14,674,29117
2021-01-22,MO,Livingston,52,726,29117
2021-01-25,MO,Livingston,40,766,29117
2021-01-26,MO,Livingston,7,773,29117
2021-01-27,MO,Livingston,36,809,29117
2021-01-28,MO,Livingston,28,837,29117
2021-01-29,MO,Livingston,70,907,29117
2021-01-30,MO,Livingston,5,912,29117
2021-01-31,MO,Livingston,6,918,29117
2021-02-01,MO,Livingston,86,1004,29117
2021-02-02,MO,Livingston,263,1267,29117
2021-02-03,MO,Livingston,50,1317,29117
2021-02-04,MO,Livingston,332,1649,29117
2021-02-05,MO,Livingston,240,1889,29117
2021-02-06,MO,Livingston,2,1891,29117
2021-02-07,MO,Livingston,1,1892,29117
2021-02-08,MO,Livingston,111,2003,29117
2021-02-09,MO,Livingston,146,2149,29117
2021-02-10,MO,Livingston,27,2176,29117
2021-02-11,MO,Livingston,75,2251,29117
2021-02-12,MO,Livingston,120,2371,29117
2021-02-13,MO,Livingston,94,2465,29117
2021-02-14,MO,Livingston,9,2474,29117
2021-02-15,MO,Livingston,11,2485,29117
2021-02-16,MO,Livingston,19,2504,29117
2021-02-17,MO,Livingston,65,2569,29117
2021-02-18,MO,Livingston,225,2794,29117
2021-02-19,MO,Livingston,30,2824,29117
2021-02-20,MO,Livingston,7,2831,29117
2021-02-21,MO,Livingston,6,2837,29117
2021-02-22,MO,Livingston,67,2904,29117
2021-02-23,MO,Livingston,255,3159,29117
2021-02-24,MO,Livingston,107,3266,29117
2021-02-25,MO,Livingston,364,3630,29117
2021-02-26,MO,Livingston,275,3905,29117
2021-02-27,MO,Livingston,32,3937,29117
2021-02-28,MO,Livingston,2,3939,29117
2021-03-01,MO,Livingston,33,3972,29117
2021-03-02,MO,Livingston,133,4105,29117
2021-03-03,MO,Livingston,198,4303,29117
2021-03-04,MO,Livingston,116,4419,29117
2021-03-05,MO,Livingston,164,4583,29117
2021-03-06,MO,Livingston,27,4610,29117
2021-03-07,MO,Livingston,2,4612,29117
2021-03-08,MO,Livingston,94,4706,29117
2021-03-09,MO,Livingston,207,4913,29117
2021-03-10,MO,Livingston,26,4939,29117
2021-03-11,MO,Livingston,56,4995,29117
2021-03-12,MO,Livingston,124,5119,29117
2021-03-13,MO,Livingston,53,5172,29117
2021-03-14,MO,Livingston,5,5177,29117
2021-03-15,MO,Livingston,62,5239,29117
2021-03-16,MO,Livingston,155,5394,29117
2021-03-17,MO,Livingston,107,5501,29117
2021-03-18,MO,Livingston,274,5775,29117
2021-03-19,MO,Livingston,142,5917,29117
2021-03-20,MO,Livingston,28,5945,29117
2021-03-21,MO,Livingston,3,5948,29117
2021-03-22,MO,Livingston,55,6003,29117
2021-03-23,MO,Livingston,102,6105,29117
2021-03-24,MO,Livingston,164,6269,29117
2021-03-25,MO,Livingston,92,6361,29117
2021-03-26,MO,Livingston,90,6451,29117
2021-03-27,MO,Livingston,35,6486,29117
2021-03-28,MO,Livingston,4,6490,29117
2021-03-29,MO,Livingston,55,6545,29117
2021-03-30,MO,Livingston,236,6781,29117
2021-03-31,MO,Livingston,31,6812,29117
2021-04-01,MO,Livingston,54,6866,29117
2021-04-02,MO,Livingston,61,6927,29117
2021-04-03,MO,Livingston,14,6941,29117
2021-04-04,MO,Livingston,3,6944,29117
2021-04-05,MO,Livingston,79,7023,29117
2021-04-06,MO,Livingston,72,7095,29117
2021-04-07,MO,Livingston,40,7135,29117
2021-04-08,MO,Livingston,35,7170,29117
2021-04-09,MO,Livingston,137,7307,29117
2021-04-10,MO,Livingston,7,7314,29117
2021-04-11,MO,Livingston,4,7318,29117
2021-04-12,MO,Livingston,95,7413,29117
2021-04-13,MO,Livingston,47,7460,29117
2021-04-14,MO,Livingston,33,7493,29117
2021-04-15,MO,Livingston,56,7549,29117
2021-04-16,MO,Livingston,80,7629,29117
2021-04-17,MO,Livingston,11,7640,29117
2021-04-18,MO,Livingston,1,7641,29117
2021-04-19,MO,Livingston,24,7665,29117
2021-04-20,MO,Livingston,99,7764,29117
2021-04-21,MO,Livingston,20,7784,29117
2021-04-22,MO,Livingston,318,8102,29117
2021-04-23,MO,Livingston,70,8172,29117
2021-04-24,MO,Livingston,26,8198,29117
2021-04-25,MO,Livingston,1,8199,29117
2021-04-26,MO,Livingston,25,8224,29117
2021-04-27,MO,Livingston,14,8238,29117
2021-04-28,MO,Livingston,35,8273,29117
2021-04-29,MO,Livingston,28,8301,29117
2021-04-30,MO,Livingston,47,8348,29117
2021-05-01,MO,Livingston,4,8352,29117
2021-05-02,MO,Livingston,4,8356,29117
2021-05-03,MO,Livingston,32,8388,29117
2021-05-04,MO,Livingston,23,8411,29117
2021-05-05,MO,Livingston,25,8436,29117
2021-05-06,MO,Livingston,93,8529,29117
2021-05-07,MO,Livingston,42,8571,29117
2021-05-08,MO,Livingston,13,8584,29117
2021-05-09,MO,Livingston,4,8588,29117
2021-05-10,MO,Livingston,88,8676,29117
2021-05-11,MO,Livingston,24,8700,29117
2021-05-12,MO,Livingston,15,8715,29117
2021-05-13,MO,Livingston,10,8725,29117
2021-05-14,MO,Livingston,34,8759,29117
2021-05-15,MO,Livingston,16,8775,29117
2021-05-16,MO,Livingston,3,8778,29117
2021-05-17,MO,Livingston,19,8797,29117
2021-05-18,MO,Livingston,22,8819,29117
2021-05-19,MO,Livingston,19,8838,29117
2021-05-20,MO,Livingston,315,9153,29117
2021-05-21,MO,Livingston,25,9178,29117
2021-05-22,MO,Livingston,6,9184,29117
2021-05-23,MO,Livingston,1,9185,29117
2021-05-24,MO,Livingston,14,9199,29117
2021-05-25,MO,Livingston,45,9244,29117
2021-05-26,MO,Livingston,15,9259,29117
2021-05-27,MO,Livingston,24,9283,29117
2020-12-18,MO,Macon,5,5,29121
2020-12-19,MO,Macon,1,6,29121
2020-12-21,MO,Macon,29,35,29121
2020-12-22,MO,Macon,5,40,29121
2020-12-23,MO,Macon,25,65,29121
2020-12-28,MO,Macon,5,70,29121
2020-12-29,MO,Macon,8,78,29121
2020-12-30,MO,Macon,7,85,29121
2020-12-31,MO,Macon,1,86,29121
2021-01-02,MO,Macon,1,87,29121
2021-01-03,MO,Macon,1,88,29121
2021-01-04,MO,Macon,44,132,29121
2021-01-05,MO,Macon,10,142,29121
2021-01-06,MO,Macon,7,149,29121
2021-01-07,MO,Macon,2,151,29121
2021-01-08,MO,Macon,46,197,29121
2021-01-09,MO,Macon,28,225,29121
2021-01-10,MO,Macon,5,230,29121
2021-01-11,MO,Macon,44,274,29121
2021-01-12,MO,Macon,9,283,29121
2021-01-13,MO,Macon,26,309,29121
2021-01-14,MO,Macon,19,328,29121
2021-01-15,MO,Macon,8,336,29121
2021-01-16,MO,Macon,1,337,29121
2021-01-18,MO,Macon,105,442,29121
2021-01-19,MO,Macon,12,454,29121
2021-01-20,MO,Macon,28,482,29121
2021-01-21,MO,Macon,49,531,29121
2021-01-22,MO,Macon,18,549,29121
2021-01-23,MO,Macon,4,553,29121
2021-01-24,MO,Macon,1,554,29121
2021-01-25,MO,Macon,106,660,29121
2021-01-26,MO,Macon,14,674,29121
2021-01-27,MO,Macon,45,719,29121
2021-01-28,MO,Macon,129,848,29121
2021-01-29,MO,Macon,46,894,29121
2021-01-30,MO,Macon,2,896,29121
2021-01-31,MO,Macon,1,897,29121
2021-02-01,MO,Macon,33,930,29121
2021-02-02,MO,Macon,103,1033,29121
2021-02-03,MO,Macon,12,1045,29121
2021-02-04,MO,Macon,374,1419,29121
2021-02-05,MO,Macon,70,1489,29121
2021-02-06,MO,Macon,39,1528,29121
2021-02-08,MO,Macon,22,1550,29121
2021-02-09,MO,Macon,126,1676,29121
2021-02-10,MO,Macon,43,1719,29121
2021-02-11,MO,Macon,111,1830,29121
2021-02-12,MO,Macon,83,1913,29121
2021-02-13,MO,Macon,21,1934,29121
2021-02-14,MO,Macon,7,1941,29121
2021-02-15,MO,Macon,128,2069,29121
2021-02-16,MO,Macon,49,2118,29121
2021-02-17,MO,Macon,20,2138,29121
2021-02-18,MO,Macon,133,2271,29121
2021-02-19,MO,Macon,32,2303,29121
2021-02-20,MO,Macon,4,2307,29121
2021-02-22,MO,Macon,101,2408,29121
2021-02-23,MO,Macon,19,2427,29121
2021-02-24,MO,Macon,326,2753,29121
2021-02-25,MO,Macon,510,3263,29121
2021-02-26,MO,Macon,24,3287,29121
2021-02-27,MO,Macon,9,3296,29121
2021-02-28,MO,Macon,2,3298,29121
2021-03-01,MO,Macon,34,3332,29121
2021-03-02,MO,Macon,129,3461,29121
2021-03-03,MO,Macon,96,3557,29121
2021-03-04,MO,Macon,272,3829,29121
2021-03-05,MO,Macon,34,3863,29121
2021-03-06,MO,Macon,19,3882,29121
2021-03-07,MO,Macon,1,3883,29121
2021-03-08,MO,Macon,27,3910,29121
2021-03-09,MO,Macon,139,4049,29121
2021-03-10,MO,Macon,47,4096,29121
2021-03-11,MO,Macon,164,4260,29121
2021-03-12,MO,Macon,56,4316,29121
2021-03-13,MO,Macon,19,4335,29121
2021-03-14,MO,Macon,7,4342,29121
2021-03-15,MO,Macon,54,4396,29121
2021-03-16,MO,Macon,83,4479,29121
2021-03-17,MO,Macon,85,4564,29121
2021-03-18,MO,Macon,189,4753,29121
2021-03-19,MO,Macon,55,4808,29121
2021-03-20,MO,Macon,14,4822,29121
2021-03-21,MO,Macon,4,4826,29121
2021-03-22,MO,Macon,15,4841,29121
2021-03-23,MO,Macon,26,4867,29121
2021-03-24,MO,Macon,42,4909,29121
2021-03-25,MO,Macon,446,5355,29121
2021-03-26,MO,Macon,39,5394,29121
2021-03-27,MO,Macon,11,5405,29121
2021-03-28,MO,Macon,2,5407,29121
2021-03-29,MO,Macon,40,5447,29121
2021-03-30,MO,Macon,54,5501,29121
2021-03-31,MO,Macon,139,5640,29121
2021-04-01,MO,Macon,303,5943,29121
2021-04-02,MO,Macon,47,5990,29121
2021-04-03,MO,Macon,8,5998,29121
2021-04-04,MO,Macon,2,6000,29121
2021-04-05,MO,Macon,42,6042,29121
2021-04-06,MO,Macon,82,6124,29121
2021-04-07,MO,Macon,78,6202,29121
2021-04-08,MO,Macon,146,6348,29121
2021-04-09,MO,Macon,89,6437,29121
2021-04-10,MO,Macon,16,6453,29121
2021-04-11,MO,Macon,6,6459,29121
2021-04-12,MO,Macon,32,6491,29121
2021-04-13,MO,Macon,50,6541,29121
2021-04-14,MO,Macon,109,6650,29121
2021-04-15,MO,Macon,147,6797,29121
2021-04-16,MO,Macon,48,6845,29121
2021-04-17,MO,Macon,13,6858,29121
2021-04-18,MO,Macon,3,6861,29121
2021-04-19,MO,Macon,15,6876,29121
2021-04-20,MO,Macon,37,6913,29121
2021-04-21,MO,Macon,38,6951,29121
2021-04-22,MO,Macon,61,7012,29121
2021-04-23,MO,Macon,42,7054,29121
2021-04-24,MO,Macon,8,7062,29121
2021-04-25,MO,Macon,3,7065,29121
2021-04-26,MO,Macon,20,7085,29121
2021-04-27,MO,Macon,43,7128,29121
2021-04-28,MO,Macon,29,7157,29121
2021-04-29,MO,Macon,26,7183,29121
2021-04-30,MO,Macon,23,7206,29121
2021-05-01,MO,Macon,5,7211,29121
2021-05-02,MO,Macon,9,7220,29121
2021-05-03,MO,Macon,21,7241,29121
2021-05-04,MO,Macon,44,7285,29121
2021-05-05,MO,Macon,19,7304,29121
2021-05-06,MO,Macon,56,7360,29121
2021-05-07,MO,Macon,30,7390,29121
2021-05-08,MO,Macon,8,7398,29121
2021-05-09,MO,Macon,6,7404,29121
2021-05-10,MO,Macon,10,7414,29121
2021-05-11,MO,Macon,26,7440,29121
2021-05-12,MO,Macon,79,7519,29121
2021-05-13,MO,Macon,58,7577,29121
2021-05-14,MO,Macon,12,7589,29121
2021-05-15,MO,Macon,6,7595,29121
2021-05-16,MO,Macon,3,7598,29121
2021-05-17,MO,Macon,18,7616,29121
2021-05-18,MO,Macon,29,7645,29121
2021-05-19,MO,Macon,22,7667,29121
2021-05-20,MO,Macon,56,7723,29121
2021-05-21,MO,Macon,19,7742,29121
2021-05-22,MO,Macon,11,7753,29121
2021-05-23,MO,Macon,2,7755,29121
2021-05-24,MO,Macon,13,7768,29121
2021-05-25,MO,Macon,31,7799,29121
2021-05-26,MO,Macon,27,7826,29121
2021-05-27,MO,Macon,13,7839,29121
2020-12-15,MO,Madison,1,1,29123
2020-12-17,MO,Madison,3,4,29123
2020-12-18,MO,Madison,5,9,29123
2020-12-19,MO,Madison,2,11,29123
2020-12-20,MO,Madison,1,12,29123
2020-12-21,MO,Madison,6,18,29123
2020-12-22,MO,Madison,7,25,29123
2020-12-23,MO,Madison,52,77,29123
2020-12-28,MO,Madison,4,81,29123
2020-12-29,MO,Madison,4,85,29123
2020-12-30,MO,Madison,17,102,29123
2020-12-31,MO,Madison,49,151,29123
2021-01-02,MO,Madison,3,154,29123
2021-01-04,MO,Madison,16,170,29123
2021-01-05,MO,Madison,6,176,29123
2021-01-06,MO,Madison,10,186,29123
2021-01-07,MO,Madison,8,194,29123
2021-01-08,MO,Madison,9,203,29123
2021-01-09,MO,Madison,9,212,29123
2021-01-11,MO,Madison,11,223,29123
2021-01-12,MO,Madison,8,231,29123
2021-01-13,MO,Madison,144,375,29123
2021-01-14,MO,Madison,16,391,29123
2021-01-15,MO,Madison,9,400,29123
2021-01-16,MO,Madison,1,401,29123
2021-01-17,MO,Madison,1,402,29123
2021-01-18,MO,Madison,10,412,29123
2021-01-19,MO,Madison,41,453,29123
2021-01-20,MO,Madison,74,527,29123
2021-01-21,MO,Madison,46,573,29123
2021-01-22,MO,Madison,50,623,29123
2021-01-23,MO,Madison,7,630,29123
2021-01-24,MO,Madison,1,631,29123
2021-01-25,MO,Madison,41,672,29123
2021-01-26,MO,Madison,20,692,29123
2021-01-27,MO,Madison,11,703,29123
2021-01-28,MO,Madison,87,790,29123
2021-01-29,MO,Madison,100,890,29123
2021-01-30,MO,Madison,12,902,29123
2021-02-01,MO,Madison,25,927,29123
2021-02-02,MO,Madison,39,966,29123
2021-02-03,MO,Madison,96,1062,29123
2021-02-04,MO,Madison,120,1182,29123
2021-02-05,MO,Madison,47,1229,29123
2021-02-06,MO,Madison,8,1237,29123
2021-02-08,MO,Madison,59,1296,29123
2021-02-09,MO,Madison,49,1345,29123
2021-02-10,MO,Madison,164,1509,29123
2021-02-11,MO,Madison,22,1531,29123
2021-02-12,MO,Madison,52,1583,29123
2021-02-13,MO,Madison,18,1601,29123
2021-02-14,MO,Madison,7,1608,29123
2021-02-15,MO,Madison,10,1618,29123
2021-02-16,MO,Madison,14,1632,29123
2021-02-17,MO,Madison,34,1666,29123
2021-02-18,MO,Madison,19,1685,29123
2021-02-19,MO,Madison,111,1796,29123
2021-02-20,MO,Madison,9,1805,29123
2021-02-21,MO,Madison,1,1806,29123
2021-02-22,MO,Madison,33,1839,29123
2021-02-23,MO,Madison,22,1861,29123
2021-02-24,MO,Madison,88,1949,29123
2021-02-25,MO,Madison,75,2024,29123
2021-02-26,MO,Madison,99,2123,29123
2021-02-27,MO,Madison,27,2150,29123
2021-02-28,MO,Madison,3,2153,29123
2021-03-01,MO,Madison,21,2174,29123
2021-03-02,MO,Madison,45,2219,29123
2021-03-03,MO,Madison,107,2326,29123
2021-03-04,MO,Madison,138,2464,29123
2021-03-05,MO,Madison,214,2678,29123
2021-03-06,MO,Madison,4,2682,29123
2021-03-08,MO,Madison,15,2697,29123
2021-03-09,MO,Madison,63,2760,29123
2021-03-10,MO,Madison,87,2847,29123
2021-03-11,MO,Madison,34,2881,29123
2021-03-12,MO,Madison,51,2932,29123
2021-03-13,MO,Madison,25,2957,29123
2021-03-14,MO,Madison,11,2968,29123
2021-03-15,MO,Madison,32,3000,29123
2021-03-16,MO,Madison,55,3055,29123
2021-03-17,MO,Madison,130,3185,29123
2021-03-18,MO,Madison,73,3258,29123
2021-03-19,MO,Madison,38,3296,29123
2021-03-20,MO,Madison,8,3304,29123
2021-03-21,MO,Madison,1,3305,29123
2021-03-22,MO,Madison,34,3339,29123
2021-03-23,MO,Madison,27,3366,29123
2021-03-24,MO,Madison,58,3424,29123
2021-03-25,MO,Madison,65,3489,29123
2021-03-26,MO,Madison,34,3523,29123
2021-03-27,MO,Madison,19,3542,29123
2021-03-28,MO,Madison,2,3544,29123
2021-03-29,MO,Madison,23,3567,29123
2021-03-30,MO,Madison,48,3615,29123
2021-03-31,MO,Madison,69,3684,29123
2021-04-01,MO,Madison,95,3779,29123
2021-04-02,MO,Madison,184,3963,29123
2021-04-03,MO,Madison,5,3968,29123
2021-04-05,MO,Madison,22,3990,29123
2021-04-06,MO,Madison,53,4043,29123
2021-04-07,MO,Madison,67,4110,29123
2021-04-08,MO,Madison,59,4169,29123
2021-04-09,MO,Madison,53,4222,29123
2021-04-10,MO,Madison,27,4249,29123
2021-04-11,MO,Madison,3,4252,29123
2021-04-12,MO,Madison,15,4267,29123
2021-04-13,MO,Madison,41,4308,29123
2021-04-14,MO,Madison,110,4418,29123
2021-04-15,MO,Madison,53,4471,29123
2021-04-16,MO,Madison,65,4536,29123
2021-04-17,MO,Madison,15,4551,29123
2021-04-18,MO,Madison,5,4556,29123
2021-04-19,MO,Madison,37,4593,29123
2021-04-20,MO,Madison,17,4610,29123
2021-04-21,MO,Madison,63,4673,29123
2021-04-22,MO,Madison,58,4731,29123
2021-04-23,MO,Madison,66,4797,29123
2021-04-24,MO,Madison,15,4812,29123
2021-04-25,MO,Madison,1,4813,29123
2021-04-26,MO,Madison,23,4836,29123
2021-04-27,MO,Madison,22,4858,29123
2021-04-28,MO,Madison,63,4921,29123
2021-04-29,MO,Madison,59,4980,29123
2021-04-30,MO,Madison,49,5029,29123
2021-05-01,MO,Madison,10,5039,29123
2021-05-02,MO,Madison,2,5041,29123
2021-05-03,MO,Madison,16,5057,29123
2021-05-04,MO,Madison,9,5066,29123
2021-05-05,MO,Madison,65,5131,29123
2021-05-06,MO,Madison,24,5155,29123
2021-05-07,MO,Madison,48,5203,29123
2021-05-08,MO,Madison,11,5214,29123
2021-05-09,MO,Madison,7,5221,29123
2021-05-10,MO,Madison,12,5233,29123
2021-05-11,MO,Madison,31,5264,29123
2021-05-12,MO,Madison,23,5287,29123
2021-05-13,MO,Madison,51,5338,29123
2021-05-14,MO,Madison,37,5375,29123
2021-05-15,MO,Madison,13,5388,29123
2021-05-16,MO,Madison,6,5394,29123
2021-05-17,MO,Madison,31,5425,29123
2021-05-18,MO,Madison,27,5452,29123
2021-05-19,MO,Madison,26,5478,29123
2021-05-20,MO,Madison,22,5500,29123
2021-05-21,MO,Madison,25,5525,29123
2021-05-22,MO,Madison,9,5534,29123
2021-05-24,MO,Madison,18,5552,29123
2021-05-25,MO,Madison,16,5568,29123
2021-05-26,MO,Madison,21,5589,29123
2021-05-27,MO,Madison,48,5637,29123
2020-12-15,MO,Maries,2,2,29125
2020-12-16,MO,Maries,3,5,29125
2020-12-17,MO,Maries,3,8,29125
2020-12-18,MO,Maries,8,16,29125
2020-12-19,MO,Maries,1,17,29125
2020-12-20,MO,Maries,2,19,29125
2020-12-21,MO,Maries,4,23,29125
2020-12-22,MO,Maries,2,25,29125
2020-12-23,MO,Maries,2,27,29125
2020-12-26,MO,Maries,1,28,29125
2020-12-28,MO,Maries,2,30,29125
2020-12-29,MO,Maries,3,33,29125
2020-12-30,MO,Maries,10,43,29125
2020-12-31,MO,Maries,5,48,29125
2021-01-01,MO,Maries,3,51,29125
2021-01-02,MO,Maries,2,53,29125
2021-01-03,MO,Maries,1,54,29125
2021-01-04,MO,Maries,6,60,29125
2021-01-05,MO,Maries,6,66,29125
2021-01-06,MO,Maries,11,77,29125
2021-01-07,MO,Maries,17,94,29125
2021-01-08,MO,Maries,20,114,29125
2021-01-09,MO,Maries,1,115,29125
2021-01-10,MO,Maries,2,117,29125
2021-01-11,MO,Maries,12,129,29125
2021-01-12,MO,Maries,19,148,29125
2021-01-13,MO,Maries,20,168,29125
2021-01-14,MO,Maries,12,180,29125
2021-01-15,MO,Maries,9,189,29125
2021-01-16,MO,Maries,4,193,29125
2021-01-18,MO,Maries,60,253,29125
2021-01-19,MO,Maries,10,263,29125
2021-01-20,MO,Maries,11,274,29125
2021-01-21,MO,Maries,17,291,29125
2021-01-22,MO,Maries,40,331,29125
2021-01-23,MO,Maries,40,371,29125
2021-01-24,MO,Maries,3,374,29125
2021-01-25,MO,Maries,24,398,29125
2021-01-26,MO,Maries,24,422,29125
2021-01-27,MO,Maries,22,444,29125
2021-01-28,MO,Maries,20,464,29125
2021-01-29,MO,Maries,91,555,29125
2021-01-30,MO,Maries,134,689,29125
2021-01-31,MO,Maries,2,691,29125
2021-02-01,MO,Maries,21,712,29125
2021-02-02,MO,Maries,14,726,29125
2021-02-03,MO,Maries,23,749,29125
2021-02-04,MO,Maries,62,811,29125
2021-02-05,MO,Maries,47,858,29125
2021-02-06,MO,Maries,25,883,29125
2021-02-08,MO,Maries,169,1052,29125
2021-02-09,MO,Maries,24,1076,29125
2021-02-10,MO,Maries,48,1124,29125
2021-02-11,MO,Maries,37,1161,29125
2021-02-12,MO,Maries,65,1226,29125
2021-02-13,MO,Maries,52,1278,29125
2021-02-15,MO,Maries,25,1303,29125
2021-02-16,MO,Maries,18,1321,29125
2021-02-17,MO,Maries,57,1378,29125
2021-02-18,MO,Maries,30,1408,29125
2021-02-19,MO,Maries,54,1462,29125
2021-02-20,MO,Maries,7,1469,29125
2021-02-22,MO,Maries,33,1502,29125
2021-02-23,MO,Maries,13,1515,29125
2021-02-24,MO,Maries,20,1535,29125
2021-02-25,MO,Maries,25,1560,29125
2021-02-26,MO,Maries,104,1664,29125
2021-02-27,MO,Maries,129,1793,29125
2021-02-28,MO,Maries,6,1799,29125
2021-03-01,MO,Maries,52,1851,29125
2021-03-02,MO,Maries,22,1873,29125
2021-03-03,MO,Maries,38,1911,29125
2021-03-04,MO,Maries,144,2055,29125
2021-03-05,MO,Maries,124,2179,29125
2021-03-06,MO,Maries,22,2201,29125
2021-03-07,MO,Maries,1,2202,29125
2021-03-08,MO,Maries,30,2232,29125
2021-03-09,MO,Maries,28,2260,29125
2021-03-10,MO,Maries,47,2307,29125
2021-03-11,MO,Maries,26,2333,29125
2021-03-12,MO,Maries,60,2393,29125
2021-03-13,MO,Maries,1,2394,29125
2021-03-14,MO,Maries,2,2396,29125
2021-03-15,MO,Maries,28,2424,29125
2021-03-16,MO,Maries,41,2465,29125
2021-03-17,MO,Maries,19,2484,29125
2021-03-18,MO,Maries,12,2496,29125
2021-03-19,MO,Maries,82,2578,29125
2021-03-20,MO,Maries,6,2584,29125
2021-03-22,MO,Maries,33,2617,29125
2021-03-23,MO,Maries,13,2630,29125
2021-03-24,MO,Maries,21,2651,29125
2021-03-25,MO,Maries,32,2683,29125
2021-03-26,MO,Maries,25,2708,29125
2021-03-27,MO,Maries,131,2839,29125
2021-03-29,MO,Maries,46,2885,29125
2021-03-30,MO,Maries,27,2912,29125
2021-03-31,MO,Maries,24,2936,29125
2021-04-01,MO,Maries,60,2996,29125
2021-04-02,MO,Maries,130,3126,29125
2021-04-03,MO,Maries,7,3133,29125
2021-04-04,MO,Maries,2,3135,29125
2021-04-05,MO,Maries,38,3173,29125
2021-04-06,MO,Maries,24,3197,29125
2021-04-07,MO,Maries,30,3227,29125
2021-04-08,MO,Maries,28,3255,29125
2021-04-09,MO,Maries,159,3414,29125
2021-04-10,MO,Maries,23,3437,29125
2021-04-11,MO,Maries,1,3438,29125
2021-04-12,MO,Maries,34,3472,29125
2021-04-13,MO,Maries,44,3516,29125
2021-04-14,MO,Maries,29,3545,29125
2021-04-15,MO,Maries,35,3580,29125
2021-04-16,MO,Maries,25,3605,29125
2021-04-17,MO,Maries,47,3652,29125
2021-04-19,MO,Maries,30,3682,29125
2021-04-20,MO,Maries,22,3704,29125
2021-04-21,MO,Maries,10,3714,29125
2021-04-22,MO,Maries,17,3731,29125
2021-04-23,MO,Maries,11,3742,29125
2021-04-24,MO,Maries,8,3750,29125
2021-04-26,MO,Maries,15,3765,29125
2021-04-27,MO,Maries,30,3795,29125
2021-04-28,MO,Maries,9,3804,29125
2021-04-29,MO,Maries,9,3813,29125
2021-04-30,MO,Maries,71,3884,29125
2021-05-01,MO,Maries,8,3892,29125
2021-05-03,MO,Maries,7,3899,29125
2021-05-04,MO,Maries,27,3926,29125
2021-05-05,MO,Maries,8,3934,29125
2021-05-06,MO,Maries,18,3952,29125
2021-05-07,MO,Maries,20,3972,29125
2021-05-08,MO,Maries,7,3979,29125
2021-05-09,MO,Maries,2,3981,29125
2021-05-10,MO,Maries,17,3998,29125
2021-05-11,MO,Maries,29,4027,29125
2021-05-12,MO,Maries,11,4038,29125
2021-05-13,MO,Maries,15,4053,29125
2021-05-14,MO,Maries,8,4061,29125
2021-05-15,MO,Maries,9,4070,29125
2021-05-16,MO,Maries,1,4071,29125
2021-05-17,MO,Maries,14,4085,29125
2021-05-18,MO,Maries,36,4121,29125
2021-05-19,MO,Maries,11,4132,29125
2021-05-20,MO,Maries,14,4146,29125
2021-05-21,MO,Maries,6,4152,29125
2021-05-22,MO,Maries,2,4154,29125
2021-05-23,MO,Maries,2,4156,29125
2021-05-24,MO,Maries,12,4168,29125
2021-05-25,MO,Maries,15,4183,29125
2021-05-26,MO,Maries,5,4188,29125
2021-05-27,MO,Maries,5,4193,29125
2020-12-14,MO,Marion,1,1,29127
2020-12-15,MO,Marion,1,2,29127
2020-12-16,MO,Marion,2,4,29127
2020-12-18,MO,Marion,3,7,29127
2020-12-19,MO,Marion,2,9,29127
2020-12-20,MO,Marion,1,10,29127
2020-12-21,MO,Marion,13,23,29127
2020-12-22,MO,Marion,5,28,29127
2020-12-23,MO,Marion,99,127,29127
2020-12-24,MO,Marion,1,128,29127
2020-12-27,MO,Marion,1,129,29127
2020-12-28,MO,Marion,120,249,29127
2020-12-29,MO,Marion,76,325,29127
2020-12-30,MO,Marion,96,421,29127
2020-12-31,MO,Marion,5,426,29127
2021-01-01,MO,Marion,3,429,29127
2021-01-02,MO,Marion,2,431,29127
2021-01-04,MO,Marion,5,436,29127
2021-01-05,MO,Marion,133,569,29127
2021-01-06,MO,Marion,14,583,29127
2021-01-07,MO,Marion,51,634,29127
2021-01-08,MO,Marion,72,706,29127
2021-01-09,MO,Marion,5,711,29127
2021-01-10,MO,Marion,2,713,29127
2021-01-11,MO,Marion,11,724,29127
2021-01-12,MO,Marion,101,825,29127
2021-01-13,MO,Marion,117,942,29127
2021-01-14,MO,Marion,118,1060,29127
2021-01-15,MO,Marion,3,1063,29127
2021-01-16,MO,Marion,2,1065,29127
2021-01-18,MO,Marion,549,1614,29127
2021-01-19,MO,Marion,420,2034,29127
2021-01-20,MO,Marion,816,2850,29127
2021-01-21,MO,Marion,407,3257,29127
2021-01-22,MO,Marion,296,3553,29127
2021-01-23,MO,Marion,4,3557,29127
2021-01-24,MO,Marion,1,3558,29127
2021-01-25,MO,Marion,5,3563,29127
2021-01-26,MO,Marion,54,3617,29127
2021-01-27,MO,Marion,11,3628,29127
2021-01-28,MO,Marion,9,3637,29127
2021-01-29,MO,Marion,80,3717,29127
2021-01-30,MO,Marion,5,3722,29127
2021-02-01,MO,Marion,27,3749,29127
2021-02-02,MO,Marion,338,4087,29127
2021-02-03,MO,Marion,12,4099,29127
2021-02-04,MO,Marion,389,4488,29127
2021-02-05,MO,Marion,159,4647,29127
2021-02-06,MO,Marion,6,4653,29127
2021-02-07,MO,Marion,2,4655,29127
2021-02-08,MO,Marion,445,5100,29127
2021-02-09,MO,Marion,415,5515,29127
2021-02-10,MO,Marion,13,5528,29127
2021-02-11,MO,Marion,334,5862,29127
2021-02-12,MO,Marion,536,6398,29127
2021-02-13,MO,Marion,4,6402,29127
2021-02-14,MO,Marion,5,6407,29127
2021-02-15,MO,Marion,392,6799,29127
2021-02-16,MO,Marion,441,7240,29127
2021-02-17,MO,Marion,91,7331,29127
2021-02-18,MO,Marion,70,7401,29127
2021-02-19,MO,Marion,90,7491,29127
2021-02-20,MO,Marion,7,7498,29127
2021-02-21,MO,Marion,3,7501,29127
2021-02-22,MO,Marion,181,7682,29127
2021-02-23,MO,Marion,20,7702,29127
2021-02-24,MO,Marion,8,7710,29127
2021-02-25,MO,Marion,262,7972,29127
2021-02-26,MO,Marion,141,8113,29127
2021-02-27,MO,Marion,4,8117,29127
2021-02-28,MO,Marion,5,8122,29127
2021-03-01,MO,Marion,22,8144,29127
2021-03-02,MO,Marion,355,8499,29127
2021-03-03,MO,Marion,8,8507,29127
2021-03-04,MO,Marion,427,8934,29127
2021-03-05,MO,Marion,257,9191,29127
2021-03-06,MO,Marion,5,9196,29127
2021-03-07,MO,Marion,11,9207,29127
2021-03-08,MO,Marion,47,9254,29127
2021-03-09,MO,Marion,61,9315,29127
2021-03-10,MO,Marion,22,9337,29127
2021-03-11,MO,Marion,47,9384,29127
2021-03-12,MO,Marion,72,9456,29127
2021-03-13,MO,Marion,6,9462,29127
2021-03-14,MO,Marion,1,9463,29127
2021-03-15,MO,Marion,331,9794,29127
2021-03-16,MO,Marion,551,10345,29127
2021-03-17,MO,Marion,63,10408,29127
2021-03-18,MO,Marion,447,10855,29127
2021-03-19,MO,Marion,61,10916,29127
2021-03-20,MO,Marion,8,10924,29127
2021-03-21,MO,Marion,3,10927,29127
2021-03-22,MO,Marion,217,11144,29127
2021-03-23,MO,Marion,40,11184,29127
2021-03-24,MO,Marion,232,11416,29127
2021-03-25,MO,Marion,248,11664,29127
2021-03-26,MO,Marion,48,11712,29127
2021-03-27,MO,Marion,7,11719,29127
2021-03-28,MO,Marion,10,11729,29127
2021-03-29,MO,Marion,37,11766,29127
2021-03-30,MO,Marion,256,12022,29127
2021-03-31,MO,Marion,33,12055,29127
2021-04-01,MO,Marion,299,12354,29127
2021-04-02,MO,Marion,264,12618,29127
2021-04-03,MO,Marion,4,12622,29127
2021-04-04,MO,Marion,4,12626,29127
2021-04-05,MO,Marion,14,12640,29127
2021-04-06,MO,Marion,45,12685,29127
2021-04-07,MO,Marion,125,12810,29127
2021-04-08,MO,Marion,424,13234,29127
2021-04-09,MO,Marion,382,13616,29127
2021-04-10,MO,Marion,11,13627,29127
2021-04-11,MO,Marion,3,13630,29127
2021-04-12,MO,Marion,78,13708,29127
2021-04-13,MO,Marion,525,14233,29127
2021-04-14,MO,Marion,256,14489,29127
2021-04-15,MO,Marion,40,14529,29127
2021-04-16,MO,Marion,60,14589,29127
2021-04-17,MO,Marion,6,14595,29127
2021-04-19,MO,Marion,36,14631,29127
2021-04-20,MO,Marion,113,14744,29127
2021-04-21,MO,Marion,21,14765,29127
2021-04-22,MO,Marion,262,15027,29127
2021-04-23,MO,Marion,35,15062,29127
2021-04-24,MO,Marion,5,15067,29127
2021-04-25,MO,Marion,2,15069,29127
2021-04-26,MO,Marion,15,15084,29127
2021-04-27,MO,Marion,109,15193,29127
2021-04-28,MO,Marion,110,15303,29127
2021-04-29,MO,Marion,46,15349,29127
2021-04-30,MO,Marion,364,15713,29127
2021-05-01,MO,Marion,4,15717,29127
2021-05-02,MO,Marion,5,15722,29127
2021-05-03,MO,Marion,21,15743,29127
2021-05-04,MO,Marion,119,15862,29127
2021-05-05,MO,Marion,33,15895,29127
2021-05-06,MO,Marion,51,15946,29127
2021-05-07,MO,Marion,59,16005,29127
2021-05-08,MO,Marion,6,16011,29127
2021-05-09,MO,Marion,5,16016,29127
2021-05-10,MO,Marion,16,16032,29127
2021-05-11,MO,Marion,123,16155,29127
2021-05-12,MO,Marion,24,16179,29127
2021-05-13,MO,Marion,16,16195,29127
2021-05-14,MO,Marion,17,16212,29127
2021-05-15,MO,Marion,13,16225,29127
2021-05-16,MO,Marion,8,16233,29127
2021-05-17,MO,Marion,23,16256,29127
2021-05-18,MO,Marion,149,16405,29127
2021-05-19,MO,Marion,46,16451,29127
2021-05-20,MO,Marion,30,16481,29127
2021-05-21,MO,Marion,30,16511,29127
2021-05-22,MO,Marion,7,16518,29127
2021-05-23,MO,Marion,8,16526,29127
2021-05-24,MO,Marion,13,16539,29127
2021-05-25,MO,Marion,18,16557,29127
2021-05-26,MO,Marion,34,16591,29127
2021-05-27,MO,Marion,19,16610,29127
2020-12-17,MO,McDonald,5,5,29119
2020-12-18,MO,McDonald,2,7,29119
2020-12-19,MO,McDonald,1,8,29119
2020-12-21,MO,McDonald,1,9,29119
2020-12-22,MO,McDonald,9,18,29119
2020-12-23,MO,McDonald,24,42,29119
2020-12-24,MO,McDonald,1,43,29119
2020-12-29,MO,McDonald,4,47,29119
2020-12-30,MO,McDonald,34,81,29119
2020-12-31,MO,McDonald,2,83,29119
2021-01-02,MO,McDonald,1,84,29119
2021-01-04,MO,McDonald,2,86,29119
2021-01-05,MO,McDonald,2,88,29119
2021-01-06,MO,McDonald,8,96,29119
2021-01-07,MO,McDonald,27,123,29119
2021-01-08,MO,McDonald,3,126,29119
2021-01-09,MO,McDonald,1,127,29119
2021-01-10,MO,McDonald,3,130,29119
2021-01-11,MO,McDonald,6,136,29119
2021-01-12,MO,McDonald,35,171,29119
2021-01-13,MO,McDonald,9,180,29119
2021-01-14,MO,McDonald,17,197,29119
2021-01-15,MO,McDonald,11,208,29119
2021-01-16,MO,McDonald,3,211,29119
2021-01-18,MO,McDonald,102,313,29119
2021-01-19,MO,McDonald,89,402,29119
2021-01-20,MO,McDonald,93,495,29119
2021-01-21,MO,McDonald,144,639,29119
2021-01-22,MO,McDonald,114,753,29119
2021-01-23,MO,McDonald,2,755,29119
2021-01-25,MO,McDonald,64,819,29119
2021-01-26,MO,McDonald,9,828,29119
2021-01-27,MO,McDonald,24,852,29119
2021-01-28,MO,McDonald,153,1005,29119
2021-01-29,MO,McDonald,32,1037,29119
2021-01-30,MO,McDonald,2,1039,29119
2021-02-01,MO,McDonald,9,1048,29119
2021-02-02,MO,McDonald,29,1077,29119
2021-02-03,MO,McDonald,14,1091,29119
2021-02-04,MO,McDonald,49,1140,29119
2021-02-05,MO,McDonald,32,1172,29119
2021-02-07,MO,McDonald,2,1174,29119
2021-02-08,MO,McDonald,122,1296,29119
2021-02-09,MO,McDonald,94,1390,29119
2021-02-10,MO,McDonald,8,1398,29119
2021-02-11,MO,McDonald,127,1525,29119
2021-02-12,MO,McDonald,160,1685,29119
2021-02-13,MO,McDonald,4,1689,29119
2021-02-14,MO,McDonald,1,1690,29119
2021-02-15,MO,McDonald,8,1698,29119
2021-02-16,MO,McDonald,8,1706,29119
2021-02-17,MO,McDonald,64,1770,29119
2021-02-18,MO,McDonald,79,1849,29119
2021-02-19,MO,McDonald,60,1909,29119
2021-02-22,MO,McDonald,2,1911,29119
2021-02-23,MO,McDonald,68,1979,29119
2021-02-24,MO,McDonald,35,2014,29119
2021-02-25,MO,McDonald,175,2189,29119
2021-02-26,MO,McDonald,39,2228,29119
2021-02-27,MO,McDonald,14,2242,29119
2021-02-28,MO,McDonald,1,2243,29119
2021-03-01,MO,McDonald,13,2256,29119
2021-03-02,MO,McDonald,31,2287,29119
2021-03-03,MO,McDonald,133,2420,29119
2021-03-04,MO,McDonald,64,2484,29119
2021-03-05,MO,McDonald,16,2500,29119
2021-03-06,MO,McDonald,1,2501,29119
2021-03-07,MO,McDonald,5,2506,29119
2021-03-08,MO,McDonald,36,2542,29119
2021-03-09,MO,McDonald,101,2643,29119
2021-03-10,MO,McDonald,6,2649,29119
2021-03-11,MO,McDonald,21,2670,29119
2021-03-12,MO,McDonald,49,2719,29119
2021-03-13,MO,McDonald,2,2721,29119
2021-03-15,MO,McDonald,108,2829,29119
2021-03-16,MO,McDonald,31,2860,29119
2021-03-17,MO,McDonald,36,2896,29119
2021-03-18,MO,McDonald,39,2935,29119
2021-03-19,MO,McDonald,143,3078,29119
2021-03-20,MO,McDonald,12,3090,29119
2021-03-21,MO,McDonald,3,3093,29119
2021-03-22,MO,McDonald,38,3131,29119
2021-03-23,MO,McDonald,170,3301,29119
2021-03-24,MO,McDonald,133,3434,29119
2021-03-25,MO,McDonald,60,3494,29119
2021-03-26,MO,McDonald,75,3569,29119
2021-03-27,MO,McDonald,16,3585,29119
2021-03-28,MO,McDonald,3,3588,29119
2021-03-29,MO,McDonald,38,3626,29119
2021-03-30,MO,McDonald,83,3709,29119
2021-03-31,MO,McDonald,22,3731,29119
2021-04-01,MO,McDonald,108,3839,29119
2021-04-02,MO,McDonald,47,3886,29119
2021-04-03,MO,McDonald,1,3887,29119
2021-04-04,MO,McDonald,5,3892,29119
2021-04-05,MO,McDonald,42,3934,29119
2021-04-06,MO,McDonald,49,3983,29119
2021-04-07,MO,McDonald,16,3999,29119
2021-04-08,MO,McDonald,23,4022,29119
2021-04-09,MO,McDonald,166,4188,29119
2021-04-10,MO,McDonald,119,4307,29119
2021-04-11,MO,McDonald,8,4315,29119
2021-04-12,MO,McDonald,100,4415,29119
2021-04-13,MO,McDonald,37,4452,29119
2021-04-14,MO,McDonald,25,4477,29119
2021-04-15,MO,McDonald,37,4514,29119
2021-04-16,MO,McDonald,48,4562,29119
2021-04-17,MO,McDonald,21,4583,29119
2021-04-18,MO,McDonald,2,4585,29119
2021-04-19,MO,McDonald,26,4611,29119
2021-04-20,MO,McDonald,30,4641,29119
2021-04-21,MO,McDonald,25,4666,29119
2021-04-22,MO,McDonald,65,4731,29119
2021-04-23,MO,McDonald,126,4857,29119
2021-04-24,MO,McDonald,12,4869,29119
2021-04-25,MO,McDonald,5,4874,29119
2021-04-26,MO,McDonald,15,4889,29119
2021-04-27,MO,McDonald,20,4909,29119
2021-04-28,MO,McDonald,63,4972,29119
2021-04-29,MO,McDonald,44,5016,29119
2021-04-30,MO,McDonald,46,5062,29119
2021-05-01,MO,McDonald,14,5076,29119
2021-05-02,MO,McDonald,5,5081,29119
2021-05-03,MO,McDonald,49,5130,29119
2021-05-04,MO,McDonald,45,5175,29119
2021-05-05,MO,McDonald,18,5193,29119
2021-05-06,MO,McDonald,21,5214,29119
2021-05-07,MO,McDonald,14,5228,29119
2021-05-08,MO,McDonald,52,5280,29119
2021-05-09,MO,McDonald,8,5288,29119
2021-05-10,MO,McDonald,36,5324,29119
2021-05-11,MO,McDonald,34,5358,29119
2021-05-12,MO,McDonald,17,5375,29119
2021-05-13,MO,McDonald,34,5409,29119
2021-05-14,MO,McDonald,34,5443,29119
2021-05-15,MO,McDonald,16,5459,29119
2021-05-16,MO,McDonald,7,5466,29119
2021-05-17,MO,McDonald,23,5489,29119
2021-05-18,MO,McDonald,23,5512,29119
2021-05-19,MO,McDonald,123,5635,29119
2021-05-20,MO,McDonald,35,5670,29119
2021-05-21,MO,McDonald,27,5697,29119
2021-05-22,MO,McDonald,12,5709,29119
2021-05-23,MO,McDonald,6,5715,29119
2021-05-24,MO,McDonald,25,5740,29119
2021-05-25,MO,McDonald,18,5758,29119
2021-05-26,MO,McDonald,30,5788,29119
2021-05-27,MO,McDonald,5,5793,29119
2020-12-20,MO,Mercer,1,1,29129
2020-12-23,MO,Mercer,2,3,29129
2020-12-29,MO,Mercer,3,6,29129
2020-12-30,MO,Mercer,8,14,29129
2021-01-04,MO,Mercer,1,15,29129
2021-01-05,MO,Mercer,1,16,29129
2021-01-06,MO,Mercer,2,18,29129
2021-01-07,MO,Mercer,1,19,29129
2021-01-08,MO,Mercer,1,20,29129
2021-01-10,MO,Mercer,1,21,29129
2021-01-11,MO,Mercer,1,22,29129
2021-01-12,MO,Mercer,50,72,29129
2021-01-13,MO,Mercer,3,75,29129
2021-01-14,MO,Mercer,4,79,29129
2021-01-15,MO,Mercer,8,87,29129
2021-01-18,MO,Mercer,2,89,29129
2021-01-19,MO,Mercer,2,91,29129
2021-01-20,MO,Mercer,3,94,29129
2021-01-21,MO,Mercer,1,95,29129
2021-01-22,MO,Mercer,5,100,29129
2021-01-26,MO,Mercer,3,103,29129
2021-01-27,MO,Mercer,7,110,29129
2021-01-28,MO,Mercer,4,114,29129
2021-01-29,MO,Mercer,1,115,29129
2021-02-01,MO,Mercer,1,116,29129
2021-02-02,MO,Mercer,73,189,29129
2021-02-03,MO,Mercer,8,197,29129
2021-02-04,MO,Mercer,67,264,29129
2021-02-05,MO,Mercer,6,270,29129
2021-02-06,MO,Mercer,1,271,29129
2021-02-08,MO,Mercer,2,273,29129
2021-02-09,MO,Mercer,96,369,29129
2021-02-10,MO,Mercer,23,392,29129
2021-02-11,MO,Mercer,9,401,29129
2021-02-12,MO,Mercer,8,409,29129
2021-02-13,MO,Mercer,3,412,29129
2021-02-15,MO,Mercer,3,415,29129
2021-02-16,MO,Mercer,39,454,29129
2021-02-17,MO,Mercer,3,457,29129
2021-02-18,MO,Mercer,36,493,29129
2021-02-19,MO,Mercer,4,497,29129
2021-02-20,MO,Mercer,1,498,29129
2021-02-22,MO,Mercer,2,500,29129
2021-02-23,MO,Mercer,2,502,29129
2021-02-24,MO,Mercer,9,511,29129
2021-02-25,MO,Mercer,4,515,29129
2021-02-26,MO,Mercer,9,524,29129
2021-02-27,MO,Mercer,36,560,29129
2021-03-02,MO,Mercer,71,631,29129
2021-03-03,MO,Mercer,7,638,29129
2021-03-04,MO,Mercer,64,702,29129
2021-03-05,MO,Mercer,10,712,29129
2021-03-06,MO,Mercer,13,725,29129
2021-03-07,MO,Mercer,1,726,29129
2021-03-08,MO,Mercer,3,729,29129
2021-03-09,MO,Mercer,36,765,29129
2021-03-10,MO,Mercer,18,783,29129
2021-03-11,MO,Mercer,17,800,29129
2021-03-12,MO,Mercer,3,803,29129
2021-03-13,MO,Mercer,1,804,29129
2021-03-15,MO,Mercer,6,810,29129
2021-03-16,MO,Mercer,79,889,29129
2021-03-17,MO,Mercer,8,897,29129
2021-03-18,MO,Mercer,14,911,29129
2021-03-19,MO,Mercer,20,931,29129
2021-03-20,MO,Mercer,9,940,29129
2021-03-21,MO,Mercer,1,941,29129
2021-03-22,MO,Mercer,1,942,29129
2021-03-23,MO,Mercer,19,961,29129
2021-03-24,MO,Mercer,8,969,29129
2021-03-25,MO,Mercer,69,1038,29129
2021-03-26,MO,Mercer,13,1051,29129
2021-03-27,MO,Mercer,2,1053,29129
2021-03-29,MO,Mercer,6,1059,29129
2021-03-30,MO,Mercer,3,1062,29129
2021-03-31,MO,Mercer,7,1069,29129
2021-04-01,MO,Mercer,2,1071,29129
2021-04-03,MO,Mercer,1,1072,29129
2021-04-05,MO,Mercer,7,1079,29129
2021-04-06,MO,Mercer,2,1081,29129
2021-04-07,MO,Mercer,12,1093,29129
2021-04-08,MO,Mercer,16,1109,29129
2021-04-09,MO,Mercer,14,1123,29129
2021-04-10,MO,Mercer,2,1125,29129
2021-04-12,MO,Mercer,1,1126,29129
2021-04-14,MO,Mercer,3,1129,29129
2021-04-15,MO,Mercer,7,1136,29129
2021-04-16,MO,Mercer,9,1145,29129
2021-04-17,MO,Mercer,2,1147,29129
2021-04-19,MO,Mercer,2,1149,29129
2021-04-20,MO,Mercer,33,1182,29129
2021-04-21,MO,Mercer,3,1185,29129
2021-04-22,MO,Mercer,60,1245,29129
2021-04-23,MO,Mercer,5,1250,29129
2021-04-24,MO,Mercer,1,1251,29129
2021-04-26,MO,Mercer,1,1252,29129
2021-04-27,MO,Mercer,2,1254,29129
2021-04-28,MO,Mercer,2,1256,29129
2021-04-29,MO,Mercer,20,1276,29129
2021-04-30,MO,Mercer,6,1282,29129
2021-05-01,MO,Mercer,2,1284,29129
2021-05-03,MO,Mercer,2,1286,29129
2021-05-04,MO,Mercer,1,1287,29129
2021-05-05,MO,Mercer,3,1290,29129
2021-05-06,MO,Mercer,6,1296,29129
2021-05-07,MO,Mercer,1,1297,29129
2021-05-10,MO,Mercer,1,1298,29129
2021-05-11,MO,Mercer,3,1301,29129
2021-05-13,MO,Mercer,6,1307,29129
2021-05-14,MO,Mercer,2,1309,29129
2021-05-15,MO,Mercer,5,1314,29129
2021-05-17,MO,Mercer,3,1317,29129
2021-05-18,MO,Mercer,16,1333,29129
2021-05-19,MO,Mercer,1,1334,29129
2021-05-20,MO,Mercer,4,1338,29129
2021-05-21,MO,Mercer,3,1341,29129
2021-05-22,MO,Mercer,2,1343,29129
2021-05-23,MO,Mercer,2,1345,29129
2021-05-24,MO,Mercer,4,1349,29129
2021-05-25,MO,Mercer,3,1352,29129
2021-05-26,MO,Mercer,4,1356,29129
2021-05-27,MO,Mercer,1,1357,29129
2020-12-15,MO,Miller,1,1,29131
2020-12-16,MO,Miller,5,6,29131
2020-12-17,MO,Miller,10,16,29131
2020-12-18,MO,Miller,21,37,29131
2020-12-19,MO,Miller,1,38,29131
2020-12-20,MO,Miller,3,41,29131
2020-12-21,MO,Miller,31,72,29131
2020-12-22,MO,Miller,29,101,29131
2020-12-23,MO,Miller,42,143,29131
2020-12-24,MO,Miller,8,151,29131
2020-12-27,MO,Miller,1,152,29131
2020-12-28,MO,Miller,48,200,29131
2020-12-29,MO,Miller,24,224,29131
2020-12-30,MO,Miller,36,260,29131
2020-12-31,MO,Miller,5,265,29131
2021-01-01,MO,Miller,1,266,29131
2021-01-02,MO,Miller,2,268,29131
2021-01-03,MO,Miller,2,270,29131
2021-01-04,MO,Miller,23,293,29131
2021-01-05,MO,Miller,15,308,29131
2021-01-06,MO,Miller,17,325,29131
2021-01-07,MO,Miller,46,371,29131
2021-01-08,MO,Miller,19,390,29131
2021-01-09,MO,Miller,2,392,29131
2021-01-10,MO,Miller,4,396,29131
2021-01-11,MO,Miller,61,457,29131
2021-01-12,MO,Miller,27,484,29131
2021-01-13,MO,Miller,42,526,29131
2021-01-14,MO,Miller,24,550,29131
2021-01-15,MO,Miller,7,557,29131
2021-01-16,MO,Miller,19,576,29131
2021-01-18,MO,Miller,49,625,29131
2021-01-19,MO,Miller,63,688,29131
2021-01-20,MO,Miller,133,821,29131
2021-01-21,MO,Miller,58,879,29131
2021-01-22,MO,Miller,125,1004,29131
2021-01-23,MO,Miller,53,1057,29131
2021-01-24,MO,Miller,2,1059,29131
2021-01-25,MO,Miller,65,1124,29131
2021-01-26,MO,Miller,75,1199,29131
2021-01-27,MO,Miller,73,1272,29131
2021-01-28,MO,Miller,41,1313,29131
2021-01-29,MO,Miller,168,1481,29131
2021-01-30,MO,Miller,63,1544,29131
2021-01-31,MO,Miller,2,1546,29131
2021-02-01,MO,Miller,52,1598,29131
2021-02-02,MO,Miller,43,1641,29131
2021-02-03,MO,Miller,43,1684,29131
2021-02-04,MO,Miller,117,1801,29131
2021-02-05,MO,Miller,100,1901,29131
2021-02-06,MO,Miller,24,1925,29131
2021-02-08,MO,Miller,43,1968,29131
2021-02-09,MO,Miller,32,2000,29131
2021-02-10,MO,Miller,62,2062,29131
2021-02-11,MO,Miller,303,2365,29131
2021-02-12,MO,Miller,233,2598,29131
2021-02-13,MO,Miller,62,2660,29131
2021-02-14,MO,Miller,4,2664,29131
2021-02-15,MO,Miller,8,2672,29131
2021-02-16,MO,Miller,55,2727,29131
2021-02-17,MO,Miller,17,2744,29131
2021-02-18,MO,Miller,85,2829,29131
2021-02-19,MO,Miller,197,3026,29131
2021-02-20,MO,Miller,57,3083,29131
2021-02-21,MO,Miller,3,3086,29131
2021-02-22,MO,Miller,88,3174,29131
2021-02-23,MO,Miller,77,3251,29131
2021-02-24,MO,Miller,24,3275,29131
2021-02-25,MO,Miller,174,3449,29131
2021-02-26,MO,Miller,173,3622,29131
2021-02-27,MO,Miller,41,3663,29131
2021-02-28,MO,Miller,2,3665,29131
2021-03-01,MO,Miller,58,3723,29131
2021-03-02,MO,Miller,56,3779,29131
2021-03-03,MO,Miller,160,3939,29131
2021-03-04,MO,Miller,218,4157,29131
2021-03-05,MO,Miller,165,4322,29131
2021-03-06,MO,Miller,26,4348,29131
2021-03-07,MO,Miller,230,4578,29131
2021-03-08,MO,Miller,56,4634,29131
2021-03-09,MO,Miller,32,4666,29131
2021-03-10,MO,Miller,105,4771,29131
2021-03-11,MO,Miller,348,5119,29131
2021-03-12,MO,Miller,313,5432,29131
2021-03-13,MO,Miller,6,5438,29131
2021-03-14,MO,Miller,8,5446,29131
2021-03-15,MO,Miller,48,5494,29131
2021-03-16,MO,Miller,61,5555,29131
2021-03-17,MO,Miller,94,5649,29131
2021-03-18,MO,Miller,92,5741,29131
2021-03-19,MO,Miller,145,5886,29131
2021-03-20,MO,Miller,27,5913,29131
2021-03-21,MO,Miller,9,5922,29131
2021-03-22,MO,Miller,111,6033,29131
2021-03-23,MO,Miller,61,6094,29131
2021-03-24,MO,Miller,92,6186,29131
2021-03-25,MO,Miller,227,6413,29131
2021-03-26,MO,Miller,145,6558,29131
2021-03-27,MO,Miller,25,6583,29131
2021-03-28,MO,Miller,6,6589,29131
2021-03-29,MO,Miller,71,6660,29131
2021-03-30,MO,Miller,87,6747,29131
2021-03-31,MO,Miller,92,6839,29131
2021-04-01,MO,Miller,141,6980,29131
2021-04-02,MO,Miller,147,7127,29131
2021-04-03,MO,Miller,30,7157,29131
2021-04-04,MO,Miller,6,7163,29131
2021-04-05,MO,Miller,53,7216,29131
2021-04-06,MO,Miller,53,7269,29131
2021-04-07,MO,Miller,90,7359,29131
2021-04-08,MO,Miller,132,7491,29131
2021-04-09,MO,Miller,222,7713,29131
2021-04-10,MO,Miller,50,7763,29131
2021-04-11,MO,Miller,14,7777,29131
2021-04-12,MO,Miller,79,7856,29131
2021-04-13,MO,Miller,63,7919,29131
2021-04-14,MO,Miller,88,8007,29131
2021-04-15,MO,Miller,82,8089,29131
2021-04-16,MO,Miller,101,8190,29131
2021-04-17,MO,Miller,23,8213,29131
2021-04-18,MO,Miller,14,8227,29131
2021-04-19,MO,Miller,64,8291,29131
2021-04-20,MO,Miller,63,8354,29131
2021-04-21,MO,Miller,43,8397,29131
2021-04-22,MO,Miller,104,8501,29131
2021-04-23,MO,Miller,43,8544,29131
2021-04-24,MO,Miller,16,8560,29131
2021-04-25,MO,Miller,14,8574,29131
2021-04-26,MO,Miller,60,8634,29131
2021-04-27,MO,Miller,66,8700,29131
2021-04-28,MO,Miller,52,8752,29131
2021-04-29,MO,Miller,98,8850,29131
2021-04-30,MO,Miller,70,8920,29131
2021-05-01,MO,Miller,14,8934,29131
2021-05-02,MO,Miller,5,8939,29131
2021-05-03,MO,Miller,42,8981,29131
2021-05-04,MO,Miller,35,9016,29131
2021-05-05,MO,Miller,45,9061,29131
2021-05-06,MO,Miller,71,9132,29131
2021-05-07,MO,Miller,80,9212,29131
2021-05-08,MO,Miller,28,9240,29131
2021-05-09,MO,Miller,14,9254,29131
2021-05-10,MO,Miller,49,9303,29131
2021-05-11,MO,Miller,42,9345,29131
2021-05-12,MO,Miller,43,9388,29131
2021-05-13,MO,Miller,41,9429,29131
2021-05-14,MO,Miller,39,9468,29131
2021-05-15,MO,Miller,18,9486,29131
2021-05-16,MO,Miller,14,9500,29131
2021-05-17,MO,Miller,40,9540,29131
2021-05-18,MO,Miller,45,9585,29131
2021-05-19,MO,Miller,53,9638,29131
2021-05-20,MO,Miller,65,9703,29131
2021-05-21,MO,Miller,37,9740,29131
2021-05-22,MO,Miller,13,9753,29131
2021-05-23,MO,Miller,9,9762,29131
2021-05-24,MO,Miller,24,9786,29131
2021-05-25,MO,Miller,21,9807,29131
2021-05-26,MO,Miller,30,9837,29131
2021-05-27,MO,Miller,36,9873,29131
2020-12-17,MO,Mississippi,2,2,29133
2020-12-19,MO,Mississippi,1,3,29133
2020-12-20,MO,Mississippi,1,4,29133
2020-12-21,MO,Mississippi,8,12,29133
2020-12-22,MO,Mississippi,29,41,29133
2020-12-23,MO,Mississippi,36,77,29133
2020-12-28,MO,Mississippi,2,79,29133
2020-12-29,MO,Mississippi,4,83,29133
2020-12-30,MO,Mississippi,1,84,29133
2021-01-01,MO,Mississippi,4,88,29133
2021-01-03,MO,Mississippi,1,89,29133
2021-01-04,MO,Mississippi,2,91,29133
2021-01-05,MO,Mississippi,5,96,29133
2021-01-06,MO,Mississippi,29,125,29133
2021-01-07,MO,Mississippi,21,146,29133
2021-01-08,MO,Mississippi,10,156,29133
2021-01-09,MO,Mississippi,1,157,29133
2021-01-10,MO,Mississippi,3,160,29133
2021-01-11,MO,Mississippi,12,172,29133
2021-01-12,MO,Mississippi,45,217,29133
2021-01-13,MO,Mississippi,16,233,29133
2021-01-14,MO,Mississippi,18,251,29133
2021-01-15,MO,Mississippi,17,268,29133
2021-01-16,MO,Mississippi,5,273,29133
2021-01-18,MO,Mississippi,111,384,29133
2021-01-19,MO,Mississippi,96,480,29133
2021-01-20,MO,Mississippi,109,589,29133
2021-01-21,MO,Mississippi,54,643,29133
2021-01-22,MO,Mississippi,84,727,29133
2021-01-23,MO,Mississippi,3,730,29133
2021-01-25,MO,Mississippi,46,776,29133
2021-01-26,MO,Mississippi,36,812,29133
2021-01-27,MO,Mississippi,8,820,29133
2021-01-28,MO,Mississippi,83,903,29133
2021-01-29,MO,Mississippi,93,996,29133
2021-01-30,MO,Mississippi,1,997,29133
2021-02-01,MO,Mississippi,183,1180,29133
2021-02-02,MO,Mississippi,54,1234,29133
2021-02-03,MO,Mississippi,13,1247,29133
2021-02-04,MO,Mississippi,223,1470,29133
2021-02-05,MO,Mississippi,83,1553,29133
2021-02-06,MO,Mississippi,289,1842,29133
2021-02-07,MO,Mississippi,4,1846,29133
2021-02-08,MO,Mississippi,85,1931,29133
2021-02-09,MO,Mississippi,114,2045,29133
2021-02-10,MO,Mississippi,123,2168,29133
2021-02-11,MO,Mississippi,32,2200,29133
2021-02-12,MO,Mississippi,130,2330,29133
2021-02-13,MO,Mississippi,21,2351,29133
2021-02-14,MO,Mississippi,1,2352,29133
2021-02-15,MO,Mississippi,32,2384,29133
2021-02-16,MO,Mississippi,24,2408,29133
2021-02-17,MO,Mississippi,2,2410,29133
2021-02-18,MO,Mississippi,4,2414,29133
2021-02-19,MO,Mississippi,46,2460,29133
2021-02-20,MO,Mississippi,7,2467,29133
2021-02-21,MO,Mississippi,1,2468,29133
2021-02-22,MO,Mississippi,10,2478,29133
2021-02-23,MO,Mississippi,122,2600,29133
2021-02-24,MO,Mississippi,76,2676,29133
2021-02-25,MO,Mississippi,122,2798,29133
2021-02-26,MO,Mississippi,90,2888,29133
2021-02-27,MO,Mississippi,18,2906,29133
2021-03-01,MO,Mississippi,199,3105,29133
2021-03-02,MO,Mississippi,28,3133,29133
2021-03-03,MO,Mississippi,330,3463,29133
2021-03-04,MO,Mississippi,33,3496,29133
2021-03-05,MO,Mississippi,63,3559,29133
2021-03-06,MO,Mississippi,285,3844,29133
2021-03-07,MO,Mississippi,2,3846,29133
2021-03-08,MO,Mississippi,62,3908,29133
2021-03-09,MO,Mississippi,65,3973,29133
2021-03-10,MO,Mississippi,122,4095,29133
2021-03-11,MO,Mississippi,29,4124,29133
2021-03-12,MO,Mississippi,381,4505,29133
2021-03-13,MO,Mississippi,17,4522,29133
2021-03-14,MO,Mississippi,18,4540,29133
2021-03-15,MO,Mississippi,83,4623,29133
2021-03-16,MO,Mississippi,152,4775,29133
2021-03-17,MO,Mississippi,70,4845,29133
2021-03-18,MO,Mississippi,53,4898,29133
2021-03-19,MO,Mississippi,36,4934,29133
2021-03-20,MO,Mississippi,27,4961,29133
2021-03-21,MO,Mississippi,2,4963,29133
2021-03-22,MO,Mississippi,15,4978,29133
2021-03-23,MO,Mississippi,5,4983,29133
2021-03-24,MO,Mississippi,34,5017,29133
2021-03-25,MO,Mississippi,100,5117,29133
2021-03-26,MO,Mississippi,25,5142,29133
2021-03-28,MO,Mississippi,18,5160,29133
2021-03-29,MO,Mississippi,25,5185,29133
2021-03-30,MO,Mississippi,319,5504,29133
2021-03-31,MO,Mississippi,78,5582,29133
2021-04-01,MO,Mississippi,50,5632,29133
2021-04-02,MO,Mississippi,24,5656,29133
2021-04-03,MO,Mississippi,5,5661,29133
2021-04-04,MO,Mississippi,2,5663,29133
2021-04-05,MO,Mississippi,31,5694,29133
2021-04-06,MO,Mississippi,68,5762,29133
2021-04-07,MO,Mississippi,42,5804,29133
2021-04-08,MO,Mississippi,64,5868,29133
2021-04-09,MO,Mississippi,375,6243,29133
2021-04-10,MO,Mississippi,22,6265,29133
2021-04-11,MO,Mississippi,5,6270,29133
2021-04-12,MO,Mississippi,78,6348,29133
2021-04-13,MO,Mississippi,31,6379,29133
2021-04-14,MO,Mississippi,60,6439,29133
2021-04-15,MO,Mississippi,49,6488,29133
2021-04-16,MO,Mississippi,33,6521,29133
2021-04-17,MO,Mississippi,21,6542,29133
2021-04-18,MO,Mississippi,19,6561,29133
2021-04-19,MO,Mississippi,19,6580,29133
2021-04-20,MO,Mississippi,328,6908,29133
2021-04-21,MO,Mississippi,29,6937,29133
2021-04-22,MO,Mississippi,27,6964,29133
2021-04-23,MO,Mississippi,88,7052,29133
2021-04-24,MO,Mississippi,2,7054,29133
2021-04-25,MO,Mississippi,1,7055,29133
2021-04-26,MO,Mississippi,14,7069,29133
2021-04-27,MO,Mississippi,6,7075,29133
2021-04-28,MO,Mississippi,60,7135,29133
2021-04-29,MO,Mississippi,45,7180,29133
2021-04-30,MO,Mississippi,18,7198,29133
2021-05-01,MO,Mississippi,1,7199,29133
2021-05-02,MO,Mississippi,3,7202,29133
2021-05-03,MO,Mississippi,20,7222,29133
2021-05-04,MO,Mississippi,63,7285,29133
2021-05-05,MO,Mississippi,15,7300,29133
2021-05-06,MO,Mississippi,39,7339,29133
2021-05-07,MO,Mississippi,19,7358,29133
2021-05-08,MO,Mississippi,6,7364,29133
2021-05-09,MO,Mississippi,1,7365,29133
2021-05-10,MO,Mississippi,6,7371,29133
2021-05-11,MO,Mississippi,6,7377,29133
2021-05-12,MO,Mississippi,36,7413,29133
2021-05-13,MO,Mississippi,13,7426,29133
2021-05-14,MO,Mississippi,13,7439,29133
2021-05-15,MO,Mississippi,5,7444,29133
2021-05-16,MO,Mississippi,5,7449,29133
2021-05-17,MO,Mississippi,10,7459,29133
2021-05-18,MO,Mississippi,301,7760,29133
2021-05-19,MO,Mississippi,32,7792,29133
2021-05-20,MO,Mississippi,20,7812,29133
2021-05-21,MO,Mississippi,30,7842,29133
2021-05-22,MO,Mississippi,3,7845,29133
2021-05-23,MO,Mississippi,3,7848,29133
2021-05-24,MO,Mississippi,10,7858,29133
2021-05-25,MO,Mississippi,13,7871,29133
2021-05-26,MO,Mississippi,34,7905,29133
2021-05-27,MO,Mississippi,24,7929,29133
2020-12-15,MO,Moniteau,1,1,29135
2020-12-16,MO,Moniteau,7,8,29135
2020-12-17,MO,Moniteau,18,26,29135
2020-12-18,MO,Moniteau,22,48,29135
2020-12-19,MO,Moniteau,1,49,29135
2020-12-20,MO,Moniteau,3,52,29135
2020-12-21,MO,Moniteau,5,57,29135
2020-12-22,MO,Moniteau,8,65,29135
2020-12-23,MO,Moniteau,16,81,29135
2020-12-24,MO,Moniteau,3,84,29135
2020-12-28,MO,Moniteau,3,87,29135
2020-12-29,MO,Moniteau,8,95,29135
2020-12-30,MO,Moniteau,44,139,29135
2020-12-31,MO,Moniteau,8,147,29135
2021-01-03,MO,Moniteau,1,148,29135
2021-01-04,MO,Moniteau,9,157,29135
2021-01-05,MO,Moniteau,31,188,29135
2021-01-06,MO,Moniteau,16,204,29135
2021-01-07,MO,Moniteau,21,225,29135
2021-01-08,MO,Moniteau,18,243,29135
2021-01-09,MO,Moniteau,3,246,29135
2021-01-10,MO,Moniteau,5,251,29135
2021-01-11,MO,Moniteau,34,285,29135
2021-01-12,MO,Moniteau,4,289,29135
2021-01-13,MO,Moniteau,92,381,29135
2021-01-14,MO,Moniteau,23,404,29135
2021-01-15,MO,Moniteau,15,419,29135
2021-01-16,MO,Moniteau,3,422,29135
2021-01-18,MO,Moniteau,10,432,29135
2021-01-19,MO,Moniteau,31,463,29135
2021-01-20,MO,Moniteau,40,503,29135
2021-01-21,MO,Moniteau,83,586,29135
2021-01-22,MO,Moniteau,110,696,29135
2021-01-23,MO,Moniteau,71,767,29135
2021-01-24,MO,Moniteau,2,769,29135
2021-01-25,MO,Moniteau,101,870,29135
2021-01-26,MO,Moniteau,109,979,29135
2021-01-27,MO,Moniteau,143,1122,29135
2021-01-28,MO,Moniteau,40,1162,29135
2021-01-29,MO,Moniteau,136,1298,29135
2021-01-30,MO,Moniteau,24,1322,29135
2021-01-31,MO,Moniteau,3,1325,29135
2021-02-01,MO,Moniteau,59,1384,29135
2021-02-02,MO,Moniteau,17,1401,29135
2021-02-03,MO,Moniteau,90,1491,29135
2021-02-04,MO,Moniteau,108,1599,29135
2021-02-05,MO,Moniteau,103,1702,29135
2021-02-06,MO,Moniteau,31,1733,29135
2021-02-07,MO,Moniteau,1,1734,29135
2021-02-08,MO,Moniteau,32,1766,29135
2021-02-09,MO,Moniteau,101,1867,29135
2021-02-10,MO,Moniteau,127,1994,29135
2021-02-11,MO,Moniteau,116,2110,29135
2021-02-12,MO,Moniteau,208,2318,29135
2021-02-13,MO,Moniteau,83,2401,29135
2021-02-14,MO,Moniteau,2,2403,29135
2021-02-15,MO,Moniteau,5,2408,29135
2021-02-16,MO,Moniteau,23,2431,29135
2021-02-17,MO,Moniteau,51,2482,29135
2021-02-18,MO,Moniteau,66,2548,29135
2021-02-19,MO,Moniteau,91,2639,29135
2021-02-20,MO,Moniteau,25,2664,29135
2021-02-21,MO,Moniteau,1,2665,29135
2021-02-22,MO,Moniteau,93,2758,29135
2021-02-23,MO,Moniteau,110,2868,29135
2021-02-24,MO,Moniteau,113,2981,29135
2021-02-25,MO,Moniteau,60,3041,29135
2021-02-26,MO,Moniteau,142,3183,29135
2021-02-27,MO,Moniteau,16,3199,29135
2021-02-28,MO,Moniteau,2,3201,29135
2021-03-01,MO,Moniteau,139,3340,29135
2021-03-02,MO,Moniteau,100,3440,29135
2021-03-03,MO,Moniteau,122,3562,29135
2021-03-04,MO,Moniteau,79,3641,29135
2021-03-05,MO,Moniteau,110,3751,29135
2021-03-06,MO,Moniteau,13,3764,29135
2021-03-07,MO,Moniteau,7,3771,29135
2021-03-08,MO,Moniteau,9,3780,29135
2021-03-09,MO,Moniteau,90,3870,29135
2021-03-10,MO,Moniteau,147,4017,29135
2021-03-11,MO,Moniteau,88,4105,29135
2021-03-12,MO,Moniteau,130,4235,29135
2021-03-13,MO,Moniteau,4,4239,29135
2021-03-14,MO,Moniteau,3,4242,29135
2021-03-15,MO,Moniteau,98,4340,29135
2021-03-16,MO,Moniteau,134,4474,29135
2021-03-17,MO,Moniteau,71,4545,29135
2021-03-18,MO,Moniteau,106,4651,29135
2021-03-19,MO,Moniteau,93,4744,29135
2021-03-20,MO,Moniteau,7,4751,29135
2021-03-21,MO,Moniteau,7,4758,29135
2021-03-22,MO,Moniteau,48,4806,29135
2021-03-23,MO,Moniteau,30,4836,29135
2021-03-24,MO,Moniteau,85,4921,29135
2021-03-25,MO,Moniteau,90,5011,29135
2021-03-26,MO,Moniteau,119,5130,29135
2021-03-27,MO,Moniteau,9,5139,29135
2021-03-28,MO,Moniteau,5,5144,29135
2021-03-29,MO,Moniteau,121,5265,29135
2021-03-30,MO,Moniteau,215,5480,29135
2021-03-31,MO,Moniteau,160,5640,29135
2021-04-01,MO,Moniteau,57,5697,29135
2021-04-02,MO,Moniteau,43,5740,29135
2021-04-03,MO,Moniteau,5,5745,29135
2021-04-04,MO,Moniteau,2,5747,29135
2021-04-05,MO,Moniteau,39,5786,29135
2021-04-06,MO,Moniteau,75,5861,29135
2021-04-07,MO,Moniteau,46,5907,29135
2021-04-08,MO,Moniteau,49,5956,29135
2021-04-09,MO,Moniteau,75,6031,29135
2021-04-10,MO,Moniteau,14,6045,29135
2021-04-11,MO,Moniteau,4,6049,29135
2021-04-12,MO,Moniteau,97,6146,29135
2021-04-13,MO,Moniteau,137,6283,29135
2021-04-14,MO,Moniteau,81,6364,29135
2021-04-15,MO,Moniteau,100,6464,29135
2021-04-16,MO,Moniteau,40,6504,29135
2021-04-17,MO,Moniteau,10,6514,29135
2021-04-18,MO,Moniteau,1,6515,29135
2021-04-19,MO,Moniteau,16,6531,29135
2021-04-20,MO,Moniteau,257,6788,29135
2021-04-21,MO,Moniteau,28,6816,29135
2021-04-22,MO,Moniteau,90,6906,29135
2021-04-23,MO,Moniteau,118,7024,29135
2021-04-24,MO,Moniteau,4,7028,29135
2021-04-26,MO,Moniteau,17,7045,29135
2021-04-27,MO,Moniteau,14,7059,29135
2021-04-28,MO,Moniteau,12,7071,29135
2021-04-29,MO,Moniteau,17,7088,29135
2021-04-30,MO,Moniteau,21,7109,29135
2021-05-01,MO,Moniteau,5,7114,29135
2021-05-02,MO,Moniteau,1,7115,29135
2021-05-03,MO,Moniteau,51,7166,29135
2021-05-04,MO,Moniteau,23,7189,29135
2021-05-05,MO,Moniteau,31,7220,29135
2021-05-06,MO,Moniteau,21,7241,29135
2021-05-07,MO,Moniteau,10,7251,29135
2021-05-08,MO,Moniteau,9,7260,29135
2021-05-09,MO,Moniteau,3,7263,29135
2021-05-10,MO,Moniteau,15,7278,29135
2021-05-11,MO,Moniteau,12,7290,29135
2021-05-12,MO,Moniteau,73,7363,29135
2021-05-13,MO,Moniteau,14,7377,29135
2021-05-14,MO,Moniteau,18,7395,29135
2021-05-15,MO,Moniteau,6,7401,29135
2021-05-16,MO,Moniteau,3,7404,29135
2021-05-17,MO,Moniteau,8,7412,29135
2021-05-18,MO,Moniteau,21,7433,29135
2021-05-19,MO,Moniteau,55,7488,29135
2021-05-20,MO,Moniteau,17,7505,29135
2021-05-21,MO,Moniteau,30,7535,29135
2021-05-22,MO,Moniteau,8,7543,29135
2021-05-23,MO,Moniteau,3,7546,29135
2021-05-24,MO,Moniteau,8,7554,29135
2021-05-25,MO,Moniteau,5,7559,29135
2021-05-26,MO,Moniteau,10,7569,29135
2021-05-27,MO,Moniteau,3,7572,29135
2020-12-16,MO,Monroe,1,1,29137
2020-12-17,MO,Monroe,4,5,29137
2020-12-18,MO,Monroe,1,6,29137
2020-12-19,MO,Monroe,4,10,29137
2020-12-20,MO,Monroe,1,11,29137
2020-12-21,MO,Monroe,4,15,29137
2020-12-22,MO,Monroe,6,21,29137
2020-12-23,MO,Monroe,14,35,29137
2020-12-28,MO,Monroe,30,65,29137
2020-12-29,MO,Monroe,15,80,29137
2020-12-30,MO,Monroe,13,93,29137
2020-12-31,MO,Monroe,4,97,29137
2021-01-02,MO,Monroe,1,98,29137
2021-01-03,MO,Monroe,1,99,29137
2021-01-04,MO,Monroe,1,100,29137
2021-01-05,MO,Monroe,6,106,29137
2021-01-06,MO,Monroe,5,111,29137
2021-01-07,MO,Monroe,6,117,29137
2021-01-08,MO,Monroe,10,127,29137
2021-01-09,MO,Monroe,61,188,29137
2021-01-10,MO,Monroe,4,192,29137
2021-01-11,MO,Monroe,10,202,29137
2021-01-12,MO,Monroe,15,217,29137
2021-01-13,MO,Monroe,18,235,29137
2021-01-14,MO,Monroe,9,244,29137
2021-01-15,MO,Monroe,7,251,29137
2021-01-16,MO,Monroe,2,253,29137
2021-01-18,MO,Monroe,87,340,29137
2021-01-19,MO,Monroe,61,401,29137
2021-01-20,MO,Monroe,161,562,29137
2021-01-21,MO,Monroe,179,741,29137
2021-01-22,MO,Monroe,111,852,29137
2021-01-23,MO,Monroe,1,853,29137
2021-01-24,MO,Monroe,16,869,29137
2021-01-25,MO,Monroe,5,874,29137
2021-01-26,MO,Monroe,9,883,29137
2021-01-27,MO,Monroe,28,911,29137
2021-01-28,MO,Monroe,43,954,29137
2021-01-29,MO,Monroe,121,1075,29137
2021-01-31,MO,Monroe,1,1076,29137
2021-02-01,MO,Monroe,4,1080,29137
2021-02-02,MO,Monroe,39,1119,29137
2021-02-03,MO,Monroe,9,1128,29137
2021-02-04,MO,Monroe,138,1266,29137
2021-02-05,MO,Monroe,88,1354,29137
2021-02-06,MO,Monroe,80,1434,29137
2021-02-07,MO,Monroe,1,1435,29137
2021-02-08,MO,Monroe,90,1525,29137
2021-02-09,MO,Monroe,128,1653,29137
2021-02-10,MO,Monroe,41,1694,29137
2021-02-11,MO,Monroe,113,1807,29137
2021-02-12,MO,Monroe,158,1965,29137
2021-02-13,MO,Monroe,5,1970,29137
2021-02-15,MO,Monroe,37,2007,29137
2021-02-16,MO,Monroe,95,2102,29137
2021-02-17,MO,Monroe,11,2113,29137
2021-02-18,MO,Monroe,114,2227,29137
2021-02-19,MO,Monroe,73,2300,29137
2021-02-21,MO,Monroe,16,2316,29137
2021-02-22,MO,Monroe,29,2345,29137
2021-02-23,MO,Monroe,10,2355,29137
2021-02-24,MO,Monroe,47,2402,29137
2021-02-25,MO,Monroe,94,2496,29137
2021-02-26,MO,Monroe,88,2584,29137
2021-02-27,MO,Monroe,1,2585,29137
2021-03-01,MO,Monroe,4,2589,29137
2021-03-02,MO,Monroe,70,2659,29137
2021-03-03,MO,Monroe,15,2674,29137
2021-03-04,MO,Monroe,132,2806,29137
2021-03-05,MO,Monroe,119,2925,29137
2021-03-06,MO,Monroe,23,2948,29137
2021-03-07,MO,Monroe,1,2949,29137
2021-03-08,MO,Monroe,20,2969,29137
2021-03-09,MO,Monroe,29,2998,29137
2021-03-10,MO,Monroe,16,3014,29137
2021-03-11,MO,Monroe,90,3104,29137
2021-03-12,MO,Monroe,54,3158,29137
2021-03-13,MO,Monroe,2,3160,29137
2021-03-14,MO,Monroe,2,3162,29137
2021-03-15,MO,Monroe,43,3205,29137
2021-03-16,MO,Monroe,114,3319,29137
2021-03-17,MO,Monroe,16,3335,29137
2021-03-18,MO,Monroe,75,3410,29137
2021-03-19,MO,Monroe,95,3505,29137
2021-03-20,MO,Monroe,2,3507,29137
2021-03-21,MO,Monroe,1,3508,29137
2021-03-22,MO,Monroe,35,3543,29137
2021-03-23,MO,Monroe,19,3562,29137
2021-03-24,MO,Monroe,116,3678,29137
2021-03-25,MO,Monroe,88,3766,29137
2021-03-26,MO,Monroe,22,3788,29137
2021-03-27,MO,Monroe,2,3790,29137
2021-03-28,MO,Monroe,1,3791,29137
2021-03-29,MO,Monroe,5,3796,29137
2021-03-30,MO,Monroe,54,3850,29137
2021-03-31,MO,Monroe,31,3881,29137
2021-04-01,MO,Monroe,119,4000,29137
2021-04-02,MO,Monroe,54,4054,29137
2021-04-03,MO,Monroe,1,4055,29137
2021-04-05,MO,Monroe,11,4066,29137
2021-04-06,MO,Monroe,31,4097,29137
2021-04-07,MO,Monroe,30,4127,29137
2021-04-08,MO,Monroe,78,4205,29137
2021-04-09,MO,Monroe,60,4265,29137
2021-04-10,MO,Monroe,6,4271,29137
2021-04-11,MO,Monroe,1,4272,29137
2021-04-12,MO,Monroe,10,4282,29137
2021-04-13,MO,Monroe,105,4387,29137
2021-04-14,MO,Monroe,60,4447,29137
2021-04-15,MO,Monroe,76,4523,29137
2021-04-16,MO,Monroe,21,4544,29137
2021-04-17,MO,Monroe,6,4550,29137
2021-04-18,MO,Monroe,5,4555,29137
2021-04-19,MO,Monroe,7,4562,29137
2021-04-20,MO,Monroe,46,4608,29137
2021-04-21,MO,Monroe,13,4621,29137
2021-04-22,MO,Monroe,45,4666,29137
2021-04-23,MO,Monroe,24,4690,29137
2021-04-24,MO,Monroe,4,4694,29137
2021-04-26,MO,Monroe,6,4700,29137
2021-04-27,MO,Monroe,37,4737,29137
2021-04-28,MO,Monroe,24,4761,29137
2021-04-29,MO,Monroe,77,4838,29137
2021-04-30,MO,Monroe,76,4914,29137
2021-05-01,MO,Monroe,3,4917,29137
2021-05-02,MO,Monroe,2,4919,29137
2021-05-03,MO,Monroe,6,4925,29137
2021-05-04,MO,Monroe,22,4947,29137
2021-05-05,MO,Monroe,8,4955,29137
2021-05-06,MO,Monroe,18,4973,29137
2021-05-07,MO,Monroe,15,4988,29137
2021-05-08,MO,Monroe,3,4991,29137
2021-05-09,MO,Monroe,2,4993,29137
2021-05-10,MO,Monroe,3,4996,29137
2021-05-11,MO,Monroe,35,5031,29137
2021-05-12,MO,Monroe,12,5043,29137
2021-05-13,MO,Monroe,27,5070,29137
2021-05-14,MO,Monroe,9,5079,29137
2021-05-15,MO,Monroe,3,5082,29137
2021-05-16,MO,Monroe,2,5084,29137
2021-05-17,MO,Monroe,3,5087,29137
2021-05-18,MO,Monroe,30,5117,29137
2021-05-19,MO,Monroe,15,5132,29137
2021-05-20,MO,Monroe,17,5149,29137
2021-05-21,MO,Monroe,8,5157,29137
2021-05-22,MO,Monroe,2,5159,29137
2021-05-23,MO,Monroe,1,5160,29137
2021-05-24,MO,Monroe,4,5164,29137
2021-05-25,MO,Monroe,8,5172,29137
2021-05-26,MO,Monroe,6,5178,29137
2021-05-27,MO,Monroe,2,5180,29137
2020-12-16,MO,Montgomery,2,2,29139
2020-12-17,MO,Montgomery,10,12,29139
2020-12-18,MO,Montgomery,15,27,29139
2020-12-19,MO,Montgomery,1,28,29139
2020-12-20,MO,Montgomery,2,30,29139
2020-12-21,MO,Montgomery,5,35,29139
2020-12-22,MO,Montgomery,13,48,29139
2020-12-23,MO,Montgomery,4,52,29139
2020-12-24,MO,Montgomery,19,71,29139
2020-12-26,MO,Montgomery,3,74,29139
2020-12-28,MO,Montgomery,12,86,29139
2020-12-29,MO,Montgomery,11,97,29139
2020-12-30,MO,Montgomery,18,115,29139
2020-12-31,MO,Montgomery,6,121,29139
2021-01-02,MO,Montgomery,2,123,29139
2021-01-03,MO,Montgomery,1,124,29139
2021-01-04,MO,Montgomery,6,130,29139
2021-01-05,MO,Montgomery,21,151,29139
2021-01-06,MO,Montgomery,33,184,29139
2021-01-07,MO,Montgomery,8,192,29139
2021-01-08,MO,Montgomery,11,203,29139
2021-01-09,MO,Montgomery,5,208,29139
2021-01-10,MO,Montgomery,3,211,29139
2021-01-11,MO,Montgomery,44,255,29139
2021-01-12,MO,Montgomery,28,283,29139
2021-01-13,MO,Montgomery,6,289,29139
2021-01-14,MO,Montgomery,12,301,29139
2021-01-15,MO,Montgomery,38,339,29139
2021-01-16,MO,Montgomery,3,342,29139
2021-01-17,MO,Montgomery,2,344,29139
2021-01-18,MO,Montgomery,11,355,29139
2021-01-19,MO,Montgomery,21,376,29139
2021-01-20,MO,Montgomery,17,393,29139
2021-01-21,MO,Montgomery,24,417,29139
2021-01-22,MO,Montgomery,41,458,29139
2021-01-23,MO,Montgomery,7,465,29139
2021-01-25,MO,Montgomery,63,528,29139
2021-01-26,MO,Montgomery,82,610,29139
2021-01-27,MO,Montgomery,18,628,29139
2021-01-28,MO,Montgomery,78,706,29139
2021-01-29,MO,Montgomery,60,766,29139
2021-01-30,MO,Montgomery,277,1043,29139
2021-01-31,MO,Montgomery,55,1098,29139
2021-02-01,MO,Montgomery,10,1108,29139
2021-02-02,MO,Montgomery,34,1142,29139
2021-02-03,MO,Montgomery,44,1186,29139
2021-02-04,MO,Montgomery,396,1582,29139
2021-02-05,MO,Montgomery,42,1624,29139
2021-02-06,MO,Montgomery,5,1629,29139
2021-02-08,MO,Montgomery,59,1688,29139
2021-02-09,MO,Montgomery,56,1744,29139
2021-02-10,MO,Montgomery,32,1776,29139
2021-02-11,MO,Montgomery,43,1819,29139
2021-02-12,MO,Montgomery,224,2043,29139
2021-02-13,MO,Montgomery,7,2050,29139
2021-02-14,MO,Montgomery,1,2051,29139
2021-02-15,MO,Montgomery,5,2056,29139
2021-02-16,MO,Montgomery,18,2074,29139
2021-02-17,MO,Montgomery,19,2093,29139
2021-02-18,MO,Montgomery,21,2114,29139
2021-02-19,MO,Montgomery,58,2172,29139
2021-02-20,MO,Montgomery,144,2316,29139
2021-02-22,MO,Montgomery,21,2337,29139
2021-02-23,MO,Montgomery,43,2380,29139
2021-02-24,MO,Montgomery,43,2423,29139
2021-02-25,MO,Montgomery,68,2491,29139
2021-02-26,MO,Montgomery,44,2535,29139
2021-02-27,MO,Montgomery,338,2873,29139
2021-02-28,MO,Montgomery,1,2874,29139
2021-03-01,MO,Montgomery,27,2901,29139
2021-03-02,MO,Montgomery,26,2927,29139
2021-03-03,MO,Montgomery,91,3018,29139
2021-03-04,MO,Montgomery,394,3412,29139
2021-03-05,MO,Montgomery,29,3441,29139
2021-03-06,MO,Montgomery,20,3461,29139
2021-03-07,MO,Montgomery,11,3472,29139
2021-03-08,MO,Montgomery,40,3512,29139
2021-03-09,MO,Montgomery,40,3552,29139
2021-03-10,MO,Montgomery,39,3591,29139
2021-03-11,MO,Montgomery,52,3643,29139
2021-03-12,MO,Montgomery,98,3741,29139
2021-03-13,MO,Montgomery,176,3917,29139
2021-03-14,MO,Montgomery,2,3919,29139
2021-03-15,MO,Montgomery,54,3973,29139
2021-03-16,MO,Montgomery,67,4040,29139
2021-03-17,MO,Montgomery,74,4114,29139
2021-03-18,MO,Montgomery,57,4171,29139
2021-03-19,MO,Montgomery,102,4273,29139
2021-03-20,MO,Montgomery,10,4283,29139
2021-03-21,MO,Montgomery,8,4291,29139
2021-03-22,MO,Montgomery,33,4324,29139
2021-03-23,MO,Montgomery,44,4368,29139
2021-03-24,MO,Montgomery,119,4487,29139
2021-03-25,MO,Montgomery,69,4556,29139
2021-03-26,MO,Montgomery,87,4643,29139
2021-03-27,MO,Montgomery,9,4652,29139
2021-03-28,MO,Montgomery,11,4663,29139
2021-03-29,MO,Montgomery,24,4687,29139
2021-03-30,MO,Montgomery,81,4768,29139
2021-03-31,MO,Montgomery,47,4815,29139
2021-04-01,MO,Montgomery,149,4964,29139
2021-04-02,MO,Montgomery,30,4994,29139
2021-04-03,MO,Montgomery,15,5009,29139
2021-04-04,MO,Montgomery,3,5012,29139
2021-04-05,MO,Montgomery,44,5056,29139
2021-04-06,MO,Montgomery,45,5101,29139
2021-04-07,MO,Montgomery,95,5196,29139
2021-04-08,MO,Montgomery,217,5413,29139
2021-04-09,MO,Montgomery,50,5463,29139
2021-04-10,MO,Montgomery,71,5534,29139
2021-04-11,MO,Montgomery,6,5540,29139
2021-04-12,MO,Montgomery,84,5624,29139
2021-04-13,MO,Montgomery,38,5662,29139
2021-04-14,MO,Montgomery,106,5768,29139
2021-04-15,MO,Montgomery,61,5829,29139
2021-04-16,MO,Montgomery,82,5911,29139
2021-04-17,MO,Montgomery,17,5928,29139
2021-04-18,MO,Montgomery,11,5939,29139
2021-04-19,MO,Montgomery,42,5981,29139
2021-04-20,MO,Montgomery,44,6025,29139
2021-04-21,MO,Montgomery,37,6062,29139
2021-04-22,MO,Montgomery,56,6118,29139
2021-04-23,MO,Montgomery,30,6148,29139
2021-04-24,MO,Montgomery,20,6168,29139
2021-04-25,MO,Montgomery,1,6169,29139
2021-04-26,MO,Montgomery,24,6193,29139
2021-04-27,MO,Montgomery,222,6415,29139
2021-04-28,MO,Montgomery,53,6468,29139
2021-04-29,MO,Montgomery,64,6532,29139
2021-04-30,MO,Montgomery,33,6565,29139
2021-05-01,MO,Montgomery,57,6622,29139
2021-05-02,MO,Montgomery,6,6628,29139
2021-05-03,MO,Montgomery,18,6646,29139
2021-05-04,MO,Montgomery,24,6670,29139
2021-05-05,MO,Montgomery,30,6700,29139
2021-05-06,MO,Montgomery,72,6772,29139
2021-05-07,MO,Montgomery,39,6811,29139
2021-05-08,MO,Montgomery,11,6822,29139
2021-05-09,MO,Montgomery,7,6829,29139
2021-05-10,MO,Montgomery,18,6847,29139
2021-05-11,MO,Montgomery,7,6854,29139
2021-05-12,MO,Montgomery,63,6917,29139
2021-05-13,MO,Montgomery,171,7088,29139
2021-05-14,MO,Montgomery,21,7109,29139
2021-05-15,MO,Montgomery,16,7125,29139
2021-05-16,MO,Montgomery,4,7129,29139
2021-05-17,MO,Montgomery,45,7174,29139
2021-05-18,MO,Montgomery,47,7221,29139
2021-05-19,MO,Montgomery,30,7251,29139
2021-05-20,MO,Montgomery,28,7279,29139
2021-05-21,MO,Montgomery,17,7296,29139
2021-05-22,MO,Montgomery,10,7306,29139
2021-05-23,MO,Montgomery,3,7309,29139
2021-05-24,MO,Montgomery,12,7321,29139
2021-05-25,MO,Montgomery,20,7341,29139
2021-05-26,MO,Montgomery,19,7360,29139
2021-05-27,MO,Montgomery,19,7379,29139
2020-12-15,MO,Morgan,3,3,29141
2020-12-16,MO,Morgan,2,5,29141
2020-12-17,MO,Morgan,4,9,29141
2020-12-18,MO,Morgan,8,17,29141
2020-12-21,MO,Morgan,19,36,29141
2020-12-22,MO,Morgan,15,51,29141
2020-12-23,MO,Morgan,12,63,29141
2020-12-24,MO,Morgan,3,66,29141
2020-12-27,MO,Morgan,1,67,29141
2020-12-28,MO,Morgan,14,81,29141
2020-12-29,MO,Morgan,23,104,29141
2020-12-30,MO,Morgan,20,124,29141
2020-12-31,MO,Morgan,6,130,29141
2021-01-02,MO,Morgan,1,131,29141
2021-01-03,MO,Morgan,1,132,29141
2021-01-04,MO,Morgan,95,227,29141
2021-01-05,MO,Morgan,12,239,29141
2021-01-06,MO,Morgan,6,245,29141
2021-01-07,MO,Morgan,10,255,29141
2021-01-08,MO,Morgan,14,269,29141
2021-01-10,MO,Morgan,1,270,29141
2021-01-11,MO,Morgan,25,295,29141
2021-01-12,MO,Morgan,16,311,29141
2021-01-13,MO,Morgan,25,336,29141
2021-01-14,MO,Morgan,53,389,29141
2021-01-15,MO,Morgan,19,408,29141
2021-01-16,MO,Morgan,5,413,29141
2021-01-18,MO,Morgan,17,430,29141
2021-01-19,MO,Morgan,29,459,29141
2021-01-20,MO,Morgan,23,482,29141
2021-01-21,MO,Morgan,19,501,29141
2021-01-22,MO,Morgan,39,540,29141
2021-01-23,MO,Morgan,90,630,29141
2021-01-25,MO,Morgan,96,726,29141
2021-01-26,MO,Morgan,49,775,29141
2021-01-27,MO,Morgan,123,898,29141
2021-01-28,MO,Morgan,88,986,29141
2021-01-29,MO,Morgan,275,1261,29141
2021-01-30,MO,Morgan,23,1284,29141
2021-01-31,MO,Morgan,1,1285,29141
2021-02-01,MO,Morgan,130,1415,29141
2021-02-02,MO,Morgan,57,1472,29141
2021-02-03,MO,Morgan,125,1597,29141
2021-02-04,MO,Morgan,107,1704,29141
2021-02-05,MO,Morgan,143,1847,29141
2021-02-06,MO,Morgan,61,1908,29141
2021-02-08,MO,Morgan,13,1921,29141
2021-02-09,MO,Morgan,124,2045,29141
2021-02-10,MO,Morgan,117,2162,29141
2021-02-11,MO,Morgan,243,2405,29141
2021-02-12,MO,Morgan,223,2628,29141
2021-02-13,MO,Morgan,132,2760,29141
2021-02-14,MO,Morgan,3,2763,29141
2021-02-15,MO,Morgan,4,2767,29141
2021-02-16,MO,Morgan,22,2789,29141
2021-02-17,MO,Morgan,21,2810,29141
2021-02-18,MO,Morgan,101,2911,29141
2021-02-19,MO,Morgan,275,3186,29141
2021-02-20,MO,Morgan,10,3196,29141
2021-02-22,MO,Morgan,130,3326,29141
2021-02-23,MO,Morgan,75,3401,29141
2021-02-24,MO,Morgan,191,3592,29141
2021-02-25,MO,Morgan,261,3853,29141
2021-02-26,MO,Morgan,266,4119,29141
2021-02-27,MO,Morgan,42,4161,29141
2021-02-28,MO,Morgan,7,4168,29141
2021-03-01,MO,Morgan,73,4241,29141
2021-03-02,MO,Morgan,95,4336,29141
2021-03-03,MO,Morgan,185,4521,29141
2021-03-04,MO,Morgan,176,4697,29141
2021-03-05,MO,Morgan,131,4828,29141
2021-03-06,MO,Morgan,62,4890,29141
2021-03-07,MO,Morgan,156,5046,29141
2021-03-08,MO,Morgan,75,5121,29141
2021-03-09,MO,Morgan,155,5276,29141
2021-03-10,MO,Morgan,133,5409,29141
2021-03-11,MO,Morgan,294,5703,29141
2021-03-12,MO,Morgan,229,5932,29141
2021-03-13,MO,Morgan,31,5963,29141
2021-03-14,MO,Morgan,4,5967,29141
2021-03-15,MO,Morgan,84,6051,29141
2021-03-16,MO,Morgan,92,6143,29141
2021-03-17,MO,Morgan,84,6227,29141
2021-03-18,MO,Morgan,114,6341,29141
2021-03-19,MO,Morgan,153,6494,29141
2021-03-20,MO,Morgan,39,6533,29141
2021-03-21,MO,Morgan,35,6568,29141
2021-03-22,MO,Morgan,129,6697,29141
2021-03-23,MO,Morgan,97,6794,29141
2021-03-24,MO,Morgan,136,6930,29141
2021-03-25,MO,Morgan,205,7135,29141
2021-03-26,MO,Morgan,158,7293,29141
2021-03-27,MO,Morgan,33,7326,29141
2021-03-28,MO,Morgan,4,7330,29141
2021-03-29,MO,Morgan,64,7394,29141
2021-03-30,MO,Morgan,124,7518,29141
2021-03-31,MO,Morgan,151,7669,29141
2021-04-01,MO,Morgan,112,7781,29141
2021-04-02,MO,Morgan,84,7865,29141
2021-04-03,MO,Morgan,24,7889,29141
2021-04-04,MO,Morgan,6,7895,29141
2021-04-05,MO,Morgan,90,7985,29141
2021-04-06,MO,Morgan,114,8099,29141
2021-04-07,MO,Morgan,59,8158,29141
2021-04-08,MO,Morgan,96,8254,29141
2021-04-09,MO,Morgan,150,8404,29141
2021-04-10,MO,Morgan,20,8424,29141
2021-04-11,MO,Morgan,12,8436,29141
2021-04-12,MO,Morgan,50,8486,29141
2021-04-13,MO,Morgan,99,8585,29141
2021-04-14,MO,Morgan,112,8697,29141
2021-04-15,MO,Morgan,65,8762,29141
2021-04-16,MO,Morgan,121,8883,29141
2021-04-17,MO,Morgan,14,8897,29141
2021-04-18,MO,Morgan,7,8904,29141
2021-04-19,MO,Morgan,40,8944,29141
2021-04-20,MO,Morgan,94,9038,29141
2021-04-21,MO,Morgan,47,9085,29141
2021-04-22,MO,Morgan,64,9149,29141
2021-04-23,MO,Morgan,68,9217,29141
2021-04-24,MO,Morgan,13,9230,29141
2021-04-25,MO,Morgan,5,9235,29141
2021-04-26,MO,Morgan,24,9259,29141
2021-04-27,MO,Morgan,63,9322,29141
2021-04-28,MO,Morgan,52,9374,29141
2021-04-29,MO,Morgan,39,9413,29141
2021-04-30,MO,Morgan,73,9486,29141
2021-05-01,MO,Morgan,13,9499,29141
2021-05-02,MO,Morgan,6,9505,29141
2021-05-03,MO,Morgan,43,9548,29141
2021-05-04,MO,Morgan,56,9604,29141
2021-05-05,MO,Morgan,39,9643,29141
2021-05-06,MO,Morgan,33,9676,29141
2021-05-07,MO,Morgan,49,9725,29141
2021-05-08,MO,Morgan,14,9739,29141
2021-05-09,MO,Morgan,9,9748,29141
2021-05-10,MO,Morgan,43,9791,29141
2021-05-11,MO,Morgan,45,9836,29141
2021-05-12,MO,Morgan,46,9882,29141
2021-05-13,MO,Morgan,50,9932,29141
2021-05-14,MO,Morgan,44,9976,29141
2021-05-15,MO,Morgan,11,9987,29141
2021-05-16,MO,Morgan,7,9994,29141
2021-05-17,MO,Morgan,56,10050,29141
2021-05-18,MO,Morgan,48,10098,29141
2021-05-19,MO,Morgan,24,10122,29141
2021-05-20,MO,Morgan,39,10161,29141
2021-05-21,MO,Morgan,25,10186,29141
2021-05-22,MO,Morgan,18,10204,29141
2021-05-23,MO,Morgan,2,10206,29141
2021-05-24,MO,Morgan,15,10221,29141
2021-05-25,MO,Morgan,17,10238,29141
2021-05-26,MO,Morgan,21,10259,29141
2021-05-27,MO,Morgan,11,10270,29141
2020-12-16,MO,New Madrid,1,1,29143
2020-12-17,MO,New Madrid,1,2,29143
2020-12-18,MO,New Madrid,4,6,29143
2020-12-19,MO,New Madrid,1,7,29143
2020-12-21,MO,New Madrid,5,12,29143
2020-12-22,MO,New Madrid,13,25,29143
2020-12-23,MO,New Madrid,23,48,29143
2020-12-28,MO,New Madrid,2,50,29143
2020-12-29,MO,New Madrid,11,61,29143
2020-12-30,MO,New Madrid,61,122,29143
2021-01-01,MO,New Madrid,1,123,29143
2021-01-02,MO,New Madrid,5,128,29143
2021-01-03,MO,New Madrid,5,133,29143
2021-01-04,MO,New Madrid,3,136,29143
2021-01-05,MO,New Madrid,7,143,29143
2021-01-06,MO,New Madrid,38,181,29143
2021-01-07,MO,New Madrid,8,189,29143
2021-01-08,MO,New Madrid,10,199,29143
2021-01-09,MO,New Madrid,1,200,29143
2021-01-10,MO,New Madrid,89,289,29143
2021-01-11,MO,New Madrid,8,297,29143
2021-01-12,MO,New Madrid,33,330,29143
2021-01-13,MO,New Madrid,6,336,29143
2021-01-14,MO,New Madrid,38,374,29143
2021-01-15,MO,New Madrid,24,398,29143
2021-01-16,MO,New Madrid,2,400,29143
2021-01-18,MO,New Madrid,36,436,29143
2021-01-19,MO,New Madrid,53,489,29143
2021-01-20,MO,New Madrid,100,589,29143
2021-01-21,MO,New Madrid,67,656,29143
2021-01-22,MO,New Madrid,98,754,29143
2021-01-23,MO,New Madrid,6,760,29143
2021-01-24,MO,New Madrid,2,762,29143
2021-01-25,MO,New Madrid,41,803,29143
2021-01-26,MO,New Madrid,56,859,29143
2021-01-27,MO,New Madrid,141,1000,29143
2021-01-28,MO,New Madrid,137,1137,29143
2021-01-29,MO,New Madrid,100,1237,29143
2021-01-30,MO,New Madrid,1,1238,29143
2021-02-01,MO,New Madrid,115,1353,29143
2021-02-02,MO,New Madrid,25,1378,29143
2021-02-03,MO,New Madrid,185,1563,29143
2021-02-04,MO,New Madrid,128,1691,29143
2021-02-05,MO,New Madrid,110,1801,29143
2021-02-06,MO,New Madrid,2,1803,29143
2021-02-07,MO,New Madrid,99,1902,29143
2021-02-08,MO,New Madrid,119,2021,29143
2021-02-09,MO,New Madrid,171,2192,29143
2021-02-10,MO,New Madrid,30,2222,29143
2021-02-11,MO,New Madrid,35,2257,29143
2021-02-12,MO,New Madrid,91,2348,29143
2021-02-13,MO,New Madrid,10,2358,29143
2021-02-14,MO,New Madrid,1,2359,29143
2021-02-15,MO,New Madrid,11,2370,29143
2021-02-16,MO,New Madrid,15,2385,29143
2021-02-17,MO,New Madrid,8,2393,29143
2021-02-18,MO,New Madrid,11,2404,29143
2021-02-19,MO,New Madrid,54,2458,29143
2021-02-20,MO,New Madrid,14,2472,29143
2021-02-21,MO,New Madrid,2,2474,29143
2021-02-22,MO,New Madrid,66,2540,29143
2021-02-23,MO,New Madrid,108,2648,29143
2021-02-24,MO,New Madrid,158,2806,29143
2021-02-25,MO,New Madrid,212,3018,29143
2021-02-26,MO,New Madrid,159,3177,29143
2021-02-27,MO,New Madrid,26,3203,29143
2021-02-28,MO,New Madrid,1,3204,29143
2021-03-01,MO,New Madrid,127,3331,29143
2021-03-02,MO,New Madrid,150,3481,29143
2021-03-03,MO,New Madrid,149,3630,29143
2021-03-04,MO,New Madrid,158,3788,29143
2021-03-05,MO,New Madrid,126,3914,29143
2021-03-06,MO,New Madrid,12,3926,29143
2021-03-08,MO,New Madrid,135,4061,29143
2021-03-09,MO,New Madrid,97,4158,29143
2021-03-10,MO,New Madrid,36,4194,29143
2021-03-11,MO,New Madrid,61,4255,29143
2021-03-12,MO,New Madrid,32,4287,29143
2021-03-13,MO,New Madrid,6,4293,29143
2021-03-14,MO,New Madrid,27,4320,29143
2021-03-15,MO,New Madrid,37,4357,29143
2021-03-16,MO,New Madrid,51,4408,29143
2021-03-17,MO,New Madrid,49,4457,29143
2021-03-18,MO,New Madrid,92,4549,29143
2021-03-19,MO,New Madrid,37,4586,29143
2021-03-20,MO,New Madrid,8,4594,29143
2021-03-21,MO,New Madrid,7,4601,29143
2021-03-22,MO,New Madrid,55,4656,29143
2021-03-23,MO,New Madrid,30,4686,29143
2021-03-24,MO,New Madrid,291,4977,29143
2021-03-25,MO,New Madrid,124,5101,29143
2021-03-26,MO,New Madrid,62,5163,29143
2021-03-27,MO,New Madrid,6,5169,29143
2021-03-28,MO,New Madrid,16,5185,29143
2021-03-29,MO,New Madrid,99,5284,29143
2021-03-30,MO,New Madrid,112,5396,29143
2021-03-31,MO,New Madrid,76,5472,29143
2021-04-01,MO,New Madrid,69,5541,29143
2021-04-02,MO,New Madrid,13,5554,29143
2021-04-03,MO,New Madrid,8,5562,29143
2021-04-04,MO,New Madrid,1,5563,29143
2021-04-05,MO,New Madrid,35,5598,29143
2021-04-06,MO,New Madrid,46,5644,29143
2021-04-07,MO,New Madrid,28,5672,29143
2021-04-08,MO,New Madrid,100,5772,29143
2021-04-09,MO,New Madrid,67,5839,29143
2021-04-10,MO,New Madrid,6,5845,29143
2021-04-11,MO,New Madrid,8,5853,29143
2021-04-12,MO,New Madrid,30,5883,29143
2021-04-13,MO,New Madrid,28,5911,29143
2021-04-14,MO,New Madrid,206,6117,29143
2021-04-15,MO,New Madrid,58,6175,29143
2021-04-16,MO,New Madrid,105,6280,29143
2021-04-17,MO,New Madrid,8,6288,29143
2021-04-18,MO,New Madrid,15,6303,29143
2021-04-19,MO,New Madrid,91,6394,29143
2021-04-20,MO,New Madrid,21,6415,29143
2021-04-21,MO,New Madrid,48,6463,29143
2021-04-22,MO,New Madrid,67,6530,29143
2021-04-23,MO,New Madrid,19,6549,29143
2021-04-24,MO,New Madrid,7,6556,29143
2021-04-25,MO,New Madrid,3,6559,29143
2021-04-26,MO,New Madrid,13,6572,29143
2021-04-27,MO,New Madrid,16,6588,29143
2021-04-28,MO,New Madrid,33,6621,29143
2021-04-29,MO,New Madrid,84,6705,29143
2021-04-30,MO,New Madrid,15,6720,29143
2021-05-01,MO,New Madrid,6,6726,29143
2021-05-02,MO,New Madrid,6,6732,29143
2021-05-03,MO,New Madrid,8,6740,29143
2021-05-04,MO,New Madrid,26,6766,29143
2021-05-05,MO,New Madrid,13,6779,29143
2021-05-06,MO,New Madrid,28,6807,29143
2021-05-07,MO,New Madrid,31,6838,29143
2021-05-08,MO,New Madrid,7,6845,29143
2021-05-09,MO,New Madrid,3,6848,29143
2021-05-10,MO,New Madrid,56,6904,29143
2021-05-11,MO,New Madrid,15,6919,29143
2021-05-12,MO,New Madrid,16,6935,29143
2021-05-13,MO,New Madrid,8,6943,29143
2021-05-14,MO,New Madrid,18,6961,29143
2021-05-15,MO,New Madrid,4,6965,29143
2021-05-16,MO,New Madrid,3,6968,29143
2021-05-17,MO,New Madrid,33,7001,29143
2021-05-18,MO,New Madrid,23,7024,29143
2021-05-19,MO,New Madrid,17,7041,29143
2021-05-20,MO,New Madrid,12,7053,29143
2021-05-21,MO,New Madrid,8,7061,29143
2021-05-22,MO,New Madrid,4,7065,29143
2021-05-23,MO,New Madrid,5,7070,29143
2021-05-24,MO,New Madrid,36,7106,29143
2021-05-25,MO,New Madrid,31,7137,29143
2021-05-26,MO,New Madrid,17,7154,29143
2021-05-27,MO,New Madrid,24,7178,29143
2020-12-16,MO,Newton,8,8,29145
2020-12-17,MO,Newton,20,28,29145
2020-12-18,MO,Newton,21,49,29145
2020-12-19,MO,Newton,6,55,29145
2020-12-20,MO,Newton,2,57,29145
2020-12-21,MO,Newton,11,68,29145
2020-12-22,MO,Newton,21,89,29145
2020-12-23,MO,Newton,28,117,29145
2020-12-24,MO,Newton,2,119,29145
2020-12-28,MO,Newton,19,138,29145
2020-12-29,MO,Newton,11,149,29145
2020-12-30,MO,Newton,208,357,29145
2020-12-31,MO,Newton,59,416,29145
2021-01-02,MO,Newton,2,418,29145
2021-01-04,MO,Newton,7,425,29145
2021-01-05,MO,Newton,8,433,29145
2021-01-06,MO,Newton,35,468,29145
2021-01-07,MO,Newton,66,534,29145
2021-01-08,MO,Newton,44,578,29145
2021-01-09,MO,Newton,14,592,29145
2021-01-10,MO,Newton,3,595,29145
2021-01-11,MO,Newton,28,623,29145
2021-01-12,MO,Newton,71,694,29145
2021-01-13,MO,Newton,111,805,29145
2021-01-14,MO,Newton,61,866,29145
2021-01-15,MO,Newton,24,890,29145
2021-01-16,MO,Newton,11,901,29145
2021-01-18,MO,Newton,79,980,29145
2021-01-19,MO,Newton,43,1023,29145
2021-01-20,MO,Newton,125,1148,29145
2021-01-21,MO,Newton,118,1266,29145
2021-01-22,MO,Newton,45,1311,29145
2021-01-23,MO,Newton,10,1321,29145
2021-01-24,MO,Newton,1,1322,29145
2021-01-25,MO,Newton,36,1358,29145
2021-01-26,MO,Newton,83,1441,29145
2021-01-27,MO,Newton,224,1665,29145
2021-01-28,MO,Newton,39,1704,29145
2021-01-29,MO,Newton,157,1861,29145
2021-01-30,MO,Newton,4,1865,29145
2021-02-01,MO,Newton,58,1923,29145
2021-02-02,MO,Newton,149,2072,29145
2021-02-03,MO,Newton,126,2198,29145
2021-02-04,MO,Newton,173,2371,29145
2021-02-05,MO,Newton,215,2586,29145
2021-02-06,MO,Newton,2,2588,29145
2021-02-07,MO,Newton,1,2589,29145
2021-02-08,MO,Newton,101,2690,29145
2021-02-09,MO,Newton,105,2795,29145
2021-02-10,MO,Newton,153,2948,29145
2021-02-11,MO,Newton,198,3146,29145
2021-02-12,MO,Newton,264,3410,29145
2021-02-13,MO,Newton,72,3482,29145
2021-02-14,MO,Newton,3,3485,29145
2021-02-15,MO,Newton,62,3547,29145
2021-02-16,MO,Newton,31,3578,29145
2021-02-17,MO,Newton,52,3630,29145
2021-02-18,MO,Newton,75,3705,29145
2021-02-19,MO,Newton,234,3939,29145
2021-02-20,MO,Newton,16,3955,29145
2021-02-21,MO,Newton,1,3956,29145
2021-02-22,MO,Newton,12,3968,29145
2021-02-23,MO,Newton,247,4215,29145
2021-02-24,MO,Newton,164,4379,29145
2021-02-25,MO,Newton,575,4954,29145
2021-02-26,MO,Newton,318,5272,29145
2021-02-27,MO,Newton,116,5388,29145
2021-02-28,MO,Newton,1,5389,29145
2021-03-01,MO,Newton,89,5478,29145
2021-03-02,MO,Newton,320,5798,29145
2021-03-03,MO,Newton,199,5997,29145
2021-03-04,MO,Newton,137,6134,29145
2021-03-05,MO,Newton,142,6276,29145
2021-03-06,MO,Newton,39,6315,29145
2021-03-07,MO,Newton,12,6327,29145
2021-03-08,MO,Newton,119,6446,29145
2021-03-09,MO,Newton,312,6758,29145
2021-03-10,MO,Newton,95,6853,29145
2021-03-11,MO,Newton,260,7113,29145
2021-03-12,MO,Newton,457,7570,29145
2021-03-13,MO,Newton,76,7646,29145
2021-03-14,MO,Newton,13,7659,29145
2021-03-15,MO,Newton,165,7824,29145
2021-03-16,MO,Newton,172,7996,29145
2021-03-17,MO,Newton,101,8097,29145
2021-03-18,MO,Newton,525,8622,29145
2021-03-19,MO,Newton,415,9037,29145
2021-03-20,MO,Newton,42,9079,29145
2021-03-21,MO,Newton,14,9093,29145
2021-03-22,MO,Newton,54,9147,29145
2021-03-23,MO,Newton,491,9638,29145
2021-03-24,MO,Newton,201,9839,29145
2021-03-25,MO,Newton,176,10015,29145
2021-03-26,MO,Newton,331,10346,29145
2021-03-27,MO,Newton,249,10595,29145
2021-03-28,MO,Newton,14,10609,29145
2021-03-29,MO,Newton,178,10787,29145
2021-03-30,MO,Newton,217,11004,29145
2021-03-31,MO,Newton,110,11114,29145
2021-04-01,MO,Newton,312,11426,29145
2021-04-02,MO,Newton,344,11770,29145
2021-04-03,MO,Newton,38,11808,29145
2021-04-04,MO,Newton,8,11816,29145
2021-04-05,MO,Newton,174,11990,29145
2021-04-06,MO,Newton,275,12265,29145
2021-04-07,MO,Newton,120,12385,29145
2021-04-08,MO,Newton,113,12498,29145
2021-04-09,MO,Newton,467,12965,29145
2021-04-10,MO,Newton,46,13011,29145
2021-04-11,MO,Newton,12,13023,29145
2021-04-12,MO,Newton,172,13195,29145
2021-04-13,MO,Newton,188,13383,29145
2021-04-14,MO,Newton,90,13473,29145
2021-04-15,MO,Newton,146,13619,29145
2021-04-16,MO,Newton,110,13729,29145
2021-04-17,MO,Newton,202,13931,29145
2021-04-18,MO,Newton,10,13941,29145
2021-04-19,MO,Newton,146,14087,29145
2021-04-20,MO,Newton,162,14249,29145
2021-04-21,MO,Newton,94,14343,29145
2021-04-22,MO,Newton,146,14489,29145
2021-04-23,MO,Newton,202,14691,29145
2021-04-24,MO,Newton,30,14721,29145
2021-04-25,MO,Newton,17,14738,29145
2021-04-26,MO,Newton,58,14796,29145
2021-04-27,MO,Newton,94,14890,29145
2021-04-28,MO,Newton,88,14978,29145
2021-04-29,MO,Newton,180,15158,29145
2021-04-30,MO,Newton,131,15289,29145
2021-05-01,MO,Newton,30,15319,29145
2021-05-02,MO,Newton,23,15342,29145
2021-05-03,MO,Newton,98,15440,29145
2021-05-04,MO,Newton,152,15592,29145
2021-05-05,MO,Newton,77,15669,29145
2021-05-06,MO,Newton,73,15742,29145
2021-05-07,MO,Newton,79,15821,29145
2021-05-08,MO,Newton,38,15859,29145
2021-05-09,MO,Newton,13,15872,29145
2021-05-10,MO,Newton,67,15939,29145
2021-05-11,MO,Newton,92,16031,29145
2021-05-12,MO,Newton,59,16090,29145
2021-05-13,MO,Newton,103,16193,29145
2021-05-14,MO,Newton,100,16293,29145
2021-05-15,MO,Newton,30,16323,29145
2021-05-16,MO,Newton,19,16342,29145
2021-05-17,MO,Newton,61,16403,29145
2021-05-18,MO,Newton,110,16513,29145
2021-05-19,MO,Newton,79,16592,29145
2021-05-20,MO,Newton,81,16673,29145
2021-05-21,MO,Newton,92,16765,29145
2021-05-22,MO,Newton,48,16813,29145
2021-05-23,MO,Newton,15,16828,29145
2021-05-24,MO,Newton,47,16875,29145
2021-05-25,MO,Newton,34,16909,29145
2021-05-26,MO,Newton,44,16953,29145
2021-05-27,MO,Newton,21,16974,29145
2020-12-18,MO,Nodaway,1,1,29147
2020-12-20,MO,Nodaway,1,2,29147
2020-12-21,MO,Nodaway,2,4,29147
2020-12-22,MO,Nodaway,7,11,29147
2020-12-23,MO,Nodaway,35,46,29147
2020-12-27,MO,Nodaway,19,65,29147
2020-12-28,MO,Nodaway,167,232,29147
2020-12-29,MO,Nodaway,25,257,29147
2020-12-30,MO,Nodaway,81,338,29147
2020-12-31,MO,Nodaway,19,357,29147
2021-01-02,MO,Nodaway,26,383,29147
2021-01-03,MO,Nodaway,11,394,29147
2021-01-04,MO,Nodaway,22,416,29147
2021-01-05,MO,Nodaway,46,462,29147
2021-01-06,MO,Nodaway,11,473,29147
2021-01-07,MO,Nodaway,3,476,29147
2021-01-08,MO,Nodaway,2,478,29147
2021-01-10,MO,Nodaway,2,480,29147
2021-01-11,MO,Nodaway,7,487,29147
2021-01-12,MO,Nodaway,73,560,29147
2021-01-13,MO,Nodaway,77,637,29147
2021-01-14,MO,Nodaway,10,647,29147
2021-01-15,MO,Nodaway,26,673,29147
2021-01-16,MO,Nodaway,3,676,29147
2021-01-17,MO,Nodaway,1,677,29147
2021-01-18,MO,Nodaway,5,682,29147
2021-01-19,MO,Nodaway,18,700,29147
2021-01-20,MO,Nodaway,104,804,29147
2021-01-21,MO,Nodaway,10,814,29147
2021-01-22,MO,Nodaway,103,917,29147
2021-01-23,MO,Nodaway,4,921,29147
2021-01-25,MO,Nodaway,75,996,29147
2021-01-26,MO,Nodaway,674,1670,29147
2021-01-27,MO,Nodaway,137,1807,29147
2021-01-28,MO,Nodaway,127,1934,29147
2021-01-29,MO,Nodaway,48,1982,29147
2021-01-30,MO,Nodaway,31,2013,29147
2021-01-31,MO,Nodaway,6,2019,29147
2021-02-01,MO,Nodaway,21,2040,29147
2021-02-02,MO,Nodaway,129,2169,29147
2021-02-03,MO,Nodaway,147,2316,29147
2021-02-04,MO,Nodaway,1021,3337,29147
2021-02-05,MO,Nodaway,30,3367,29147
2021-02-06,MO,Nodaway,2,3369,29147
2021-02-07,MO,Nodaway,2,3371,29147
2021-02-08,MO,Nodaway,41,3412,29147
2021-02-09,MO,Nodaway,78,3490,29147
2021-02-10,MO,Nodaway,81,3571,29147
2021-02-11,MO,Nodaway,384,3955,29147
2021-02-12,MO,Nodaway,128,4083,29147
2021-02-13,MO,Nodaway,14,4097,29147
2021-02-14,MO,Nodaway,7,4104,29147
2021-02-15,MO,Nodaway,10,4114,29147
2021-02-16,MO,Nodaway,33,4147,29147
2021-02-17,MO,Nodaway,712,4859,29147
2021-02-18,MO,Nodaway,18,4877,29147
2021-02-19,MO,Nodaway,60,4937,29147
2021-02-20,MO,Nodaway,4,4941,29147
2021-02-22,MO,Nodaway,43,4984,29147
2021-02-23,MO,Nodaway,39,5023,29147
2021-02-24,MO,Nodaway,60,5083,29147
2021-02-25,MO,Nodaway,120,5203,29147
2021-02-26,MO,Nodaway,1063,6266,29147
2021-02-27,MO,Nodaway,17,6283,29147
2021-02-28,MO,Nodaway,4,6287,29147
2021-03-01,MO,Nodaway,98,6385,29147
2021-03-02,MO,Nodaway,98,6483,29147
2021-03-03,MO,Nodaway,107,6590,29147
2021-03-04,MO,Nodaway,157,6747,29147
2021-03-05,MO,Nodaway,69,6816,29147
2021-03-06,MO,Nodaway,14,6830,29147
2021-03-07,MO,Nodaway,7,6837,29147
2021-03-08,MO,Nodaway,34,6871,29147
2021-03-09,MO,Nodaway,66,6937,29147
2021-03-10,MO,Nodaway,538,7475,29147
2021-03-11,MO,Nodaway,90,7565,29147
2021-03-12,MO,Nodaway,65,7630,29147
2021-03-13,MO,Nodaway,5,7635,29147
2021-03-14,MO,Nodaway,3,7638,29147
2021-03-15,MO,Nodaway,525,8163,29147
2021-03-16,MO,Nodaway,45,8208,29147
2021-03-17,MO,Nodaway,78,8286,29147
2021-03-18,MO,Nodaway,185,8471,29147
2021-03-19,MO,Nodaway,103,8574,29147
2021-03-20,MO,Nodaway,27,8601,29147
2021-03-21,MO,Nodaway,10,8611,29147
2021-03-22,MO,Nodaway,39,8650,29147
2021-03-23,MO,Nodaway,58,8708,29147
2021-03-24,MO,Nodaway,383,9091,29147
2021-03-25,MO,Nodaway,118,9209,29147
2021-03-26,MO,Nodaway,49,9258,29147
2021-03-27,MO,Nodaway,24,9282,29147
2021-03-28,MO,Nodaway,17,9299,29147
2021-03-29,MO,Nodaway,78,9377,29147
2021-03-30,MO,Nodaway,83,9460,29147
2021-03-31,MO,Nodaway,450,9910,29147
2021-04-01,MO,Nodaway,119,10029,29147
2021-04-02,MO,Nodaway,66,10095,29147
2021-04-03,MO,Nodaway,16,10111,29147
2021-04-04,MO,Nodaway,4,10115,29147
2021-04-05,MO,Nodaway,42,10157,29147
2021-04-06,MO,Nodaway,154,10311,29147
2021-04-07,MO,Nodaway,848,11159,29147
2021-04-08,MO,Nodaway,190,11349,29147
2021-04-09,MO,Nodaway,98,11447,29147
2021-04-10,MO,Nodaway,27,11474,29147
2021-04-11,MO,Nodaway,14,11488,29147
2021-04-12,MO,Nodaway,46,11534,29147
2021-04-13,MO,Nodaway,81,11615,29147
2021-04-14,MO,Nodaway,482,12097,29147
2021-04-15,MO,Nodaway,119,12216,29147
2021-04-16,MO,Nodaway,77,12293,29147
2021-04-17,MO,Nodaway,14,12307,29147
2021-04-18,MO,Nodaway,16,12323,29147
2021-04-19,MO,Nodaway,41,12364,29147
2021-04-20,MO,Nodaway,80,12444,29147
2021-04-21,MO,Nodaway,178,12622,29147
2021-04-22,MO,Nodaway,63,12685,29147
2021-04-23,MO,Nodaway,53,12738,29147
2021-04-24,MO,Nodaway,25,12763,29147
2021-04-25,MO,Nodaway,12,12775,29147
2021-04-26,MO,Nodaway,38,12813,29147
2021-04-27,MO,Nodaway,59,12872,29147
2021-04-28,MO,Nodaway,296,13168,29147
2021-04-29,MO,Nodaway,57,13225,29147
2021-04-30,MO,Nodaway,43,13268,29147
2021-05-01,MO,Nodaway,26,13294,29147
2021-05-02,MO,Nodaway,5,13299,29147
2021-05-03,MO,Nodaway,32,13331,29147
2021-05-04,MO,Nodaway,51,13382,29147
2021-05-05,MO,Nodaway,360,13742,29147
2021-05-06,MO,Nodaway,51,13793,29147
2021-05-07,MO,Nodaway,61,13854,29147
2021-05-08,MO,Nodaway,19,13873,29147
2021-05-09,MO,Nodaway,6,13879,29147
2021-05-10,MO,Nodaway,35,13914,29147
2021-05-11,MO,Nodaway,32,13946,29147
2021-05-12,MO,Nodaway,237,14183,29147
2021-05-13,MO,Nodaway,27,14210,29147
2021-05-14,MO,Nodaway,49,14259,29147
2021-05-15,MO,Nodaway,28,14287,29147
2021-05-16,MO,Nodaway,12,14299,29147
2021-05-17,MO,Nodaway,46,14345,29147
2021-05-18,MO,Nodaway,20,14365,29147
2021-05-19,MO,Nodaway,74,14439,29147
2021-05-20,MO,Nodaway,51,14490,29147
2021-05-21,MO,Nodaway,39,14529,29147
2021-05-22,MO,Nodaway,17,14546,29147
2021-05-23,MO,Nodaway,8,14554,29147
2021-05-24,MO,Nodaway,20,14574,29147
2021-05-25,MO,Nodaway,19,14593,29147
2021-05-26,MO,Nodaway,11,14604,29147
2021-05-27,MO,Nodaway,23,14627,29147
2020-12-16,MO,Oregon,2,2,29149
2020-12-19,MO,Oregon,1,3,29149
2020-12-22,MO,Oregon,9,12,29149
2020-12-23,MO,Oregon,21,33,29149
2020-12-24,MO,Oregon,3,36,29149
2020-12-26,MO,Oregon,1,37,29149
2020-12-28,MO,Oregon,12,49,29149
2020-12-29,MO,Oregon,10,59,29149
2020-12-30,MO,Oregon,12,71,29149
2020-12-31,MO,Oregon,2,73,29149
2021-01-04,MO,Oregon,1,74,29149
2021-01-05,MO,Oregon,50,124,29149
2021-01-06,MO,Oregon,8,132,29149
2021-01-07,MO,Oregon,5,137,29149
2021-01-09,MO,Oregon,5,142,29149
2021-01-11,MO,Oregon,21,163,29149
2021-01-12,MO,Oregon,18,181,29149
2021-01-13,MO,Oregon,2,183,29149
2021-01-14,MO,Oregon,5,188,29149
2021-01-15,MO,Oregon,1,189,29149
2021-01-18,MO,Oregon,3,192,29149
2021-01-19,MO,Oregon,4,196,29149
2021-01-20,MO,Oregon,9,205,29149
2021-01-21,MO,Oregon,2,207,29149
2021-01-22,MO,Oregon,7,214,29149
2021-01-23,MO,Oregon,1,215,29149
2021-01-25,MO,Oregon,26,241,29149
2021-01-26,MO,Oregon,20,261,29149
2021-01-27,MO,Oregon,21,282,29149
2021-01-28,MO,Oregon,41,323,29149
2021-01-29,MO,Oregon,140,463,29149
2021-01-30,MO,Oregon,3,466,29149
2021-02-01,MO,Oregon,19,485,29149
2021-02-02,MO,Oregon,85,570,29149
2021-02-03,MO,Oregon,29,599,29149
2021-02-04,MO,Oregon,3,602,29149
2021-02-05,MO,Oregon,126,728,29149
2021-02-06,MO,Oregon,6,734,29149
2021-02-08,MO,Oregon,46,780,29149
2021-02-09,MO,Oregon,13,793,29149
2021-02-10,MO,Oregon,27,820,29149
2021-02-11,MO,Oregon,8,828,29149
2021-02-12,MO,Oregon,25,853,29149
2021-02-13,MO,Oregon,14,867,29149
2021-02-14,MO,Oregon,7,874,29149
2021-02-15,MO,Oregon,14,888,29149
2021-02-16,MO,Oregon,16,904,29149
2021-02-17,MO,Oregon,7,911,29149
2021-02-18,MO,Oregon,18,929,29149
2021-02-19,MO,Oregon,22,951,29149
2021-02-20,MO,Oregon,10,961,29149
2021-02-21,MO,Oregon,7,968,29149
2021-02-22,MO,Oregon,14,982,29149
2021-02-23,MO,Oregon,33,1015,29149
2021-02-24,MO,Oregon,7,1022,29149
2021-02-25,MO,Oregon,16,1038,29149
2021-02-26,MO,Oregon,288,1326,29149
2021-02-27,MO,Oregon,2,1328,29149
2021-02-28,MO,Oregon,10,1338,29149
2021-03-01,MO,Oregon,36,1374,29149
2021-03-02,MO,Oregon,95,1469,29149
2021-03-03,MO,Oregon,15,1484,29149
2021-03-04,MO,Oregon,14,1498,29149
2021-03-05,MO,Oregon,186,1684,29149
2021-03-06,MO,Oregon,3,1687,29149
2021-03-08,MO,Oregon,24,1711,29149
2021-03-09,MO,Oregon,70,1781,29149
2021-03-10,MO,Oregon,37,1818,29149
2021-03-11,MO,Oregon,17,1835,29149
2021-03-12,MO,Oregon,24,1859,29149
2021-03-13,MO,Oregon,2,1861,29149
2021-03-14,MO,Oregon,13,1874,29149
2021-03-15,MO,Oregon,46,1920,29149
2021-03-16,MO,Oregon,65,1985,29149
2021-03-17,MO,Oregon,14,1999,29149
2021-03-18,MO,Oregon,68,2067,29149
2021-03-19,MO,Oregon,40,2107,29149
2021-03-20,MO,Oregon,24,2131,29149
2021-03-21,MO,Oregon,1,2132,29149
2021-03-22,MO,Oregon,19,2151,29149
2021-03-23,MO,Oregon,58,2209,29149
2021-03-24,MO,Oregon,17,2226,29149
2021-03-25,MO,Oregon,18,2244,29149
2021-03-26,MO,Oregon,173,2417,29149
2021-03-27,MO,Oregon,4,2421,29149
2021-03-29,MO,Oregon,15,2436,29149
2021-03-30,MO,Oregon,88,2524,29149
2021-03-31,MO,Oregon,31,2555,29149
2021-04-01,MO,Oregon,45,2600,29149
2021-04-02,MO,Oregon,5,2605,29149
2021-04-04,MO,Oregon,1,2606,29149
2021-04-05,MO,Oregon,20,2626,29149
2021-04-06,MO,Oregon,90,2716,29149
2021-04-07,MO,Oregon,40,2756,29149
2021-04-08,MO,Oregon,38,2794,29149
2021-04-09,MO,Oregon,59,2853,29149
2021-04-10,MO,Oregon,9,2862,29149
2021-04-11,MO,Oregon,10,2872,29149
2021-04-12,MO,Oregon,20,2892,29149
2021-04-13,MO,Oregon,58,2950,29149
2021-04-14,MO,Oregon,22,2972,29149
2021-04-15,MO,Oregon,51,3023,29149
2021-04-16,MO,Oregon,39,3062,29149
2021-04-17,MO,Oregon,17,3079,29149
2021-04-19,MO,Oregon,33,3112,29149
2021-04-20,MO,Oregon,16,3128,29149
2021-04-21,MO,Oregon,33,3161,29149
2021-04-22,MO,Oregon,22,3183,29149
2021-04-23,MO,Oregon,41,3224,29149
2021-04-24,MO,Oregon,2,3226,29149
2021-04-26,MO,Oregon,14,3240,29149
2021-04-27,MO,Oregon,19,3259,29149
2021-04-28,MO,Oregon,33,3292,29149
2021-04-29,MO,Oregon,34,3326,29149
2021-04-30,MO,Oregon,13,3339,29149
2021-05-02,MO,Oregon,1,3340,29149
2021-05-03,MO,Oregon,8,3348,29149
2021-05-04,MO,Oregon,10,3358,29149
2021-05-05,MO,Oregon,17,3375,29149
2021-05-06,MO,Oregon,14,3389,29149
2021-05-07,MO,Oregon,12,3401,29149
2021-05-08,MO,Oregon,6,3407,29149
2021-05-09,MO,Oregon,6,3413,29149
2021-05-10,MO,Oregon,34,3447,29149
2021-05-11,MO,Oregon,21,3468,29149
2021-05-12,MO,Oregon,21,3489,29149
2021-05-13,MO,Oregon,25,3514,29149
2021-05-14,MO,Oregon,20,3534,29149
2021-05-15,MO,Oregon,8,3542,29149
2021-05-16,MO,Oregon,1,3543,29149
2021-05-17,MO,Oregon,19,3562,29149
2021-05-18,MO,Oregon,9,3571,29149
2021-05-19,MO,Oregon,4,3575,29149
2021-05-20,MO,Oregon,10,3585,29149
2021-05-21,MO,Oregon,13,3598,29149
2021-05-22,MO,Oregon,12,3610,29149
2021-05-23,MO,Oregon,1,3611,29149
2021-05-24,MO,Oregon,16,3627,29149
2021-05-25,MO,Oregon,5,3632,29149
2021-05-26,MO,Oregon,14,3646,29149
2021-05-27,MO,Oregon,4,3650,29149
2020-12-15,MO,Osage,1,1,29151
2020-12-16,MO,Osage,10,11,29151
2020-12-17,MO,Osage,21,32,29151
2020-12-18,MO,Osage,28,60,29151
2020-12-19,MO,Osage,2,62,29151
2020-12-20,MO,Osage,1,63,29151
2020-12-21,MO,Osage,18,81,29151
2020-12-22,MO,Osage,5,86,29151
2020-12-23,MO,Osage,3,89,29151
2020-12-24,MO,Osage,1,90,29151
2020-12-28,MO,Osage,3,93,29151
2020-12-30,MO,Osage,3,96,29151
2020-12-31,MO,Osage,3,99,29151
2021-01-01,MO,Osage,1,100,29151
2021-01-04,MO,Osage,5,105,29151
2021-01-05,MO,Osage,5,110,29151
2021-01-06,MO,Osage,20,130,29151
2021-01-07,MO,Osage,36,166,29151
2021-01-08,MO,Osage,25,191,29151
2021-01-09,MO,Osage,1,192,29151
2021-01-11,MO,Osage,21,213,29151
2021-01-12,MO,Osage,7,220,29151
2021-01-13,MO,Osage,65,285,29151
2021-01-14,MO,Osage,12,297,29151
2021-01-15,MO,Osage,17,314,29151
2021-01-16,MO,Osage,3,317,29151
2021-01-18,MO,Osage,34,351,29151
2021-01-19,MO,Osage,15,366,29151
2021-01-20,MO,Osage,14,380,29151
2021-01-21,MO,Osage,26,406,29151
2021-01-22,MO,Osage,73,479,29151
2021-01-23,MO,Osage,54,533,29151
2021-01-25,MO,Osage,78,611,29151
2021-01-26,MO,Osage,32,643,29151
2021-01-27,MO,Osage,45,688,29151
2021-01-28,MO,Osage,32,720,29151
2021-01-29,MO,Osage,141,861,29151
2021-01-30,MO,Osage,68,929,29151
2021-01-31,MO,Osage,6,935,29151
2021-02-01,MO,Osage,196,1131,29151
2021-02-02,MO,Osage,10,1141,29151
2021-02-03,MO,Osage,16,1157,29151
2021-02-04,MO,Osage,70,1227,29151
2021-02-05,MO,Osage,67,1294,29151
2021-02-06,MO,Osage,23,1317,29151
2021-02-08,MO,Osage,108,1425,29151
2021-02-09,MO,Osage,23,1448,29151
2021-02-10,MO,Osage,88,1536,29151
2021-02-11,MO,Osage,75,1611,29151
2021-02-12,MO,Osage,72,1683,29151
2021-02-13,MO,Osage,65,1748,29151
2021-02-14,MO,Osage,2,1750,29151
2021-02-15,MO,Osage,14,1764,29151
2021-02-16,MO,Osage,22,1786,29151
2021-02-17,MO,Osage,21,1807,29151
2021-02-18,MO,Osage,55,1862,29151
2021-02-19,MO,Osage,172,2034,29151
2021-02-20,MO,Osage,68,2102,29151
2021-02-22,MO,Osage,292,2394,29151
2021-02-23,MO,Osage,18,2412,29151
2021-02-24,MO,Osage,36,2448,29151
2021-02-25,MO,Osage,32,2480,29151
2021-02-26,MO,Osage,121,2601,29151
2021-02-27,MO,Osage,33,2634,29151
2021-02-28,MO,Osage,2,2636,29151
2021-03-01,MO,Osage,267,2903,29151
2021-03-02,MO,Osage,20,2923,29151
2021-03-03,MO,Osage,41,2964,29151
2021-03-04,MO,Osage,67,3031,29151
2021-03-05,MO,Osage,55,3086,29151
2021-03-06,MO,Osage,4,3090,29151
2021-03-07,MO,Osage,8,3098,29151
2021-03-08,MO,Osage,216,3314,29151
2021-03-09,MO,Osage,14,3328,29151
2021-03-10,MO,Osage,100,3428,29151
2021-03-11,MO,Osage,86,3514,29151
2021-03-12,MO,Osage,50,3564,29151
2021-03-13,MO,Osage,6,3570,29151
2021-03-15,MO,Osage,147,3717,29151
2021-03-16,MO,Osage,124,3841,29151
2021-03-17,MO,Osage,38,3879,29151
2021-03-18,MO,Osage,33,3912,29151
2021-03-19,MO,Osage,58,3970,29151
2021-03-20,MO,Osage,8,3978,29151
2021-03-21,MO,Osage,15,3993,29151
2021-03-22,MO,Osage,260,4253,29151
2021-03-23,MO,Osage,26,4279,29151
2021-03-24,MO,Osage,56,4335,29151
2021-03-25,MO,Osage,70,4405,29151
2021-03-26,MO,Osage,69,4474,29151
2021-03-27,MO,Osage,27,4501,29151
2021-03-28,MO,Osage,4,4505,29151
2021-03-29,MO,Osage,217,4722,29151
2021-03-30,MO,Osage,31,4753,29151
2021-03-31,MO,Osage,44,4797,29151
2021-04-01,MO,Osage,125,4922,29151
2021-04-02,MO,Osage,96,5018,29151
2021-04-03,MO,Osage,1,5019,29151
2021-04-04,MO,Osage,2,5021,29151
2021-04-05,MO,Osage,280,5301,29151
2021-04-06,MO,Osage,43,5344,29151
2021-04-07,MO,Osage,56,5400,29151
2021-04-08,MO,Osage,57,5457,29151
2021-04-09,MO,Osage,75,5532,29151
2021-04-10,MO,Osage,39,5571,29151
2021-04-11,MO,Osage,1,5572,29151
2021-04-12,MO,Osage,128,5700,29151
2021-04-13,MO,Osage,45,5745,29151
2021-04-14,MO,Osage,52,5797,29151
2021-04-15,MO,Osage,82,5879,29151
2021-04-16,MO,Osage,45,5924,29151
2021-04-17,MO,Osage,23,5947,29151
2021-04-18,MO,Osage,1,5948,29151
2021-04-19,MO,Osage,47,5995,29151
2021-04-20,MO,Osage,23,6018,29151
2021-04-21,MO,Osage,34,6052,29151
2021-04-22,MO,Osage,29,6081,29151
2021-04-23,MO,Osage,42,6123,29151
2021-04-24,MO,Osage,2,6125,29151
2021-04-25,MO,Osage,3,6128,29151
2021-04-26,MO,Osage,90,6218,29151
2021-04-27,MO,Osage,23,6241,29151
2021-04-28,MO,Osage,15,6256,29151
2021-04-29,MO,Osage,22,6278,29151
2021-04-30,MO,Osage,120,6398,29151
2021-05-01,MO,Osage,14,6412,29151
2021-05-02,MO,Osage,8,6420,29151
2021-05-03,MO,Osage,15,6435,29151
2021-05-04,MO,Osage,19,6454,29151
2021-05-05,MO,Osage,17,6471,29151
2021-05-06,MO,Osage,23,6494,29151
2021-05-07,MO,Osage,15,6509,29151
2021-05-08,MO,Osage,9,6518,29151
2021-05-10,MO,Osage,117,6635,29151
2021-05-11,MO,Osage,17,6652,29151
2021-05-12,MO,Osage,8,6660,29151
2021-05-13,MO,Osage,13,6673,29151
2021-05-14,MO,Osage,38,6711,29151
2021-05-15,MO,Osage,7,6718,29151
2021-05-16,MO,Osage,4,6722,29151
2021-05-17,MO,Osage,34,6756,29151
2021-05-18,MO,Osage,18,6774,29151
2021-05-19,MO,Osage,13,6787,29151
2021-05-20,MO,Osage,14,6801,29151
2021-05-21,MO,Osage,40,6841,29151
2021-05-22,MO,Osage,2,6843,29151
2021-05-23,MO,Osage,4,6847,29151
2021-05-24,MO,Osage,8,6855,29151
2021-05-25,MO,Osage,7,6862,29151
2021-05-26,MO,Osage,5,6867,29151
2021-05-27,MO,Osage,6,6873,29151
2020-12-22,MO,Ozark,6,6,29153
2020-12-23,MO,Ozark,5,11,29153
2020-12-24,MO,Ozark,1,12,29153
2020-12-28,MO,Ozark,4,16,29153
2020-12-29,MO,Ozark,1,17,29153
2020-12-30,MO,Ozark,10,27,29153
2020-12-31,MO,Ozark,26,53,29153
2021-01-02,MO,Ozark,1,54,29153
2021-01-04,MO,Ozark,2,56,29153
2021-01-05,MO,Ozark,1,57,29153
2021-01-06,MO,Ozark,5,62,29153
2021-01-07,MO,Ozark,2,64,29153
2021-01-09,MO,Ozark,7,71,29153
2021-01-11,MO,Ozark,3,74,29153
2021-01-13,MO,Ozark,1,75,29153
2021-01-15,MO,Ozark,1,76,29153
2021-01-18,MO,Ozark,2,78,29153
2021-01-19,MO,Ozark,4,82,29153
2021-01-20,MO,Ozark,10,92,29153
2021-01-21,MO,Ozark,3,95,29153
2021-01-22,MO,Ozark,10,105,29153
2021-01-23,MO,Ozark,3,108,29153
2021-01-25,MO,Ozark,4,112,29153
2021-01-26,MO,Ozark,6,118,29153
2021-01-27,MO,Ozark,16,134,29153
2021-01-28,MO,Ozark,74,208,29153
2021-01-29,MO,Ozark,124,332,29153
2021-01-30,MO,Ozark,5,337,29153
2021-02-01,MO,Ozark,14,351,29153
2021-02-02,MO,Ozark,79,430,29153
2021-02-03,MO,Ozark,107,537,29153
2021-02-04,MO,Ozark,71,608,29153
2021-02-05,MO,Ozark,20,628,29153
2021-02-06,MO,Ozark,23,651,29153
2021-02-08,MO,Ozark,8,659,29153
2021-02-09,MO,Ozark,66,725,29153
2021-02-10,MO,Ozark,21,746,29153
2021-02-11,MO,Ozark,9,755,29153
2021-02-12,MO,Ozark,16,771,29153
2021-02-13,MO,Ozark,5,776,29153
2021-02-15,MO,Ozark,1,777,29153
2021-02-16,MO,Ozark,4,781,29153
2021-02-17,MO,Ozark,1,782,29153
2021-02-18,MO,Ozark,7,789,29153
2021-02-19,MO,Ozark,8,797,29153
2021-02-20,MO,Ozark,2,799,29153
2021-02-22,MO,Ozark,1,800,29153
2021-02-23,MO,Ozark,193,993,29153
2021-02-24,MO,Ozark,11,1004,29153
2021-02-25,MO,Ozark,23,1027,29153
2021-02-26,MO,Ozark,107,1134,29153
2021-02-27,MO,Ozark,28,1162,29153
2021-02-28,MO,Ozark,12,1174,29153
2021-03-01,MO,Ozark,5,1179,29153
2021-03-02,MO,Ozark,38,1217,29153
2021-03-03,MO,Ozark,125,1342,29153
2021-03-04,MO,Ozark,11,1353,29153
2021-03-05,MO,Ozark,16,1369,29153
2021-03-06,MO,Ozark,9,1378,29153
2021-03-08,MO,Ozark,13,1391,29153
2021-03-09,MO,Ozark,69,1460,29153
2021-03-10,MO,Ozark,77,1537,29153
2021-03-11,MO,Ozark,25,1562,29153
2021-03-12,MO,Ozark,46,1608,29153
2021-03-13,MO,Ozark,5,1613,29153
2021-03-15,MO,Ozark,12,1625,29153
2021-03-16,MO,Ozark,7,1632,29153
2021-03-17,MO,Ozark,11,1643,29153
2021-03-18,MO,Ozark,16,1659,29153
2021-03-19,MO,Ozark,4,1663,29153
2021-03-20,MO,Ozark,8,1671,29153
2021-03-21,MO,Ozark,2,1673,29153
2021-03-22,MO,Ozark,10,1683,29153
2021-03-23,MO,Ozark,188,1871,29153
2021-03-24,MO,Ozark,18,1889,29153
2021-03-25,MO,Ozark,10,1899,29153
2021-03-26,MO,Ozark,165,2064,29153
2021-03-27,MO,Ozark,8,2072,29153
2021-03-28,MO,Ozark,1,2073,29153
2021-03-29,MO,Ozark,5,2078,29153
2021-03-30,MO,Ozark,24,2102,29153
2021-03-31,MO,Ozark,18,2120,29153
2021-04-01,MO,Ozark,18,2138,29153
2021-04-02,MO,Ozark,17,2155,29153
2021-04-03,MO,Ozark,2,2157,29153
2021-04-04,MO,Ozark,1,2158,29153
2021-04-05,MO,Ozark,14,2172,29153
2021-04-06,MO,Ozark,135,2307,29153
2021-04-07,MO,Ozark,26,2333,29153
2021-04-08,MO,Ozark,18,2351,29153
2021-04-09,MO,Ozark,37,2388,29153
2021-04-10,MO,Ozark,6,2394,29153
2021-04-11,MO,Ozark,1,2395,29153
2021-04-12,MO,Ozark,20,2415,29153
2021-04-13,MO,Ozark,17,2432,29153
2021-04-14,MO,Ozark,16,2448,29153
2021-04-15,MO,Ozark,13,2461,29153
2021-04-16,MO,Ozark,58,2519,29153
2021-04-17,MO,Ozark,7,2526,29153
2021-04-18,MO,Ozark,4,2530,29153
2021-04-19,MO,Ozark,10,2540,29153
2021-04-20,MO,Ozark,6,2546,29153
2021-04-21,MO,Ozark,17,2563,29153
2021-04-22,MO,Ozark,8,2571,29153
2021-04-23,MO,Ozark,161,2732,29153
2021-04-24,MO,Ozark,7,2739,29153
2021-04-26,MO,Ozark,4,2743,29153
2021-04-27,MO,Ozark,14,2757,29153
2021-04-28,MO,Ozark,12,2769,29153
2021-04-29,MO,Ozark,9,2778,29153
2021-04-30,MO,Ozark,14,2792,29153
2021-05-01,MO,Ozark,5,2797,29153
2021-05-02,MO,Ozark,3,2800,29153
2021-05-03,MO,Ozark,12,2812,29153
2021-05-04,MO,Ozark,113,2925,29153
2021-05-05,MO,Ozark,10,2935,29153
2021-05-06,MO,Ozark,10,2945,29153
2021-05-07,MO,Ozark,10,2955,29153
2021-05-08,MO,Ozark,2,2957,29153
2021-05-09,MO,Ozark,1,2958,29153
2021-05-10,MO,Ozark,8,2966,29153
2021-05-11,MO,Ozark,10,2976,29153
2021-05-12,MO,Ozark,18,2994,29153
2021-05-13,MO,Ozark,5,2999,29153
2021-05-14,MO,Ozark,55,3054,29153
2021-05-15,MO,Ozark,8,3062,29153
2021-05-16,MO,Ozark,3,3065,29153
2021-05-17,MO,Ozark,6,3071,29153
2021-05-18,MO,Ozark,3,3074,29153
2021-05-19,MO,Ozark,11,3085,29153
2021-05-20,MO,Ozark,6,3091,29153
2021-05-21,MO,Ozark,44,3135,29153
2021-05-22,MO,Ozark,4,3139,29153
2021-05-23,MO,Ozark,3,3142,29153
2021-05-24,MO,Ozark,6,3148,29153
2021-05-25,MO,Ozark,7,3155,29153
2021-05-26,MO,Ozark,11,3166,29153
2020-12-22,MO,Pemiscot,2,2,29155
2020-12-29,MO,Pemiscot,44,46,29155
2020-12-30,MO,Pemiscot,29,75,29155
2020-12-31,MO,Pemiscot,6,81,29155
2021-01-01,MO,Pemiscot,1,82,29155
2021-01-04,MO,Pemiscot,2,84,29155
2021-01-05,MO,Pemiscot,1,85,29155
2021-01-06,MO,Pemiscot,2,87,29155
2021-01-07,MO,Pemiscot,3,90,29155
2021-01-08,MO,Pemiscot,3,93,29155
2021-01-10,MO,Pemiscot,1,94,29155
2021-01-11,MO,Pemiscot,52,146,29155
2021-01-12,MO,Pemiscot,6,152,29155
2021-01-13,MO,Pemiscot,1,153,29155
2021-01-14,MO,Pemiscot,5,158,29155
2021-01-15,MO,Pemiscot,4,162,29155
2021-01-18,MO,Pemiscot,23,185,29155
2021-01-19,MO,Pemiscot,62,247,29155
2021-01-20,MO,Pemiscot,25,272,29155
2021-01-21,MO,Pemiscot,33,305,29155
2021-01-22,MO,Pemiscot,122,427,29155
2021-01-23,MO,Pemiscot,2,429,29155
2021-01-25,MO,Pemiscot,55,484,29155
2021-01-26,MO,Pemiscot,57,541,29155
2021-01-27,MO,Pemiscot,90,631,29155
2021-01-28,MO,Pemiscot,11,642,29155
2021-01-29,MO,Pemiscot,13,655,29155
2021-01-30,MO,Pemiscot,2,657,29155
2021-01-31,MO,Pemiscot,1,658,29155
2021-02-01,MO,Pemiscot,9,667,29155
2021-02-02,MO,Pemiscot,24,691,29155
2021-02-03,MO,Pemiscot,64,755,29155
2021-02-04,MO,Pemiscot,40,795,29155
2021-02-05,MO,Pemiscot,170,965,29155
2021-02-06,MO,Pemiscot,2,967,29155
2021-02-08,MO,Pemiscot,67,1034,29155
2021-02-09,MO,Pemiscot,30,1064,29155
2021-02-10,MO,Pemiscot,3,1067,29155
2021-02-11,MO,Pemiscot,4,1071,29155
2021-02-12,MO,Pemiscot,20,1091,29155
2021-02-13,MO,Pemiscot,1,1092,29155
2021-02-15,MO,Pemiscot,11,1103,29155
2021-02-16,MO,Pemiscot,47,1150,29155
2021-02-17,MO,Pemiscot,19,1169,29155
2021-02-18,MO,Pemiscot,43,1212,29155
2021-02-19,MO,Pemiscot,82,1294,29155
2021-02-20,MO,Pemiscot,106,1400,29155
2021-02-22,MO,Pemiscot,60,1460,29155
2021-02-23,MO,Pemiscot,69,1529,29155
2021-02-24,MO,Pemiscot,61,1590,29155
2021-02-25,MO,Pemiscot,64,1654,29155
2021-02-26,MO,Pemiscot,179,1833,29155
2021-02-27,MO,Pemiscot,229,2062,29155
2021-03-01,MO,Pemiscot,38,2100,29155
2021-03-02,MO,Pemiscot,75,2175,29155
2021-03-03,MO,Pemiscot,52,2227,29155
2021-03-04,MO,Pemiscot,80,2307,29155
2021-03-05,MO,Pemiscot,58,2365,29155
2021-03-06,MO,Pemiscot,108,2473,29155
2021-03-07,MO,Pemiscot,2,2475,29155
2021-03-08,MO,Pemiscot,16,2491,29155
2021-03-09,MO,Pemiscot,44,2535,29155
2021-03-10,MO,Pemiscot,41,2576,29155
2021-03-11,MO,Pemiscot,19,2595,29155
2021-03-12,MO,Pemiscot,42,2637,29155
2021-03-13,MO,Pemiscot,1,2638,29155
2021-03-15,MO,Pemiscot,194,2832,29155
2021-03-16,MO,Pemiscot,52,2884,29155
2021-03-17,MO,Pemiscot,54,2938,29155
2021-03-18,MO,Pemiscot,49,2987,29155
2021-03-19,MO,Pemiscot,63,3050,29155
2021-03-20,MO,Pemiscot,1,3051,29155
2021-03-22,MO,Pemiscot,54,3105,29155
2021-03-23,MO,Pemiscot,108,3213,29155
2021-03-24,MO,Pemiscot,19,3232,29155
2021-03-25,MO,Pemiscot,119,3351,29155
2021-03-26,MO,Pemiscot,49,3400,29155
2021-03-29,MO,Pemiscot,32,3432,29155
2021-03-30,MO,Pemiscot,69,3501,29155
2021-03-31,MO,Pemiscot,66,3567,29155
2021-04-01,MO,Pemiscot,33,3600,29155
2021-04-02,MO,Pemiscot,27,3627,29155
2021-04-03,MO,Pemiscot,1,3628,29155
2021-04-04,MO,Pemiscot,2,3630,29155
2021-04-05,MO,Pemiscot,11,3641,29155
2021-04-06,MO,Pemiscot,38,3679,29155
2021-04-07,MO,Pemiscot,19,3698,29155
2021-04-08,MO,Pemiscot,25,3723,29155
2021-04-09,MO,Pemiscot,40,3763,29155
2021-04-10,MO,Pemiscot,2,3765,29155
2021-04-11,MO,Pemiscot,1,3766,29155
2021-04-12,MO,Pemiscot,51,3817,29155
2021-04-13,MO,Pemiscot,33,3850,29155
2021-04-14,MO,Pemiscot,37,3887,29155
2021-04-15,MO,Pemiscot,22,3909,29155
2021-04-16,MO,Pemiscot,36,3945,29155
2021-04-17,MO,Pemiscot,1,3946,29155
2021-04-18,MO,Pemiscot,3,3949,29155
2021-04-19,MO,Pemiscot,32,3981,29155
2021-04-20,MO,Pemiscot,41,4022,29155
2021-04-21,MO,Pemiscot,20,4042,29155
2021-04-22,MO,Pemiscot,38,4080,29155
2021-04-23,MO,Pemiscot,27,4107,29155
2021-04-24,MO,Pemiscot,1,4108,29155
2021-04-25,MO,Pemiscot,2,4110,29155
2021-04-26,MO,Pemiscot,35,4145,29155
2021-04-27,MO,Pemiscot,40,4185,29155
2021-04-28,MO,Pemiscot,53,4238,29155
2021-04-29,MO,Pemiscot,32,4270,29155
2021-04-30,MO,Pemiscot,21,4291,29155
2021-05-01,MO,Pemiscot,1,4292,29155
2021-05-02,MO,Pemiscot,1,4293,29155
2021-05-03,MO,Pemiscot,17,4310,29155
2021-05-04,MO,Pemiscot,15,4325,29155
2021-05-05,MO,Pemiscot,41,4366,29155
2021-05-06,MO,Pemiscot,11,4377,29155
2021-05-07,MO,Pemiscot,31,4408,29155
2021-05-08,MO,Pemiscot,3,4411,29155
2021-05-09,MO,Pemiscot,2,4413,29155
2021-05-10,MO,Pemiscot,24,4437,29155
2021-05-11,MO,Pemiscot,10,4447,29155
2021-05-12,MO,Pemiscot,56,4503,29155
2021-05-13,MO,Pemiscot,14,4517,29155
2021-05-14,MO,Pemiscot,4,4521,29155
2021-05-15,MO,Pemiscot,4,4525,29155
2021-05-16,MO,Pemiscot,3,4528,29155
2021-05-17,MO,Pemiscot,19,4547,29155
2021-05-18,MO,Pemiscot,18,4565,29155
2021-05-19,MO,Pemiscot,15,4580,29155
2021-05-20,MO,Pemiscot,32,4612,29155
2021-05-21,MO,Pemiscot,9,4621,29155
2021-05-24,MO,Pemiscot,25,4646,29155
2021-05-25,MO,Pemiscot,30,4676,29155
2021-05-26,MO,Pemiscot,24,4700,29155
2021-05-27,MO,Pemiscot,5,4705,29155
2020-12-16,MO,Perry,1,1,29157
2020-12-17,MO,Perry,5,6,29157
2020-12-18,MO,Perry,7,13,29157
2020-12-19,MO,Perry,1,14,29157
2020-12-20,MO,Perry,1,15,29157
2020-12-21,MO,Perry,24,39,29157
2020-12-22,MO,Perry,28,67,29157
2020-12-23,MO,Perry,75,142,29157
2020-12-24,MO,Perry,5,147,29157
2020-12-26,MO,Perry,1,148,29157
2020-12-27,MO,Perry,2,150,29157
2020-12-28,MO,Perry,4,154,29157
2020-12-29,MO,Perry,12,166,29157
2020-12-30,MO,Perry,40,206,29157
2020-12-31,MO,Perry,7,213,29157
2021-01-02,MO,Perry,2,215,29157
2021-01-05,MO,Perry,6,221,29157
2021-01-06,MO,Perry,10,231,29157
2021-01-07,MO,Perry,14,245,29157
2021-01-08,MO,Perry,25,270,29157
2021-01-09,MO,Perry,9,279,29157
2021-01-10,MO,Perry,1,280,29157
2021-01-11,MO,Perry,125,405,29157
2021-01-12,MO,Perry,28,433,29157
2021-01-13,MO,Perry,142,575,29157
2021-01-14,MO,Perry,10,585,29157
2021-01-15,MO,Perry,38,623,29157
2021-01-16,MO,Perry,3,626,29157
2021-01-17,MO,Perry,1,627,29157
2021-01-18,MO,Perry,131,758,29157
2021-01-19,MO,Perry,66,824,29157
2021-01-20,MO,Perry,87,911,29157
2021-01-21,MO,Perry,57,968,29157
2021-01-22,MO,Perry,205,1173,29157
2021-01-23,MO,Perry,1,1174,29157
2021-01-25,MO,Perry,48,1222,29157
2021-01-26,MO,Perry,53,1275,29157
2021-01-27,MO,Perry,56,1331,29157
2021-01-28,MO,Perry,56,1387,29157
2021-01-29,MO,Perry,775,2162,29157
2021-01-30,MO,Perry,4,2166,29157
2021-01-31,MO,Perry,1,2167,29157
2021-02-01,MO,Perry,10,2177,29157
2021-02-02,MO,Perry,216,2393,29157
2021-02-03,MO,Perry,41,2434,29157
2021-02-04,MO,Perry,17,2451,29157
2021-02-05,MO,Perry,130,2581,29157
2021-02-06,MO,Perry,3,2584,29157
2021-02-07,MO,Perry,1,2585,29157
2021-02-08,MO,Perry,135,2720,29157
2021-02-09,MO,Perry,109,2829,29157
2021-02-10,MO,Perry,107,2936,29157
2021-02-11,MO,Perry,48,2984,29157
2021-02-12,MO,Perry,273,3257,29157
2021-02-13,MO,Perry,5,3262,29157
2021-02-14,MO,Perry,1,3263,29157
2021-02-15,MO,Perry,6,3269,29157
2021-02-16,MO,Perry,14,3283,29157
2021-02-17,MO,Perry,14,3297,29157
2021-02-18,MO,Perry,9,3306,29157
2021-02-19,MO,Perry,718,4024,29157
2021-02-20,MO,Perry,19,4043,29157
2021-02-22,MO,Perry,96,4139,29157
2021-02-23,MO,Perry,120,4259,29157
2021-02-24,MO,Perry,144,4403,29157
2021-02-25,MO,Perry,50,4453,29157
2021-02-26,MO,Perry,242,4695,29157
2021-02-27,MO,Perry,24,4719,29157
2021-03-01,MO,Perry,10,4729,29157
2021-03-02,MO,Perry,127,4856,29157
2021-03-03,MO,Perry,124,4980,29157
2021-03-04,MO,Perry,11,4991,29157
2021-03-05,MO,Perry,116,5107,29157
2021-03-06,MO,Perry,7,5114,29157
2021-03-08,MO,Perry,53,5167,29157
2021-03-09,MO,Perry,48,5215,29157
2021-03-10,MO,Perry,304,5519,29157
2021-03-11,MO,Perry,31,5550,29157
2021-03-12,MO,Perry,164,5714,29157
2021-03-13,MO,Perry,5,5719,29157
2021-03-14,MO,Perry,2,5721,29157
2021-03-15,MO,Perry,39,5760,29157
2021-03-16,MO,Perry,58,5818,29157
2021-03-17,MO,Perry,53,5871,29157
2021-03-18,MO,Perry,13,5884,29157
2021-03-19,MO,Perry,345,6229,29157
2021-03-20,MO,Perry,6,6235,29157
2021-03-21,MO,Perry,2,6237,29157
2021-03-22,MO,Perry,12,6249,29157
2021-03-23,MO,Perry,20,6269,29157
2021-03-24,MO,Perry,91,6360,29157
2021-03-25,MO,Perry,25,6385,29157
2021-03-26,MO,Perry,26,6411,29157
2021-03-27,MO,Perry,6,6417,29157
2021-03-29,MO,Perry,17,6434,29157
2021-03-30,MO,Perry,144,6578,29157
2021-03-31,MO,Perry,125,6703,29157
2021-04-01,MO,Perry,96,6799,29157
2021-04-02,MO,Perry,186,6985,29157
2021-04-03,MO,Perry,17,7002,29157
2021-04-04,MO,Perry,4,7006,29157
2021-04-05,MO,Perry,52,7058,29157
2021-04-06,MO,Perry,64,7122,29157
2021-04-07,MO,Perry,340,7462,29157
2021-04-08,MO,Perry,137,7599,29157
2021-04-09,MO,Perry,105,7704,29157
2021-04-10,MO,Perry,23,7727,29157
2021-04-11,MO,Perry,16,7743,29157
2021-04-12,MO,Perry,87,7830,29157
2021-04-13,MO,Perry,27,7857,29157
2021-04-14,MO,Perry,61,7918,29157
2021-04-15,MO,Perry,50,7968,29157
2021-04-16,MO,Perry,334,8302,29157
2021-04-17,MO,Perry,9,8311,29157
2021-04-18,MO,Perry,1,8312,29157
2021-04-19,MO,Perry,44,8356,29157
2021-04-20,MO,Perry,40,8396,29157
2021-04-21,MO,Perry,83,8479,29157
2021-04-22,MO,Perry,72,8551,29157
2021-04-23,MO,Perry,210,8761,29157
2021-04-24,MO,Perry,12,8773,29157
2021-04-25,MO,Perry,2,8775,29157
2021-04-26,MO,Perry,51,8826,29157
2021-04-27,MO,Perry,17,8843,29157
2021-04-28,MO,Perry,86,8929,29157
2021-04-29,MO,Perry,96,9025,29157
2021-04-30,MO,Perry,57,9082,29157
2021-05-01,MO,Perry,19,9101,29157
2021-05-02,MO,Perry,7,9108,29157
2021-05-03,MO,Perry,50,9158,29157
2021-05-04,MO,Perry,17,9175,29157
2021-05-05,MO,Perry,52,9227,29157
2021-05-06,MO,Perry,94,9321,29157
2021-05-07,MO,Perry,28,9349,29157
2021-05-08,MO,Perry,7,9356,29157
2021-05-09,MO,Perry,6,9362,29157
2021-05-10,MO,Perry,62,9424,29157
2021-05-11,MO,Perry,27,9451,29157
2021-05-12,MO,Perry,40,9491,29157
2021-05-13,MO,Perry,33,9524,29157
2021-05-14,MO,Perry,81,9605,29157
2021-05-15,MO,Perry,19,9624,29157
2021-05-16,MO,Perry,10,9634,29157
2021-05-17,MO,Perry,45,9679,29157
2021-05-18,MO,Perry,30,9709,29157
2021-05-19,MO,Perry,27,9736,29157
2021-05-20,MO,Perry,66,9802,29157
2021-05-21,MO,Perry,24,9826,29157
2021-05-22,MO,Perry,4,9830,29157
2021-05-23,MO,Perry,6,9836,29157
2021-05-24,MO,Perry,44,9880,29157
2021-05-25,MO,Perry,16,9896,29157
2021-05-26,MO,Perry,49,9945,29157
2021-05-27,MO,Perry,2,9947,29157
2020-12-16,MO,Pettis,9,9,29159
2020-12-17,MO,Pettis,4,13,29159
2020-12-18,MO,Pettis,34,47,29159
2020-12-19,MO,Pettis,5,52,29159
2020-12-20,MO,Pettis,1,53,29159
2020-12-21,MO,Pettis,33,86,29159
2020-12-22,MO,Pettis,65,151,29159
2020-12-23,MO,Pettis,55,206,29159
2020-12-24,MO,Pettis,34,240,29159
2020-12-26,MO,Pettis,1,241,29159
2020-12-27,MO,Pettis,1,242,29159
2020-12-28,MO,Pettis,49,291,29159
2020-12-29,MO,Pettis,98,389,29159
2020-12-30,MO,Pettis,88,477,29159
2020-12-31,MO,Pettis,30,507,29159
2021-01-01,MO,Pettis,2,509,29159
2021-01-02,MO,Pettis,2,511,29159
2021-01-04,MO,Pettis,9,520,29159
2021-01-05,MO,Pettis,18,538,29159
2021-01-06,MO,Pettis,72,610,29159
2021-01-07,MO,Pettis,151,761,29159
2021-01-08,MO,Pettis,45,806,29159
2021-01-09,MO,Pettis,3,809,29159
2021-01-10,MO,Pettis,5,814,29159
2021-01-11,MO,Pettis,57,871,29159
2021-01-12,MO,Pettis,101,972,29159
2021-01-13,MO,Pettis,117,1089,29159
2021-01-14,MO,Pettis,110,1199,29159
2021-01-15,MO,Pettis,115,1314,29159
2021-01-16,MO,Pettis,22,1336,29159
2021-01-17,MO,Pettis,1,1337,29159
2021-01-18,MO,Pettis,68,1405,29159
2021-01-19,MO,Pettis,65,1470,29159
2021-01-20,MO,Pettis,48,1518,29159
2021-01-21,MO,Pettis,54,1572,29159
2021-01-22,MO,Pettis,226,1798,29159
2021-01-23,MO,Pettis,5,1803,29159
2021-01-24,MO,Pettis,3,1806,29159
2021-01-25,MO,Pettis,95,1901,29159
2021-01-26,MO,Pettis,78,1979,29159
2021-01-27,MO,Pettis,132,2111,29159
2021-01-28,MO,Pettis,908,3019,29159
2021-01-29,MO,Pettis,1241,4260,29159
2021-01-30,MO,Pettis,282,4542,29159
2021-01-31,MO,Pettis,15,4557,29159
2021-02-01,MO,Pettis,24,4581,29159
2021-02-02,MO,Pettis,201,4782,29159
2021-02-03,MO,Pettis,424,5206,29159
2021-02-04,MO,Pettis,314,5520,29159
2021-02-05,MO,Pettis,154,5674,29159
2021-02-06,MO,Pettis,6,5680,29159
2021-02-07,MO,Pettis,1,5681,29159
2021-02-08,MO,Pettis,82,5763,29159
2021-02-09,MO,Pettis,303,6066,29159
2021-02-10,MO,Pettis,133,6199,29159
2021-02-11,MO,Pettis,88,6287,29159
2021-02-12,MO,Pettis,288,6575,29159
2021-02-13,MO,Pettis,140,6715,29159
2021-02-14,MO,Pettis,14,6729,29159
2021-02-15,MO,Pettis,50,6779,29159
2021-02-16,MO,Pettis,25,6804,29159
2021-02-17,MO,Pettis,59,6863,29159
2021-02-18,MO,Pettis,209,7072,29159
2021-02-19,MO,Pettis,248,7320,29159
2021-02-20,MO,Pettis,8,7328,29159
2021-02-21,MO,Pettis,5,7333,29159
2021-02-22,MO,Pettis,53,7386,29159
2021-02-23,MO,Pettis,938,8324,29159
2021-02-24,MO,Pettis,526,8850,29159
2021-02-25,MO,Pettis,1185,10035,29159
2021-02-26,MO,Pettis,430,10465,29159
2021-02-27,MO,Pettis,217,10682,29159
2021-02-28,MO,Pettis,17,10699,29159
2021-03-01,MO,Pettis,41,10740,29159
2021-03-02,MO,Pettis,140,10880,29159
2021-03-03,MO,Pettis,208,11088,29159
2021-03-04,MO,Pettis,233,11321,29159
2021-03-05,MO,Pettis,149,11470,29159
2021-03-06,MO,Pettis,4,11474,29159
2021-03-07,MO,Pettis,3,11477,29159
2021-03-08,MO,Pettis,36,11513,29159
2021-03-09,MO,Pettis,348,11861,29159
2021-03-10,MO,Pettis,316,12177,29159
2021-03-11,MO,Pettis,134,12311,29159
2021-03-12,MO,Pettis,301,12612,29159
2021-03-13,MO,Pettis,117,12729,29159
2021-03-14,MO,Pettis,10,12739,29159
2021-03-15,MO,Pettis,251,12990,29159
2021-03-16,MO,Pettis,101,13091,29159
2021-03-17,MO,Pettis,172,13263,29159
2021-03-18,MO,Pettis,214,13477,29159
2021-03-19,MO,Pettis,254,13731,29159
2021-03-20,MO,Pettis,23,13754,29159
2021-03-21,MO,Pettis,6,13760,29159
2021-03-22,MO,Pettis,162,13922,29159
2021-03-23,MO,Pettis,208,14130,29159
2021-03-24,MO,Pettis,375,14505,29159
2021-03-25,MO,Pettis,435,14940,29159
2021-03-26,MO,Pettis,572,15512,29159
2021-03-27,MO,Pettis,255,15767,29159
2021-03-28,MO,Pettis,12,15779,29159
2021-03-29,MO,Pettis,47,15826,29159
2021-03-30,MO,Pettis,165,15991,29159
2021-03-31,MO,Pettis,367,16358,29159
2021-04-01,MO,Pettis,378,16736,29159
2021-04-02,MO,Pettis,117,16853,29159
2021-04-03,MO,Pettis,27,16880,29159
2021-04-04,MO,Pettis,3,16883,29159
2021-04-05,MO,Pettis,128,17011,29159
2021-04-06,MO,Pettis,198,17209,29159
2021-04-07,MO,Pettis,101,17310,29159
2021-04-08,MO,Pettis,143,17453,29159
2021-04-09,MO,Pettis,670,18123,29159
2021-04-10,MO,Pettis,118,18241,29159
2021-04-11,MO,Pettis,13,18254,29159
2021-04-12,MO,Pettis,181,18435,29159
2021-04-13,MO,Pettis,150,18585,29159
2021-04-14,MO,Pettis,199,18784,29159
2021-04-15,MO,Pettis,444,19228,29159
2021-04-16,MO,Pettis,301,19529,29159
2021-04-17,MO,Pettis,35,19564,29159
2021-04-18,MO,Pettis,19,19583,29159
2021-04-19,MO,Pettis,59,19642,29159
2021-04-20,MO,Pettis,146,19788,29159
2021-04-21,MO,Pettis,207,19995,29159
2021-04-22,MO,Pettis,381,20376,29159
2021-04-23,MO,Pettis,433,20809,29159
2021-04-24,MO,Pettis,19,20828,29159
2021-04-25,MO,Pettis,4,20832,29159
2021-04-26,MO,Pettis,45,20877,29159
2021-04-27,MO,Pettis,58,20935,29159
2021-04-28,MO,Pettis,49,20984,29159
2021-04-29,MO,Pettis,105,21089,29159
2021-04-30,MO,Pettis,341,21430,29159
2021-05-01,MO,Pettis,114,21544,29159
2021-05-02,MO,Pettis,10,21554,29159
2021-05-03,MO,Pettis,145,21699,29159
2021-05-04,MO,Pettis,53,21752,29159
2021-05-05,MO,Pettis,159,21911,29159
2021-05-06,MO,Pettis,91,22002,29159
2021-05-07,MO,Pettis,150,22152,29159
2021-05-08,MO,Pettis,18,22170,29159
2021-05-09,MO,Pettis,14,22184,29159
2021-05-10,MO,Pettis,42,22226,29159
2021-05-11,MO,Pettis,96,22322,29159
2021-05-12,MO,Pettis,48,22370,29159
2021-05-13,MO,Pettis,63,22433,29159
2021-05-14,MO,Pettis,86,22519,29159
2021-05-15,MO,Pettis,42,22561,29159
2021-05-16,MO,Pettis,12,22573,29159
2021-05-17,MO,Pettis,72,22645,29159
2021-05-18,MO,Pettis,84,22729,29159
2021-05-19,MO,Pettis,56,22785,29159
2021-05-20,MO,Pettis,77,22862,29159
2021-05-21,MO,Pettis,92,22954,29159
2021-05-22,MO,Pettis,71,23025,29159
2021-05-23,MO,Pettis,4,23029,29159
2021-05-24,MO,Pettis,31,23060,29159
2021-05-25,MO,Pettis,57,23117,29159
2021-05-26,MO,Pettis,38,23155,29159
2021-05-27,MO,Pettis,36,23191,29159
2020-12-15,MO,Phelps,2,2,29161
2020-12-16,MO,Phelps,9,11,29161
2020-12-17,MO,Phelps,16,27,29161
2020-12-18,MO,Phelps,21,48,29161
2020-12-19,MO,Phelps,12,60,29161
2020-12-20,MO,Phelps,2,62,29161
2020-12-21,MO,Phelps,24,86,29161
2020-12-22,MO,Phelps,16,102,29161
2020-12-23,MO,Phelps,15,117,29161
2020-12-24,MO,Phelps,1,118,29161
2020-12-26,MO,Phelps,2,120,29161
2020-12-28,MO,Phelps,17,137,29161
2020-12-29,MO,Phelps,43,180,29161
2020-12-30,MO,Phelps,103,283,29161
2020-12-31,MO,Phelps,69,352,29161
2021-01-01,MO,Phelps,58,410,29161
2021-01-02,MO,Phelps,59,469,29161
2021-01-03,MO,Phelps,57,526,29161
2021-01-04,MO,Phelps,134,660,29161
2021-01-05,MO,Phelps,122,782,29161
2021-01-06,MO,Phelps,154,936,29161
2021-01-07,MO,Phelps,155,1091,29161
2021-01-08,MO,Phelps,96,1187,29161
2021-01-09,MO,Phelps,3,1190,29161
2021-01-10,MO,Phelps,1,1191,29161
2021-01-11,MO,Phelps,64,1255,29161
2021-01-12,MO,Phelps,65,1320,29161
2021-01-13,MO,Phelps,122,1442,29161
2021-01-14,MO,Phelps,21,1463,29161
2021-01-15,MO,Phelps,55,1518,29161
2021-01-16,MO,Phelps,70,1588,29161
2021-01-18,MO,Phelps,232,1820,29161
2021-01-19,MO,Phelps,102,1922,29161
2021-01-20,MO,Phelps,151,2073,29161
2021-01-21,MO,Phelps,155,2228,29161
2021-01-22,MO,Phelps,165,2393,29161
2021-01-23,MO,Phelps,453,2846,29161
2021-01-25,MO,Phelps,172,3018,29161
2021-01-26,MO,Phelps,132,3150,29161
2021-01-27,MO,Phelps,152,3302,29161
2021-01-28,MO,Phelps,158,3460,29161
2021-01-29,MO,Phelps,569,4029,29161
2021-01-30,MO,Phelps,340,4369,29161
2021-01-31,MO,Phelps,5,4374,29161
2021-02-01,MO,Phelps,70,4444,29161
2021-02-02,MO,Phelps,63,4507,29161
2021-02-03,MO,Phelps,152,4659,29161
2021-02-04,MO,Phelps,597,5256,29161
2021-02-05,MO,Phelps,554,5810,29161
2021-02-06,MO,Phelps,254,6064,29161
2021-02-07,MO,Phelps,3,6067,29161
2021-02-08,MO,Phelps,436,6503,29161
2021-02-09,MO,Phelps,125,6628,29161
2021-02-10,MO,Phelps,228,6856,29161
2021-02-11,MO,Phelps,190,7046,29161
2021-02-12,MO,Phelps,273,7319,29161
2021-02-13,MO,Phelps,557,7876,29161
2021-02-14,MO,Phelps,5,7881,29161
2021-02-15,MO,Phelps,158,8039,29161
2021-02-16,MO,Phelps,192,8231,29161
2021-02-17,MO,Phelps,116,8347,29161
2021-02-18,MO,Phelps,92,8439,29161
2021-02-19,MO,Phelps,57,8496,29161
2021-02-20,MO,Phelps,20,8516,29161
2021-02-21,MO,Phelps,2,8518,29161
2021-02-22,MO,Phelps,94,8612,29161
2021-02-23,MO,Phelps,86,8698,29161
2021-02-24,MO,Phelps,202,8900,29161
2021-02-25,MO,Phelps,191,9091,29161
2021-02-26,MO,Phelps,1071,10162,29161
2021-02-27,MO,Phelps,576,10738,29161
2021-03-01,MO,Phelps,161,10899,29161
2021-03-02,MO,Phelps,146,11045,29161
2021-03-03,MO,Phelps,142,11187,29161
2021-03-04,MO,Phelps,117,11304,29161
2021-03-05,MO,Phelps,114,11418,29161
2021-03-06,MO,Phelps,263,11681,29161
2021-03-07,MO,Phelps,11,11692,29161
2021-03-08,MO,Phelps,204,11896,29161
2021-03-09,MO,Phelps,210,12106,29161
2021-03-10,MO,Phelps,225,12331,29161
2021-03-11,MO,Phelps,242,12573,29161
2021-03-12,MO,Phelps,478,13051,29161
2021-03-13,MO,Phelps,76,13127,29161
2021-03-14,MO,Phelps,13,13140,29161
2021-03-15,MO,Phelps,214,13354,29161
2021-03-16,MO,Phelps,301,13655,29161
2021-03-17,MO,Phelps,159,13814,29161
2021-03-18,MO,Phelps,158,13972,29161
2021-03-19,MO,Phelps,243,14215,29161
2021-03-20,MO,Phelps,144,14359,29161
2021-03-21,MO,Phelps,19,14378,29161
2021-03-22,MO,Phelps,214,14592,29161
2021-03-23,MO,Phelps,255,14847,29161
2021-03-24,MO,Phelps,180,15027,29161
2021-03-25,MO,Phelps,294,15321,29161
2021-03-26,MO,Phelps,207,15528,29161
2021-03-27,MO,Phelps,38,15566,29161
2021-03-28,MO,Phelps,21,15587,29161
2021-03-29,MO,Phelps,278,15865,29161
2021-03-30,MO,Phelps,337,16202,29161
2021-03-31,MO,Phelps,166,16368,29161
2021-04-01,MO,Phelps,410,16778,29161
2021-04-02,MO,Phelps,294,17072,29161
2021-04-03,MO,Phelps,29,17101,29161
2021-04-04,MO,Phelps,8,17109,29161
2021-04-05,MO,Phelps,271,17380,29161
2021-04-06,MO,Phelps,336,17716,29161
2021-04-07,MO,Phelps,118,17834,29161
2021-04-08,MO,Phelps,265,18099,29161
2021-04-09,MO,Phelps,940,19039,29161
2021-04-10,MO,Phelps,150,19189,29161
2021-04-11,MO,Phelps,18,19207,29161
2021-04-12,MO,Phelps,409,19616,29161
2021-04-13,MO,Phelps,351,19967,29161
2021-04-14,MO,Phelps,182,20149,29161
2021-04-15,MO,Phelps,222,20371,29161
2021-04-16,MO,Phelps,234,20605,29161
2021-04-17,MO,Phelps,57,20662,29161
2021-04-18,MO,Phelps,17,20679,29161
2021-04-19,MO,Phelps,255,20934,29161
2021-04-20,MO,Phelps,358,21292,29161
2021-04-21,MO,Phelps,88,21380,29161
2021-04-22,MO,Phelps,324,21704,29161
2021-04-23,MO,Phelps,228,21932,29161
2021-04-24,MO,Phelps,77,22009,29161
2021-04-25,MO,Phelps,18,22027,29161
2021-04-26,MO,Phelps,208,22235,29161
2021-04-27,MO,Phelps,268,22503,29161
2021-04-28,MO,Phelps,143,22646,29161
2021-04-29,MO,Phelps,127,22773,29161
2021-04-30,MO,Phelps,324,23097,29161
2021-05-01,MO,Phelps,35,23132,29161
2021-05-02,MO,Phelps,30,23162,29161
2021-05-03,MO,Phelps,142,23304,29161
2021-05-04,MO,Phelps,191,23495,29161
2021-05-05,MO,Phelps,137,23632,29161
2021-05-06,MO,Phelps,102,23734,29161
2021-05-07,MO,Phelps,148,23882,29161
2021-05-08,MO,Phelps,34,23916,29161
2021-05-09,MO,Phelps,20,23936,29161
2021-05-10,MO,Phelps,134,24070,29161
2021-05-11,MO,Phelps,169,24239,29161
2021-05-12,MO,Phelps,92,24331,29161
2021-05-13,MO,Phelps,133,24464,29161
2021-05-14,MO,Phelps,141,24605,29161
2021-05-15,MO,Phelps,78,24683,29161
2021-05-16,MO,Phelps,23,24706,29161
2021-05-17,MO,Phelps,129,24835,29161
2021-05-18,MO,Phelps,215,25050,29161
2021-05-19,MO,Phelps,88,25138,29161
2021-05-20,MO,Phelps,130,25268,29161
2021-05-21,MO,Phelps,111,25379,29161
2021-05-22,MO,Phelps,41,25420,29161
2021-05-23,MO,Phelps,20,25440,29161
2021-05-24,MO,Phelps,71,25511,29161
2021-05-25,MO,Phelps,105,25616,29161
2021-05-26,MO,Phelps,120,25736,29161
2021-05-27,MO,Phelps,57,25793,29161
2020-12-15,MO,Pike,1,1,29163
2020-12-16,MO,Pike,6,7,29163
2020-12-17,MO,Pike,9,16,29163
2020-12-18,MO,Pike,6,22,29163
2020-12-21,MO,Pike,5,27,29163
2020-12-22,MO,Pike,1,28,29163
2020-12-23,MO,Pike,12,40,29163
2020-12-28,MO,Pike,39,79,29163
2020-12-29,MO,Pike,28,107,29163
2020-12-30,MO,Pike,38,145,29163
2021-01-03,MO,Pike,1,146,29163
2021-01-04,MO,Pike,8,154,29163
2021-01-05,MO,Pike,39,193,29163
2021-01-06,MO,Pike,9,202,29163
2021-01-07,MO,Pike,10,212,29163
2021-01-08,MO,Pike,6,218,29163
2021-01-09,MO,Pike,1,219,29163
2021-01-10,MO,Pike,1,220,29163
2021-01-11,MO,Pike,11,231,29163
2021-01-12,MO,Pike,11,242,29163
2021-01-13,MO,Pike,15,257,29163
2021-01-14,MO,Pike,9,266,29163
2021-01-15,MO,Pike,25,291,29163
2021-01-16,MO,Pike,3,294,29163
2021-01-17,MO,Pike,22,316,29163
2021-01-18,MO,Pike,140,456,29163
2021-01-19,MO,Pike,141,597,29163
2021-01-20,MO,Pike,217,814,29163
2021-01-21,MO,Pike,184,998,29163
2021-01-22,MO,Pike,101,1099,29163
2021-01-23,MO,Pike,3,1102,29163
2021-01-24,MO,Pike,1,1103,29163
2021-01-25,MO,Pike,11,1114,29163
2021-01-26,MO,Pike,17,1131,29163
2021-01-27,MO,Pike,5,1136,29163
2021-01-28,MO,Pike,13,1149,29163
2021-01-29,MO,Pike,18,1167,29163
2021-01-30,MO,Pike,2,1169,29163
2021-02-01,MO,Pike,11,1180,29163
2021-02-02,MO,Pike,131,1311,29163
2021-02-03,MO,Pike,2,1313,29163
2021-02-04,MO,Pike,122,1435,29163
2021-02-05,MO,Pike,63,1498,29163
2021-02-06,MO,Pike,4,1502,29163
2021-02-07,MO,Pike,1,1503,29163
2021-02-08,MO,Pike,124,1627,29163
2021-02-09,MO,Pike,317,1944,29163
2021-02-10,MO,Pike,224,2168,29163
2021-02-11,MO,Pike,139,2307,29163
2021-02-12,MO,Pike,190,2497,29163
2021-02-13,MO,Pike,2,2499,29163
2021-02-14,MO,Pike,30,2529,29163
2021-02-15,MO,Pike,43,2572,29163
2021-02-16,MO,Pike,98,2670,29163
2021-02-17,MO,Pike,174,2844,29163
2021-02-18,MO,Pike,21,2865,29163
2021-02-19,MO,Pike,37,2902,29163
2021-02-20,MO,Pike,2,2904,29163
2021-02-22,MO,Pike,27,2931,29163
2021-02-23,MO,Pike,221,3152,29163
2021-02-24,MO,Pike,69,3221,29163
2021-02-25,MO,Pike,117,3338,29163
2021-02-26,MO,Pike,25,3363,29163
2021-02-27,MO,Pike,14,3377,29163
2021-03-01,MO,Pike,8,3385,29163
2021-03-02,MO,Pike,450,3835,29163
2021-03-03,MO,Pike,20,3855,29163
2021-03-04,MO,Pike,133,3988,29163
2021-03-05,MO,Pike,95,4083,29163
2021-03-06,MO,Pike,4,4087,29163
2021-03-08,MO,Pike,16,4103,29163
2021-03-09,MO,Pike,225,4328,29163
2021-03-10,MO,Pike,232,4560,29163
2021-03-11,MO,Pike,62,4622,29163
2021-03-12,MO,Pike,41,4663,29163
2021-03-13,MO,Pike,6,4669,29163
2021-03-14,MO,Pike,2,4671,29163
2021-03-15,MO,Pike,50,4721,29163
2021-03-16,MO,Pike,76,4797,29163
2021-03-17,MO,Pike,205,5002,29163
2021-03-18,MO,Pike,51,5053,29163
2021-03-19,MO,Pike,113,5166,29163
2021-03-20,MO,Pike,7,5173,29163
2021-03-21,MO,Pike,6,5179,29163
2021-03-22,MO,Pike,30,5209,29163
2021-03-23,MO,Pike,224,5433,29163
2021-03-24,MO,Pike,93,5526,29163
2021-03-25,MO,Pike,122,5648,29163
2021-03-26,MO,Pike,15,5663,29163
2021-03-27,MO,Pike,8,5671,29163
2021-03-29,MO,Pike,30,5701,29163
2021-03-30,MO,Pike,373,6074,29163
2021-03-31,MO,Pike,181,6255,29163
2021-04-01,MO,Pike,61,6316,29163
2021-04-02,MO,Pike,58,6374,29163
2021-04-03,MO,Pike,5,6379,29163
2021-04-04,MO,Pike,2,6381,29163
2021-04-05,MO,Pike,12,6393,29163
2021-04-06,MO,Pike,120,6513,29163
2021-04-07,MO,Pike,122,6635,29163
2021-04-08,MO,Pike,62,6697,29163
2021-04-09,MO,Pike,54,6751,29163
2021-04-10,MO,Pike,9,6760,29163
2021-04-11,MO,Pike,5,6765,29163
2021-04-12,MO,Pike,27,6792,29163
2021-04-13,MO,Pike,166,6958,29163
2021-04-14,MO,Pike,145,7103,29163
2021-04-15,MO,Pike,25,7128,29163
2021-04-16,MO,Pike,124,7252,29163
2021-04-17,MO,Pike,13,7265,29163
2021-04-18,MO,Pike,4,7269,29163
2021-04-19,MO,Pike,16,7285,29163
2021-04-20,MO,Pike,98,7383,29163
2021-04-21,MO,Pike,311,7694,29163
2021-04-22,MO,Pike,89,7783,29163
2021-04-23,MO,Pike,25,7808,29163
2021-04-24,MO,Pike,2,7810,29163
2021-04-25,MO,Pike,1,7811,29163
2021-04-26,MO,Pike,18,7829,29163
2021-04-27,MO,Pike,31,7860,29163
2021-04-28,MO,Pike,164,8024,29163
2021-04-29,MO,Pike,8,8032,29163
2021-04-30,MO,Pike,47,8079,29163
2021-05-01,MO,Pike,6,8085,29163
2021-05-02,MO,Pike,4,8089,29163
2021-05-03,MO,Pike,10,8099,29163
2021-05-04,MO,Pike,36,8135,29163
2021-05-05,MO,Pike,98,8233,29163
2021-05-06,MO,Pike,15,8248,29163
2021-05-07,MO,Pike,16,8264,29163
2021-05-08,MO,Pike,11,8275,29163
2021-05-10,MO,Pike,12,8287,29163
2021-05-11,MO,Pike,113,8400,29163
2021-05-12,MO,Pike,158,8558,29163
2021-05-13,MO,Pike,22,8580,29163
2021-05-14,MO,Pike,17,8597,29163
2021-05-15,MO,Pike,10,8607,29163
2021-05-16,MO,Pike,8,8615,29163
2021-05-17,MO,Pike,18,8633,29163
2021-05-18,MO,Pike,77,8710,29163
2021-05-19,MO,Pike,327,9037,29163
2021-05-20,MO,Pike,41,9078,29163
2021-05-21,MO,Pike,17,9095,29163
2021-05-22,MO,Pike,6,9101,29163
2021-05-23,MO,Pike,2,9103,29163
2021-05-24,MO,Pike,12,9115,29163
2021-05-25,MO,Pike,24,9139,29163
2021-05-26,MO,Pike,20,9159,29163
2021-05-27,MO,Pike,7,9166,29163
2020-12-14,MO,Platte,1,1,29165
2020-12-15,MO,Platte,2,3,29165
2020-12-16,MO,Platte,5,8,29165
2020-12-17,MO,Platte,15,23,29165
2020-12-18,MO,Platte,9,32,29165
2020-12-19,MO,Platte,11,43,29165
2020-12-20,MO,Platte,3,46,29165
2020-12-21,MO,Platte,40,86,29165
2020-12-22,MO,Platte,105,191,29165
2020-12-23,MO,Platte,60,251,29165
2020-12-24,MO,Platte,11,262,29165
2020-12-26,MO,Platte,1,263,29165
2020-12-27,MO,Platte,10,273,29165
2020-12-28,MO,Platte,30,303,29165
2020-12-29,MO,Platte,77,380,29165
2020-12-30,MO,Platte,98,478,29165
2020-12-31,MO,Platte,51,529,29165
2021-01-01,MO,Platte,1,530,29165
2021-01-02,MO,Platte,22,552,29165
2021-01-03,MO,Platte,6,558,29165
2021-01-04,MO,Platte,28,586,29165
2021-01-05,MO,Platte,50,636,29165
2021-01-06,MO,Platte,95,731,29165
2021-01-07,MO,Platte,85,816,29165
2021-01-08,MO,Platte,107,923,29165
2021-01-09,MO,Platte,49,972,29165
2021-01-10,MO,Platte,7,979,29165
2021-01-11,MO,Platte,54,1033,29165
2021-01-12,MO,Platte,151,1184,29165
2021-01-13,MO,Platte,121,1305,29165
2021-01-14,MO,Platte,85,1390,29165
2021-01-15,MO,Platte,101,1491,29165
2021-01-16,MO,Platte,11,1502,29165
2021-01-17,MO,Platte,1,1503,29165
2021-01-18,MO,Platte,48,1551,29165
2021-01-19,MO,Platte,111,1662,29165
2021-01-20,MO,Platte,126,1788,29165
2021-01-21,MO,Platte,138,1926,29165
2021-01-22,MO,Platte,130,2056,29165
2021-01-23,MO,Platte,23,2079,29165
2021-01-25,MO,Platte,76,2155,29165
2021-01-26,MO,Platte,97,2252,29165
2021-01-27,MO,Platte,103,2355,29165
2021-01-28,MO,Platte,150,2505,29165
2021-01-29,MO,Platte,263,2768,29165
2021-01-30,MO,Platte,35,2803,29165
2021-01-31,MO,Platte,49,2852,29165
2021-02-01,MO,Platte,70,2922,29165
2021-02-02,MO,Platte,112,3034,29165
2021-02-03,MO,Platte,196,3230,29165
2021-02-04,MO,Platte,214,3444,29165
2021-02-05,MO,Platte,290,3734,29165
2021-02-06,MO,Platte,102,3836,29165
2021-02-07,MO,Platte,27,3863,29165
2021-02-08,MO,Platte,73,3936,29165
2021-02-09,MO,Platte,124,4060,29165
2021-02-10,MO,Platte,110,4170,29165
2021-02-11,MO,Platte,213,4383,29165
2021-02-12,MO,Platte,296,4679,29165
2021-02-13,MO,Platte,57,4736,29165
2021-02-14,MO,Platte,33,4769,29165
2021-02-15,MO,Platte,79,4848,29165
2021-02-16,MO,Platte,92,4940,29165
2021-02-17,MO,Platte,125,5065,29165
2021-02-18,MO,Platte,248,5313,29165
2021-02-19,MO,Platte,162,5475,29165
2021-02-20,MO,Platte,27,5502,29165
2021-02-21,MO,Platte,14,5516,29165
2021-02-22,MO,Platte,163,5679,29165
2021-02-23,MO,Platte,157,5836,29165
2021-02-24,MO,Platte,238,6074,29165
2021-02-25,MO,Platte,452,6526,29165
2021-02-26,MO,Platte,600,7126,29165
2021-02-27,MO,Platte,116,7242,29165
2021-02-28,MO,Platte,63,7305,29165
2021-03-01,MO,Platte,118,7423,29165
2021-03-02,MO,Platte,300,7723,29165
2021-03-03,MO,Platte,573,8296,29165
2021-03-04,MO,Platte,466,8762,29165
2021-03-05,MO,Platte,294,9056,29165
2021-03-06,MO,Platte,203,9259,29165
2021-03-07,MO,Platte,64,9323,29165
2021-03-08,MO,Platte,160,9483,29165
2021-03-09,MO,Platte,215,9698,29165
2021-03-10,MO,Platte,175,9873,29165
2021-03-11,MO,Platte,301,10174,29165
2021-03-12,MO,Platte,355,10529,29165
2021-03-13,MO,Platte,127,10656,29165
2021-03-14,MO,Platte,77,10733,29165
2021-03-15,MO,Platte,192,10925,29165
2021-03-16,MO,Platte,332,11257,29165
2021-03-17,MO,Platte,369,11626,29165
2021-03-18,MO,Platte,666,12292,29165
2021-03-19,MO,Platte,627,12919,29165
2021-03-20,MO,Platte,156,13075,29165
2021-03-21,MO,Platte,106,13181,29165
2021-03-22,MO,Platte,236,13417,29165
2021-03-23,MO,Platte,359,13776,29165
2021-03-24,MO,Platte,589,14365,29165
2021-03-25,MO,Platte,650,15015,29165
2021-03-26,MO,Platte,677,15692,29165
2021-03-27,MO,Platte,147,15839,29165
2021-03-28,MO,Platte,71,15910,29165
2021-03-29,MO,Platte,350,16260,29165
2021-03-30,MO,Platte,432,16692,29165
2021-03-31,MO,Platte,359,17051,29165
2021-04-01,MO,Platte,449,17500,29165
2021-04-02,MO,Platte,389,17889,29165
2021-04-03,MO,Platte,122,18011,29165
2021-04-04,MO,Platte,35,18046,29165
2021-04-05,MO,Platte,246,18292,29165
2021-04-06,MO,Platte,441,18733,29165
2021-04-07,MO,Platte,325,19058,29165
2021-04-08,MO,Platte,459,19517,29165
2021-04-09,MO,Platte,746,20263,29165
2021-04-10,MO,Platte,163,20426,29165
2021-04-11,MO,Platte,64,20490,29165
2021-04-12,MO,Platte,278,20768,29165
2021-04-13,MO,Platte,311,21079,29165
2021-04-14,MO,Platte,329,21408,29165
2021-04-15,MO,Platte,438,21846,29165
2021-04-16,MO,Platte,529,22375,29165
2021-04-17,MO,Platte,81,22456,29165
2021-04-18,MO,Platte,51,22507,29165
2021-04-19,MO,Platte,177,22684,29165
2021-04-20,MO,Platte,274,22958,29165
2021-04-21,MO,Platte,261,23219,29165
2021-04-22,MO,Platte,331,23550,29165
2021-04-23,MO,Platte,339,23889,29165
2021-04-24,MO,Platte,97,23986,29165
2021-04-25,MO,Platte,50,24036,29165
2021-04-26,MO,Platte,264,24300,29165
2021-04-27,MO,Platte,291,24591,29165
2021-04-28,MO,Platte,236,24827,29165
2021-04-29,MO,Platte,288,25115,29165
2021-04-30,MO,Platte,245,25360,29165
2021-05-01,MO,Platte,126,25486,29165
2021-05-02,MO,Platte,60,25546,29165
2021-05-03,MO,Platte,143,25689,29165
2021-05-04,MO,Platte,231,25920,29165
2021-05-05,MO,Platte,139,26059,29165
2021-05-06,MO,Platte,398,26457,29165
2021-05-07,MO,Platte,224,26681,29165
2021-05-08,MO,Platte,62,26743,29165
2021-05-09,MO,Platte,29,26772,29165
2021-05-10,MO,Platte,85,26857,29165
2021-05-11,MO,Platte,109,26966,29165
2021-05-12,MO,Platte,75,27041,29165
2021-05-13,MO,Platte,160,27201,29165
2021-05-14,MO,Platte,209,27410,29165
2021-05-15,MO,Platte,111,27521,29165
2021-05-16,MO,Platte,63,27584,29165
2021-05-17,MO,Platte,226,27810,29165
2021-05-18,MO,Platte,196,28006,29165
2021-05-19,MO,Platte,179,28185,29165
2021-05-20,MO,Platte,113,28298,29165
2021-05-21,MO,Platte,116,28414,29165
2021-05-22,MO,Platte,66,28480,29165
2021-05-23,MO,Platte,26,28506,29165
2021-05-24,MO,Platte,90,28596,29165
2021-05-25,MO,Platte,118,28714,29165
2021-05-26,MO,Platte,66,28780,29165
2021-05-27,MO,Platte,30,28810,29165
2020-12-14,MO,Polk,1,1,29167
2020-12-15,MO,Polk,2,3,29167
2020-12-16,MO,Polk,2,5,29167
2020-12-17,MO,Polk,8,13,29167
2020-12-18,MO,Polk,5,18,29167
2020-12-19,MO,Polk,2,20,29167
2020-12-20,MO,Polk,1,21,29167
2020-12-21,MO,Polk,18,39,29167
2020-12-22,MO,Polk,47,86,29167
2020-12-23,MO,Polk,84,170,29167
2020-12-24,MO,Polk,9,179,29167
2020-12-26,MO,Polk,7,186,29167
2020-12-27,MO,Polk,5,191,29167
2020-12-28,MO,Polk,76,267,29167
2020-12-29,MO,Polk,95,362,29167
2020-12-30,MO,Polk,130,492,29167
2020-12-31,MO,Polk,46,538,29167
2021-01-02,MO,Polk,2,540,29167
2021-01-03,MO,Polk,3,543,29167
2021-01-04,MO,Polk,19,562,29167
2021-01-05,MO,Polk,156,718,29167
2021-01-06,MO,Polk,18,736,29167
2021-01-07,MO,Polk,8,744,29167
2021-01-08,MO,Polk,13,757,29167
2021-01-09,MO,Polk,13,770,29167
2021-01-10,MO,Polk,1,771,29167
2021-01-11,MO,Polk,15,786,29167
2021-01-12,MO,Polk,79,865,29167
2021-01-13,MO,Polk,25,890,29167
2021-01-14,MO,Polk,22,912,29167
2021-01-15,MO,Polk,18,930,29167
2021-01-16,MO,Polk,9,939,29167
2021-01-17,MO,Polk,2,941,29167
2021-01-18,MO,Polk,11,952,29167
2021-01-19,MO,Polk,167,1119,29167
2021-01-20,MO,Polk,221,1340,29167
2021-01-21,MO,Polk,205,1545,29167
2021-01-22,MO,Polk,78,1623,29167
2021-01-23,MO,Polk,22,1645,29167
2021-01-24,MO,Polk,5,1650,29167
2021-01-25,MO,Polk,129,1779,29167
2021-01-26,MO,Polk,356,2135,29167
2021-01-27,MO,Polk,145,2280,29167
2021-01-28,MO,Polk,183,2463,29167
2021-01-29,MO,Polk,328,2791,29167
2021-01-30,MO,Polk,8,2799,29167
2021-02-01,MO,Polk,116,2915,29167
2021-02-02,MO,Polk,182,3097,29167
2021-02-03,MO,Polk,156,3253,29167
2021-02-04,MO,Polk,25,3278,29167
2021-02-05,MO,Polk,63,3341,29167
2021-02-06,MO,Polk,21,3362,29167
2021-02-08,MO,Polk,25,3387,29167
2021-02-09,MO,Polk,108,3495,29167
2021-02-10,MO,Polk,117,3612,29167
2021-02-11,MO,Polk,427,4039,29167
2021-02-12,MO,Polk,210,4249,29167
2021-02-13,MO,Polk,65,4314,29167
2021-02-14,MO,Polk,9,4323,29167
2021-02-15,MO,Polk,10,4333,29167
2021-02-16,MO,Polk,126,4459,29167
2021-02-17,MO,Polk,16,4475,29167
2021-02-18,MO,Polk,40,4515,29167
2021-02-19,MO,Polk,115,4630,29167
2021-02-20,MO,Polk,127,4757,29167
2021-02-21,MO,Polk,5,4762,29167
2021-02-22,MO,Polk,89,4851,29167
2021-02-23,MO,Polk,336,5187,29167
2021-02-24,MO,Polk,285,5472,29167
2021-02-25,MO,Polk,541,6013,29167
2021-02-26,MO,Polk,411,6424,29167
2021-02-27,MO,Polk,79,6503,29167
2021-03-01,MO,Polk,180,6683,29167
2021-03-02,MO,Polk,243,6926,29167
2021-03-03,MO,Polk,210,7136,29167
2021-03-04,MO,Polk,238,7374,29167
2021-03-05,MO,Polk,119,7493,29167
2021-03-06,MO,Polk,135,7628,29167
2021-03-07,MO,Polk,7,7635,29167
2021-03-08,MO,Polk,58,7693,29167
2021-03-09,MO,Polk,215,7908,29167
2021-03-10,MO,Polk,175,8083,29167
2021-03-11,MO,Polk,222,8305,29167
2021-03-12,MO,Polk,290,8595,29167
2021-03-13,MO,Polk,76,8671,29167
2021-03-14,MO,Polk,7,8678,29167
2021-03-15,MO,Polk,78,8756,29167
2021-03-16,MO,Polk,257,9013,29167
2021-03-17,MO,Polk,125,9138,29167
2021-03-18,MO,Polk,159,9297,29167
2021-03-19,MO,Polk,202,9499,29167
2021-03-20,MO,Polk,41,9540,29167
2021-03-21,MO,Polk,10,9550,29167
2021-03-22,MO,Polk,99,9649,29167
2021-03-23,MO,Polk,222,9871,29167
2021-03-24,MO,Polk,300,10171,29167
2021-03-25,MO,Polk,360,10531,29167
2021-03-26,MO,Polk,445,10976,29167
2021-03-27,MO,Polk,75,11051,29167
2021-03-28,MO,Polk,13,11064,29167
2021-03-29,MO,Polk,75,11139,29167
2021-03-30,MO,Polk,215,11354,29167
2021-03-31,MO,Polk,189,11543,29167
2021-04-01,MO,Polk,356,11899,29167
2021-04-02,MO,Polk,168,12067,29167
2021-04-03,MO,Polk,51,12118,29167
2021-04-04,MO,Polk,11,12129,29167
2021-04-05,MO,Polk,68,12197,29167
2021-04-06,MO,Polk,159,12356,29167
2021-04-07,MO,Polk,85,12441,29167
2021-04-08,MO,Polk,169,12610,29167
2021-04-09,MO,Polk,181,12791,29167
2021-04-10,MO,Polk,57,12848,29167
2021-04-11,MO,Polk,27,12875,29167
2021-04-12,MO,Polk,82,12957,29167
2021-04-13,MO,Polk,116,13073,29167
2021-04-14,MO,Polk,91,13164,29167
2021-04-15,MO,Polk,170,13334,29167
2021-04-16,MO,Polk,180,13514,29167
2021-04-17,MO,Polk,29,13543,29167
2021-04-18,MO,Polk,7,13550,29167
2021-04-19,MO,Polk,47,13597,29167
2021-04-20,MO,Polk,79,13676,29167
2021-04-21,MO,Polk,132,13808,29167
2021-04-22,MO,Polk,71,13879,29167
2021-04-23,MO,Polk,81,13960,29167
2021-04-24,MO,Polk,24,13984,29167
2021-04-25,MO,Polk,7,13991,29167
2021-04-26,MO,Polk,59,14050,29167
2021-04-27,MO,Polk,39,14089,29167
2021-04-28,MO,Polk,45,14134,29167
2021-04-29,MO,Polk,106,14240,29167
2021-04-30,MO,Polk,73,14313,29167
2021-05-01,MO,Polk,21,14334,29167
2021-05-02,MO,Polk,10,14344,29167
2021-05-03,MO,Polk,40,14384,29167
2021-05-04,MO,Polk,34,14418,29167
2021-05-05,MO,Polk,60,14478,29167
2021-05-06,MO,Polk,79,14557,29167
2021-05-07,MO,Polk,49,14606,29167
2021-05-08,MO,Polk,9,14615,29167
2021-05-09,MO,Polk,23,14638,29167
2021-05-10,MO,Polk,17,14655,29167
2021-05-11,MO,Polk,29,14684,29167
2021-05-12,MO,Polk,34,14718,29167
2021-05-13,MO,Polk,72,14790,29167
2021-05-14,MO,Polk,54,14844,29167
2021-05-15,MO,Polk,30,14874,29167
2021-05-16,MO,Polk,12,14886,29167
2021-05-17,MO,Polk,42,14928,29167
2021-05-18,MO,Polk,42,14970,29167
2021-05-19,MO,Polk,39,15009,29167
2021-05-20,MO,Polk,30,15039,29167
2021-05-21,MO,Polk,46,15085,29167
2021-05-22,MO,Polk,26,15111,29167
2021-05-23,MO,Polk,11,15122,29167
2021-05-24,MO,Polk,30,15152,29167
2021-05-25,MO,Polk,39,15191,29167
2021-05-26,MO,Polk,27,15218,29167
2021-05-27,MO,Polk,8,15226,29167
2020-12-15,MO,Pulaski,1,1,29169
2020-12-16,MO,Pulaski,14,15,29169
2020-12-17,MO,Pulaski,12,27,29169
2020-12-18,MO,Pulaski,4,31,29169
2020-12-19,MO,Pulaski,4,35,29169
2020-12-21,MO,Pulaski,24,59,29169
2020-12-22,MO,Pulaski,34,93,29169
2020-12-23,MO,Pulaski,7,100,29169
2020-12-24,MO,Pulaski,1,101,29169
2020-12-27,MO,Pulaski,3,104,29169
2020-12-28,MO,Pulaski,19,123,29169
2020-12-29,MO,Pulaski,17,140,29169
2020-12-30,MO,Pulaski,33,173,29169
2020-12-31,MO,Pulaski,39,212,29169
2021-01-01,MO,Pulaski,8,220,29169
2021-01-02,MO,Pulaski,12,232,29169
2021-01-03,MO,Pulaski,6,238,29169
2021-01-04,MO,Pulaski,14,252,29169
2021-01-05,MO,Pulaski,21,273,29169
2021-01-06,MO,Pulaski,34,307,29169
2021-01-07,MO,Pulaski,48,355,29169
2021-01-08,MO,Pulaski,68,423,29169
2021-01-09,MO,Pulaski,1,424,29169
2021-01-11,MO,Pulaski,30,454,29169
2021-01-12,MO,Pulaski,68,522,29169
2021-01-13,MO,Pulaski,42,564,29169
2021-01-14,MO,Pulaski,49,613,29169
2021-01-15,MO,Pulaski,54,667,29169
2021-01-16,MO,Pulaski,95,762,29169
2021-01-17,MO,Pulaski,7,769,29169
2021-01-18,MO,Pulaski,43,812,29169
2021-01-19,MO,Pulaski,100,912,29169
2021-01-20,MO,Pulaski,200,1112,29169
2021-01-21,MO,Pulaski,101,1213,29169
2021-01-22,MO,Pulaski,120,1333,29169
2021-01-23,MO,Pulaski,183,1516,29169
2021-01-24,MO,Pulaski,5,1521,29169
2021-01-25,MO,Pulaski,34,1555,29169
2021-01-26,MO,Pulaski,24,1579,29169
2021-01-27,MO,Pulaski,37,1616,29169
2021-01-28,MO,Pulaski,176,1792,29169
2021-01-29,MO,Pulaski,262,2054,29169
2021-01-30,MO,Pulaski,211,2265,29169
2021-02-01,MO,Pulaski,7,2272,29169
2021-02-02,MO,Pulaski,117,2389,29169
2021-02-03,MO,Pulaski,59,2448,29169
2021-02-04,MO,Pulaski,91,2539,29169
2021-02-05,MO,Pulaski,187,2726,29169
2021-02-06,MO,Pulaski,113,2839,29169
2021-02-07,MO,Pulaski,8,2847,29169
2021-02-08,MO,Pulaski,44,2891,29169
2021-02-09,MO,Pulaski,131,3022,29169
2021-02-10,MO,Pulaski,36,3058,29169
2021-02-11,MO,Pulaski,183,3241,29169
2021-02-12,MO,Pulaski,52,3293,29169
2021-02-13,MO,Pulaski,28,3321,29169
2021-02-14,MO,Pulaski,2,3323,29169
2021-02-15,MO,Pulaski,16,3339,29169
2021-02-16,MO,Pulaski,17,3356,29169
2021-02-17,MO,Pulaski,13,3369,29169
2021-02-18,MO,Pulaski,275,3644,29169
2021-02-19,MO,Pulaski,185,3829,29169
2021-02-20,MO,Pulaski,3,3832,29169
2021-02-21,MO,Pulaski,1,3833,29169
2021-02-22,MO,Pulaski,45,3878,29169
2021-02-23,MO,Pulaski,126,4004,29169
2021-02-24,MO,Pulaski,22,4026,29169
2021-02-25,MO,Pulaski,165,4191,29169
2021-02-26,MO,Pulaski,129,4320,29169
2021-02-27,MO,Pulaski,443,4763,29169
2021-02-28,MO,Pulaski,4,4767,29169
2021-03-01,MO,Pulaski,33,4800,29169
2021-03-02,MO,Pulaski,253,5053,29169
2021-03-03,MO,Pulaski,96,5149,29169
2021-03-04,MO,Pulaski,134,5283,29169
2021-03-05,MO,Pulaski,87,5370,29169
2021-03-06,MO,Pulaski,28,5398,29169
2021-03-07,MO,Pulaski,37,5435,29169
2021-03-08,MO,Pulaski,56,5491,29169
2021-03-09,MO,Pulaski,54,5545,29169
2021-03-10,MO,Pulaski,61,5606,29169
2021-03-11,MO,Pulaski,90,5696,29169
2021-03-12,MO,Pulaski,118,5814,29169
2021-03-13,MO,Pulaski,14,5828,29169
2021-03-14,MO,Pulaski,5,5833,29169
2021-03-15,MO,Pulaski,87,5920,29169
2021-03-16,MO,Pulaski,191,6111,29169
2021-03-17,MO,Pulaski,38,6149,29169
2021-03-18,MO,Pulaski,48,6197,29169
2021-03-19,MO,Pulaski,118,6315,29169
2021-03-20,MO,Pulaski,19,6334,29169
2021-03-21,MO,Pulaski,3,6337,29169
2021-03-22,MO,Pulaski,77,6414,29169
2021-03-23,MO,Pulaski,88,6502,29169
2021-03-24,MO,Pulaski,64,6566,29169
2021-03-25,MO,Pulaski,205,6771,29169
2021-03-26,MO,Pulaski,116,6887,29169
2021-03-27,MO,Pulaski,25,6912,29169
2021-03-28,MO,Pulaski,13,6925,29169
2021-03-29,MO,Pulaski,107,7032,29169
2021-03-30,MO,Pulaski,76,7108,29169
2021-03-31,MO,Pulaski,128,7236,29169
2021-04-01,MO,Pulaski,168,7404,29169
2021-04-02,MO,Pulaski,289,7693,29169
2021-04-03,MO,Pulaski,11,7704,29169
2021-04-04,MO,Pulaski,6,7710,29169
2021-04-05,MO,Pulaski,65,7775,29169
2021-04-06,MO,Pulaski,225,8000,29169
2021-04-07,MO,Pulaski,73,8073,29169
2021-04-08,MO,Pulaski,96,8169,29169
2021-04-09,MO,Pulaski,162,8331,29169
2021-04-10,MO,Pulaski,30,8361,29169
2021-04-11,MO,Pulaski,17,8378,29169
2021-04-12,MO,Pulaski,160,8538,29169
2021-04-13,MO,Pulaski,92,8630,29169
2021-04-14,MO,Pulaski,74,8704,29169
2021-04-15,MO,Pulaski,156,8860,29169
2021-04-16,MO,Pulaski,72,8932,29169
2021-04-17,MO,Pulaski,24,8956,29169
2021-04-18,MO,Pulaski,9,8965,29169
2021-04-19,MO,Pulaski,156,9121,29169
2021-04-20,MO,Pulaski,58,9179,29169
2021-04-21,MO,Pulaski,86,9265,29169
2021-04-22,MO,Pulaski,104,9369,29169
2021-04-23,MO,Pulaski,56,9425,29169
2021-04-24,MO,Pulaski,24,9449,29169
2021-04-25,MO,Pulaski,14,9463,29169
2021-04-26,MO,Pulaski,65,9528,29169
2021-04-27,MO,Pulaski,88,9616,29169
2021-04-28,MO,Pulaski,81,9697,29169
2021-04-29,MO,Pulaski,67,9764,29169
2021-04-30,MO,Pulaski,123,9887,29169
2021-05-01,MO,Pulaski,21,9908,29169
2021-05-02,MO,Pulaski,18,9926,29169
2021-05-03,MO,Pulaski,70,9996,29169
2021-05-04,MO,Pulaski,50,10046,29169
2021-05-05,MO,Pulaski,60,10106,29169
2021-05-06,MO,Pulaski,53,10159,29169
2021-05-07,MO,Pulaski,58,10217,29169
2021-05-08,MO,Pulaski,18,10235,29169
2021-05-09,MO,Pulaski,12,10247,29169
2021-05-10,MO,Pulaski,62,10309,29169
2021-05-11,MO,Pulaski,67,10376,29169
2021-05-12,MO,Pulaski,53,10429,29169
2021-05-13,MO,Pulaski,122,10551,29169
2021-05-14,MO,Pulaski,68,10619,29169
2021-05-15,MO,Pulaski,57,10676,29169
2021-05-16,MO,Pulaski,17,10693,29169
2021-05-17,MO,Pulaski,119,10812,29169
2021-05-18,MO,Pulaski,69,10881,29169
2021-05-19,MO,Pulaski,61,10942,29169
2021-05-20,MO,Pulaski,149,11091,29169
2021-05-21,MO,Pulaski,46,11137,29169
2021-05-22,MO,Pulaski,28,11165,29169
2021-05-23,MO,Pulaski,19,11184,29169
2021-05-24,MO,Pulaski,44,11228,29169
2021-05-25,MO,Pulaski,43,11271,29169
2021-05-26,MO,Pulaski,50,11321,29169
2021-05-27,MO,Pulaski,56,11377,29169
2020-12-16,MO,Putnam,2,2,29171
2020-12-21,MO,Putnam,4,6,29171
2020-12-23,MO,Putnam,2,8,29171
2020-12-28,MO,Putnam,2,10,29171
2020-12-29,MO,Putnam,1,11,29171
2020-12-30,MO,Putnam,1,12,29171
2021-01-03,MO,Putnam,1,13,29171
2021-01-05,MO,Putnam,1,14,29171
2021-01-11,MO,Putnam,7,21,29171
2021-01-12,MO,Putnam,2,23,29171
2021-01-13,MO,Putnam,46,69,29171
2021-01-14,MO,Putnam,1,70,29171
2021-01-15,MO,Putnam,5,75,29171
2021-01-18,MO,Putnam,1,76,29171
2021-01-19,MO,Putnam,1,77,29171
2021-01-20,MO,Putnam,61,138,29171
2021-01-21,MO,Putnam,43,181,29171
2021-01-22,MO,Putnam,8,189,29171
2021-01-24,MO,Putnam,1,190,29171
2021-01-27,MO,Putnam,11,201,29171
2021-01-29,MO,Putnam,131,332,29171
2021-02-01,MO,Putnam,9,341,29171
2021-02-02,MO,Putnam,1,342,29171
2021-02-03,MO,Putnam,3,345,29171
2021-02-04,MO,Putnam,166,511,29171
2021-02-05,MO,Putnam,117,628,29171
2021-02-06,MO,Putnam,5,633,29171
2021-02-08,MO,Putnam,2,635,29171
2021-02-09,MO,Putnam,2,637,29171
2021-02-10,MO,Putnam,153,790,29171
2021-02-11,MO,Putnam,3,793,29171
2021-02-12,MO,Putnam,5,798,29171
2021-02-15,MO,Putnam,1,799,29171
2021-02-16,MO,Putnam,2,801,29171
2021-02-18,MO,Putnam,127,928,29171
2021-02-19,MO,Putnam,3,931,29171
2021-02-22,MO,Putnam,1,932,29171
2021-02-23,MO,Putnam,3,935,29171
2021-02-24,MO,Putnam,11,946,29171
2021-02-25,MO,Putnam,10,956,29171
2021-02-26,MO,Putnam,7,963,29171
2021-02-27,MO,Putnam,151,1114,29171
2021-02-28,MO,Putnam,1,1115,29171
2021-03-01,MO,Putnam,5,1120,29171
2021-03-02,MO,Putnam,27,1147,29171
2021-03-03,MO,Putnam,1,1148,29171
2021-03-04,MO,Putnam,186,1334,29171
2021-03-05,MO,Putnam,95,1429,29171
2021-03-06,MO,Putnam,5,1434,29171
2021-03-07,MO,Putnam,1,1435,29171
2021-03-08,MO,Putnam,5,1440,29171
2021-03-09,MO,Putnam,1,1441,29171
2021-03-11,MO,Putnam,3,1444,29171
2021-03-12,MO,Putnam,12,1456,29171
2021-03-15,MO,Putnam,2,1458,29171
2021-03-16,MO,Putnam,4,1462,29171
2021-03-17,MO,Putnam,6,1468,29171
2021-03-18,MO,Putnam,6,1474,29171
2021-03-19,MO,Putnam,5,1479,29171
2021-03-20,MO,Putnam,187,1666,29171
2021-03-21,MO,Putnam,2,1668,29171
2021-03-22,MO,Putnam,1,1669,29171
2021-03-23,MO,Putnam,3,1672,29171
2021-03-24,MO,Putnam,35,1707,29171
2021-03-25,MO,Putnam,30,1737,29171
2021-03-26,MO,Putnam,6,1743,29171
2021-03-27,MO,Putnam,2,1745,29171
2021-03-28,MO,Putnam,1,1746,29171
2021-03-29,MO,Putnam,7,1753,29171
2021-03-30,MO,Putnam,9,1762,29171
2021-03-31,MO,Putnam,37,1799,29171
2021-04-01,MO,Putnam,4,1803,29171
2021-04-02,MO,Putnam,12,1815,29171
2021-04-03,MO,Putnam,1,1816,29171
2021-04-06,MO,Putnam,10,1826,29171
2021-04-07,MO,Putnam,9,1835,29171
2021-04-08,MO,Putnam,91,1926,29171
2021-04-09,MO,Putnam,29,1955,29171
2021-04-10,MO,Putnam,3,1958,29171
2021-04-12,MO,Putnam,2,1960,29171
2021-04-13,MO,Putnam,5,1965,29171
2021-04-14,MO,Putnam,3,1968,29171
2021-04-15,MO,Putnam,4,1972,29171
2021-04-16,MO,Putnam,9,1981,29171
2021-04-19,MO,Putnam,7,1988,29171
2021-04-20,MO,Putnam,3,1991,29171
2021-04-21,MO,Putnam,1,1992,29171
2021-04-22,MO,Putnam,41,2033,29171
2021-04-23,MO,Putnam,2,2035,29171
2021-04-24,MO,Putnam,3,2038,29171
2021-04-26,MO,Putnam,3,2041,29171
2021-04-27,MO,Putnam,4,2045,29171
2021-04-28,MO,Putnam,40,2085,29171
2021-04-29,MO,Putnam,6,2091,29171
2021-04-30,MO,Putnam,6,2097,29171
2021-05-02,MO,Putnam,1,2098,29171
2021-05-03,MO,Putnam,14,2112,29171
2021-05-04,MO,Putnam,3,2115,29171
2021-05-05,MO,Putnam,22,2137,29171
2021-05-06,MO,Putnam,9,2146,29171
2021-05-07,MO,Putnam,1,2147,29171
2021-05-08,MO,Putnam,1,2148,29171
2021-05-11,MO,Putnam,3,2151,29171
2021-05-12,MO,Putnam,1,2152,29171
2021-05-14,MO,Putnam,9,2161,29171
2021-05-15,MO,Putnam,1,2162,29171
2021-05-16,MO,Putnam,1,2163,29171
2021-05-17,MO,Putnam,16,2179,29171
2021-05-18,MO,Putnam,1,2180,29171
2021-05-19,MO,Putnam,1,2181,29171
2021-05-20,MO,Putnam,6,2187,29171
2021-05-21,MO,Putnam,3,2190,29171
2021-05-24,MO,Putnam,2,2192,29171
2021-05-25,MO,Putnam,2,2194,29171
2020-12-16,MO,Ralls,1,1,29173
2020-12-18,MO,Ralls,1,2,29173
2020-12-19,MO,Ralls,1,3,29173
2020-12-21,MO,Ralls,1,4,29173
2020-12-22,MO,Ralls,1,5,29173
2020-12-23,MO,Ralls,15,20,29173
2020-12-27,MO,Ralls,1,21,29173
2020-12-28,MO,Ralls,20,41,29173
2020-12-29,MO,Ralls,22,63,29173
2020-12-30,MO,Ralls,21,84,29173
2020-12-31,MO,Ralls,1,85,29173
2021-01-02,MO,Ralls,1,86,29173
2021-01-05,MO,Ralls,7,93,29173
2021-01-07,MO,Ralls,14,107,29173
2021-01-08,MO,Ralls,16,123,29173
2021-01-09,MO,Ralls,4,127,29173
2021-01-10,MO,Ralls,1,128,29173
2021-01-11,MO,Ralls,4,132,29173
2021-01-12,MO,Ralls,15,147,29173
2021-01-13,MO,Ralls,16,163,29173
2021-01-14,MO,Ralls,9,172,29173
2021-01-18,MO,Ralls,100,272,29173
2021-01-19,MO,Ralls,108,380,29173
2021-01-20,MO,Ralls,203,583,29173
2021-01-21,MO,Ralls,108,691,29173
2021-01-22,MO,Ralls,72,763,29173
2021-01-23,MO,Ralls,3,766,29173
2021-01-24,MO,Ralls,2,768,29173
2021-01-25,MO,Ralls,2,770,29173
2021-01-26,MO,Ralls,16,786,29173
2021-01-27,MO,Ralls,7,793,29173
2021-01-28,MO,Ralls,6,799,29173
2021-01-29,MO,Ralls,26,825,29173
2021-02-01,MO,Ralls,8,833,29173
2021-02-02,MO,Ralls,66,899,29173
2021-02-03,MO,Ralls,2,901,29173
2021-02-04,MO,Ralls,106,1007,29173
2021-02-05,MO,Ralls,48,1055,29173
2021-02-06,MO,Ralls,7,1062,29173
2021-02-07,MO,Ralls,1,1063,29173
2021-02-08,MO,Ralls,81,1144,29173
2021-02-09,MO,Ralls,131,1275,29173
2021-02-10,MO,Ralls,6,1281,29173
2021-02-11,MO,Ralls,69,1350,29173
2021-02-12,MO,Ralls,124,1474,29173
2021-02-13,MO,Ralls,4,1478,29173
2021-02-15,MO,Ralls,89,1567,29173
2021-02-16,MO,Ralls,111,1678,29173
2021-02-17,MO,Ralls,16,1694,29173
2021-02-18,MO,Ralls,67,1761,29173
2021-02-19,MO,Ralls,28,1789,29173
2021-02-20,MO,Ralls,3,1792,29173
2021-02-21,MO,Ralls,2,1794,29173
2021-02-22,MO,Ralls,34,1828,29173
2021-02-23,MO,Ralls,10,1838,29173
2021-02-24,MO,Ralls,7,1845,29173
2021-02-25,MO,Ralls,87,1932,29173
2021-02-26,MO,Ralls,47,1979,29173
2021-02-27,MO,Ralls,6,1985,29173
2021-03-01,MO,Ralls,6,1991,29173
2021-03-02,MO,Ralls,121,2112,29173
2021-03-03,MO,Ralls,4,2116,29173
2021-03-04,MO,Ralls,103,2219,29173
2021-03-05,MO,Ralls,90,2309,29173
2021-03-06,MO,Ralls,4,2313,29173
2021-03-08,MO,Ralls,12,2325,29173
2021-03-09,MO,Ralls,24,2349,29173
2021-03-10,MO,Ralls,10,2359,29173
2021-03-11,MO,Ralls,21,2380,29173
2021-03-12,MO,Ralls,15,2395,29173
2021-03-13,MO,Ralls,3,2398,29173
2021-03-14,MO,Ralls,3,2401,29173
2021-03-15,MO,Ralls,68,2469,29173
2021-03-16,MO,Ralls,151,2620,29173
2021-03-17,MO,Ralls,12,2632,29173
2021-03-18,MO,Ralls,134,2766,29173
2021-03-19,MO,Ralls,19,2785,29173
2021-03-20,MO,Ralls,4,2789,29173
2021-03-22,MO,Ralls,37,2826,29173
2021-03-23,MO,Ralls,7,2833,29173
2021-03-24,MO,Ralls,46,2879,29173
2021-03-25,MO,Ralls,59,2938,29173
2021-03-26,MO,Ralls,14,2952,29173
2021-03-27,MO,Ralls,3,2955,29173
2021-03-29,MO,Ralls,5,2960,29173
2021-03-30,MO,Ralls,69,3029,29173
2021-03-31,MO,Ralls,14,3043,29173
2021-04-01,MO,Ralls,61,3104,29173
2021-04-02,MO,Ralls,81,3185,29173
2021-04-04,MO,Ralls,1,3186,29173
2021-04-05,MO,Ralls,3,3189,29173
2021-04-06,MO,Ralls,18,3207,29173
2021-04-07,MO,Ralls,23,3230,29173
2021-04-08,MO,Ralls,96,3326,29173
2021-04-09,MO,Ralls,89,3415,29173
2021-04-10,MO,Ralls,2,3417,29173
2021-04-11,MO,Ralls,5,3422,29173
2021-04-12,MO,Ralls,17,3439,29173
2021-04-13,MO,Ralls,136,3575,29173
2021-04-14,MO,Ralls,45,3620,29173
2021-04-15,MO,Ralls,20,3640,29173
2021-04-16,MO,Ralls,15,3655,29173
2021-04-17,MO,Ralls,2,3657,29173
2021-04-19,MO,Ralls,12,3669,29173
2021-04-20,MO,Ralls,26,3695,29173
2021-04-21,MO,Ralls,3,3698,29173
2021-04-22,MO,Ralls,58,3756,29173
2021-04-23,MO,Ralls,7,3763,29173
2021-04-24,MO,Ralls,2,3765,29173
2021-04-26,MO,Ralls,3,3768,29173
2021-04-27,MO,Ralls,31,3799,29173
2021-04-28,MO,Ralls,16,3815,29173
2021-04-29,MO,Ralls,9,3824,29173
2021-04-30,MO,Ralls,73,3897,29173
2021-05-01,MO,Ralls,5,3902,29173
2021-05-03,MO,Ralls,2,3904,29173
2021-05-04,MO,Ralls,25,3929,29173
2021-05-05,MO,Ralls,5,3934,29173
2021-05-06,MO,Ralls,12,3946,29173
2021-05-07,MO,Ralls,12,3958,29173
2021-05-08,MO,Ralls,4,3962,29173
2021-05-10,MO,Ralls,4,3966,29173
2021-05-11,MO,Ralls,24,3990,29173
2021-05-12,MO,Ralls,5,3995,29173
2021-05-13,MO,Ralls,10,4005,29173
2021-05-14,MO,Ralls,10,4015,29173
2021-05-15,MO,Ralls,1,4016,29173
2021-05-16,MO,Ralls,1,4017,29173
2021-05-17,MO,Ralls,5,4022,29173
2021-05-18,MO,Ralls,40,4062,29173
2021-05-19,MO,Ralls,7,4069,29173
2021-05-20,MO,Ralls,8,4077,29173
2021-05-21,MO,Ralls,1,4078,29173
2021-05-22,MO,Ralls,2,4080,29173
2021-05-23,MO,Ralls,1,4081,29173
2021-05-24,MO,Ralls,2,4083,29173
2021-05-25,MO,Ralls,5,4088,29173
2021-05-26,MO,Ralls,4,4092,29173
2021-05-27,MO,Ralls,5,4097,29173
2020-12-16,MO,Randolph,8,8,29175
2020-12-17,MO,Randolph,10,18,29175
2020-12-18,MO,Randolph,12,30,29175
2020-12-19,MO,Randolph,8,38,29175
2020-12-20,MO,Randolph,11,49,29175
2020-12-21,MO,Randolph,19,68,29175
2020-12-22,MO,Randolph,22,90,29175
2020-12-23,MO,Randolph,6,96,29175
2020-12-28,MO,Randolph,28,124,29175
2020-12-29,MO,Randolph,29,153,29175
2020-12-30,MO,Randolph,64,217,29175
2020-12-31,MO,Randolph,18,235,29175
2021-01-02,MO,Randolph,9,244,29175
2021-01-03,MO,Randolph,4,248,29175
2021-01-04,MO,Randolph,11,259,29175
2021-01-05,MO,Randolph,16,275,29175
2021-01-06,MO,Randolph,18,293,29175
2021-01-07,MO,Randolph,17,310,29175
2021-01-08,MO,Randolph,24,334,29175
2021-01-09,MO,Randolph,12,346,29175
2021-01-10,MO,Randolph,15,361,29175
2021-01-11,MO,Randolph,32,393,29175
2021-01-12,MO,Randolph,70,463,29175
2021-01-13,MO,Randolph,52,515,29175
2021-01-14,MO,Randolph,16,531,29175
2021-01-15,MO,Randolph,50,581,29175
2021-01-16,MO,Randolph,9,590,29175
2021-01-18,MO,Randolph,64,654,29175
2021-01-19,MO,Randolph,70,724,29175
2021-01-20,MO,Randolph,108,832,29175
2021-01-21,MO,Randolph,138,970,29175
2021-01-22,MO,Randolph,41,1011,29175
2021-01-23,MO,Randolph,43,1054,29175
2021-01-24,MO,Randolph,3,1057,29175
2021-01-25,MO,Randolph,36,1093,29175
2021-01-26,MO,Randolph,28,1121,29175
2021-01-27,MO,Randolph,8,1129,29175
2021-01-28,MO,Randolph,32,1161,29175
2021-01-29,MO,Randolph,995,2156,29175
2021-01-30,MO,Randolph,9,2165,29175
2021-01-31,MO,Randolph,6,2171,29175
2021-02-01,MO,Randolph,14,2185,29175
2021-02-02,MO,Randolph,127,2312,29175
2021-02-03,MO,Randolph,22,2334,29175
2021-02-04,MO,Randolph,57,2391,29175
2021-02-05,MO,Randolph,154,2545,29175
2021-02-06,MO,Randolph,25,2570,29175
2021-02-07,MO,Randolph,2,2572,29175
2021-02-08,MO,Randolph,16,2588,29175
2021-02-09,MO,Randolph,111,2699,29175
2021-02-10,MO,Randolph,109,2808,29175
2021-02-11,MO,Randolph,77,2885,29175
2021-02-12,MO,Randolph,107,2992,29175
2021-02-13,MO,Randolph,16,3008,29175
2021-02-14,MO,Randolph,3,3011,29175
2021-02-15,MO,Randolph,74,3085,29175
2021-02-16,MO,Randolph,75,3160,29175
2021-02-17,MO,Randolph,147,3307,29175
2021-02-18,MO,Randolph,80,3387,29175
2021-02-19,MO,Randolph,48,3435,29175
2021-02-20,MO,Randolph,44,3479,29175
2021-02-21,MO,Randolph,3,3482,29175
2021-02-22,MO,Randolph,47,3529,29175
2021-02-23,MO,Randolph,24,3553,29175
2021-02-24,MO,Randolph,906,4459,29175
2021-02-25,MO,Randolph,88,4547,29175
2021-02-26,MO,Randolph,31,4578,29175
2021-02-27,MO,Randolph,32,4610,29175
2021-02-28,MO,Randolph,1,4611,29175
2021-03-01,MO,Randolph,30,4641,29175
2021-03-02,MO,Randolph,100,4741,29175
2021-03-03,MO,Randolph,70,4811,29175
2021-03-04,MO,Randolph,86,4897,29175
2021-03-05,MO,Randolph,177,5074,29175
2021-03-06,MO,Randolph,32,5106,29175
2021-03-07,MO,Randolph,10,5116,29175
2021-03-08,MO,Randolph,84,5200,29175
2021-03-09,MO,Randolph,141,5341,29175
2021-03-10,MO,Randolph,423,5764,29175
2021-03-11,MO,Randolph,133,5897,29175
2021-03-12,MO,Randolph,92,5989,29175
2021-03-13,MO,Randolph,3,5992,29175
2021-03-15,MO,Randolph,81,6073,29175
2021-03-16,MO,Randolph,120,6193,29175
2021-03-17,MO,Randolph,207,6400,29175
2021-03-18,MO,Randolph,58,6458,29175
2021-03-19,MO,Randolph,55,6513,29175
2021-03-20,MO,Randolph,13,6526,29175
2021-03-21,MO,Randolph,10,6536,29175
2021-03-22,MO,Randolph,82,6618,29175
2021-03-23,MO,Randolph,108,6726,29175
2021-03-24,MO,Randolph,96,6822,29175
2021-03-25,MO,Randolph,88,6910,29175
2021-03-26,MO,Randolph,140,7050,29175
2021-03-27,MO,Randolph,23,7073,29175
2021-03-28,MO,Randolph,9,7082,29175
2021-03-29,MO,Randolph,55,7137,29175
2021-03-30,MO,Randolph,90,7227,29175
2021-03-31,MO,Randolph,384,7611,29175
2021-04-01,MO,Randolph,46,7657,29175
2021-04-02,MO,Randolph,112,7769,29175
2021-04-03,MO,Randolph,15,7784,29175
2021-04-04,MO,Randolph,2,7786,29175
2021-04-05,MO,Randolph,69,7855,29175
2021-04-06,MO,Randolph,160,8015,29175
2021-04-07,MO,Randolph,167,8182,29175
2021-04-08,MO,Randolph,60,8242,29175
2021-04-09,MO,Randolph,92,8334,29175
2021-04-10,MO,Randolph,15,8349,29175
2021-04-11,MO,Randolph,19,8368,29175
2021-04-12,MO,Randolph,268,8636,29175
2021-04-13,MO,Randolph,86,8722,29175
2021-04-14,MO,Randolph,105,8827,29175
2021-04-15,MO,Randolph,61,8888,29175
2021-04-16,MO,Randolph,141,9029,29175
2021-04-17,MO,Randolph,23,9052,29175
2021-04-18,MO,Randolph,5,9057,29175
2021-04-19,MO,Randolph,71,9128,29175
2021-04-20,MO,Randolph,94,9222,29175
2021-04-21,MO,Randolph,196,9418,29175
2021-04-22,MO,Randolph,31,9449,29175
2021-04-23,MO,Randolph,84,9533,29175
2021-04-24,MO,Randolph,10,9543,29175
2021-04-25,MO,Randolph,2,9545,29175
2021-04-26,MO,Randolph,42,9587,29175
2021-04-27,MO,Randolph,72,9659,29175
2021-04-28,MO,Randolph,82,9741,29175
2021-04-29,MO,Randolph,31,9772,29175
2021-04-30,MO,Randolph,50,9822,29175
2021-05-01,MO,Randolph,20,9842,29175
2021-05-02,MO,Randolph,3,9845,29175
2021-05-03,MO,Randolph,59,9904,29175
2021-05-04,MO,Randolph,66,9970,29175
2021-05-05,MO,Randolph,52,10022,29175
2021-05-06,MO,Randolph,54,10076,29175
2021-05-07,MO,Randolph,62,10138,29175
2021-05-08,MO,Randolph,24,10162,29175
2021-05-09,MO,Randolph,5,10167,29175
2021-05-10,MO,Randolph,44,10211,29175
2021-05-11,MO,Randolph,63,10274,29175
2021-05-12,MO,Randolph,78,10352,29175
2021-05-13,MO,Randolph,40,10392,29175
2021-05-14,MO,Randolph,64,10456,29175
2021-05-15,MO,Randolph,19,10475,29175
2021-05-16,MO,Randolph,20,10495,29175
2021-05-17,MO,Randolph,62,10557,29175
2021-05-18,MO,Randolph,56,10613,29175
2021-05-19,MO,Randolph,44,10657,29175
2021-05-20,MO,Randolph,47,10704,29175
2021-05-21,MO,Randolph,32,10736,29175
2021-05-22,MO,Randolph,36,10772,29175
2021-05-23,MO,Randolph,5,10777,29175
2021-05-24,MO,Randolph,18,10795,29175
2021-05-25,MO,Randolph,42,10837,29175
2021-05-26,MO,Randolph,26,10863,29175
2021-05-27,MO,Randolph,34,10897,29175
2020-12-16,MO,Ray,1,1,29177
2020-12-17,MO,Ray,4,5,29177
2020-12-18,MO,Ray,3,8,29177
2020-12-19,MO,Ray,3,11,29177
2020-12-21,MO,Ray,10,21,29177
2020-12-22,MO,Ray,16,37,29177
2020-12-23,MO,Ray,13,50,29177
2020-12-24,MO,Ray,2,52,29177
2020-12-26,MO,Ray,3,55,29177
2020-12-27,MO,Ray,1,56,29177
2020-12-28,MO,Ray,4,60,29177
2020-12-29,MO,Ray,28,88,29177
2020-12-30,MO,Ray,45,133,29177
2020-12-31,MO,Ray,50,183,29177
2021-01-02,MO,Ray,17,200,29177
2021-01-03,MO,Ray,3,203,29177
2021-01-04,MO,Ray,1,204,29177
2021-01-05,MO,Ray,96,300,29177
2021-01-06,MO,Ray,26,326,29177
2021-01-07,MO,Ray,31,357,29177
2021-01-08,MO,Ray,33,390,29177
2021-01-09,MO,Ray,5,395,29177
2021-01-10,MO,Ray,1,396,29177
2021-01-11,MO,Ray,37,433,29177
2021-01-12,MO,Ray,25,458,29177
2021-01-13,MO,Ray,19,477,29177
2021-01-14,MO,Ray,11,488,29177
2021-01-15,MO,Ray,20,508,29177
2021-01-16,MO,Ray,3,511,29177
2021-01-17,MO,Ray,1,512,29177
2021-01-18,MO,Ray,106,618,29177
2021-01-19,MO,Ray,24,642,29177
2021-01-20,MO,Ray,37,679,29177
2021-01-21,MO,Ray,49,728,29177
2021-01-22,MO,Ray,48,776,29177
2021-01-23,MO,Ray,19,795,29177
2021-01-24,MO,Ray,1,796,29177
2021-01-25,MO,Ray,35,831,29177
2021-01-26,MO,Ray,89,920,29177
2021-01-27,MO,Ray,99,1019,29177
2021-01-28,MO,Ray,123,1142,29177
2021-01-29,MO,Ray,176,1318,29177
2021-01-30,MO,Ray,81,1399,29177
2021-01-31,MO,Ray,10,1409,29177
2021-02-01,MO,Ray,64,1473,29177
2021-02-02,MO,Ray,60,1533,29177
2021-02-03,MO,Ray,131,1664,29177
2021-02-04,MO,Ray,168,1832,29177
2021-02-05,MO,Ray,152,1984,29177
2021-02-06,MO,Ray,43,2027,29177
2021-02-08,MO,Ray,27,2054,29177
2021-02-09,MO,Ray,17,2071,29177
2021-02-10,MO,Ray,36,2107,29177
2021-02-11,MO,Ray,53,2160,29177
2021-02-12,MO,Ray,42,2202,29177
2021-02-13,MO,Ray,34,2236,29177
2021-02-14,MO,Ray,3,2239,29177
2021-02-15,MO,Ray,126,2365,29177
2021-02-16,MO,Ray,40,2405,29177
2021-02-17,MO,Ray,38,2443,29177
2021-02-18,MO,Ray,59,2502,29177
2021-02-19,MO,Ray,28,2530,29177
2021-02-20,MO,Ray,49,2579,29177
2021-02-21,MO,Ray,4,2583,29177
2021-02-22,MO,Ray,43,2626,29177
2021-02-23,MO,Ray,55,2681,29177
2021-02-24,MO,Ray,179,2860,29177
2021-02-25,MO,Ray,150,3010,29177
2021-02-26,MO,Ray,314,3324,29177
2021-02-27,MO,Ray,89,3413,29177
2021-02-28,MO,Ray,9,3422,29177
2021-03-01,MO,Ray,67,3489,29177
2021-03-02,MO,Ray,215,3704,29177
2021-03-03,MO,Ray,132,3836,29177
2021-03-04,MO,Ray,96,3932,29177
2021-03-05,MO,Ray,175,4107,29177
2021-03-06,MO,Ray,66,4173,29177
2021-03-07,MO,Ray,10,4183,29177
2021-03-08,MO,Ray,56,4239,29177
2021-03-09,MO,Ray,161,4400,29177
2021-03-10,MO,Ray,58,4458,29177
2021-03-11,MO,Ray,129,4587,29177
2021-03-12,MO,Ray,87,4674,29177
2021-03-13,MO,Ray,40,4714,29177
2021-03-14,MO,Ray,21,4735,29177
2021-03-15,MO,Ray,107,4842,29177
2021-03-16,MO,Ray,243,5085,29177
2021-03-17,MO,Ray,174,5259,29177
2021-03-18,MO,Ray,171,5430,29177
2021-03-19,MO,Ray,144,5574,29177
2021-03-20,MO,Ray,37,5611,29177
2021-03-21,MO,Ray,6,5617,29177
2021-03-22,MO,Ray,18,5635,29177
2021-03-23,MO,Ray,90,5725,29177
2021-03-24,MO,Ray,156,5881,29177
2021-03-25,MO,Ray,190,6071,29177
2021-03-26,MO,Ray,230,6301,29177
2021-03-27,MO,Ray,37,6338,29177
2021-03-28,MO,Ray,9,6347,29177
2021-03-29,MO,Ray,101,6448,29177
2021-03-30,MO,Ray,162,6610,29177
2021-03-31,MO,Ray,182,6792,29177
2021-04-01,MO,Ray,124,6916,29177
2021-04-02,MO,Ray,267,7183,29177
2021-04-03,MO,Ray,22,7205,29177
2021-04-04,MO,Ray,1,7206,29177
2021-04-05,MO,Ray,67,7273,29177
2021-04-06,MO,Ray,90,7363,29177
2021-04-07,MO,Ray,111,7474,29177
2021-04-08,MO,Ray,124,7598,29177
2021-04-09,MO,Ray,237,7835,29177
2021-04-10,MO,Ray,42,7877,29177
2021-04-11,MO,Ray,11,7888,29177
2021-04-12,MO,Ray,68,7956,29177
2021-04-13,MO,Ray,121,8077,29177
2021-04-14,MO,Ray,223,8300,29177
2021-04-15,MO,Ray,115,8415,29177
2021-04-16,MO,Ray,173,8588,29177
2021-04-17,MO,Ray,44,8632,29177
2021-04-18,MO,Ray,5,8637,29177
2021-04-19,MO,Ray,32,8669,29177
2021-04-20,MO,Ray,59,8728,29177
2021-04-21,MO,Ray,70,8798,29177
2021-04-22,MO,Ray,103,8901,29177
2021-04-23,MO,Ray,113,9014,29177
2021-04-24,MO,Ray,16,9030,29177
2021-04-25,MO,Ray,3,9033,29177
2021-04-26,MO,Ray,31,9064,29177
2021-04-27,MO,Ray,78,9142,29177
2021-04-28,MO,Ray,103,9245,29177
2021-04-29,MO,Ray,62,9307,29177
2021-04-30,MO,Ray,74,9381,29177
2021-05-01,MO,Ray,30,9411,29177
2021-05-02,MO,Ray,2,9413,29177
2021-05-03,MO,Ray,29,9442,29177
2021-05-04,MO,Ray,44,9486,29177
2021-05-05,MO,Ray,107,9593,29177
2021-05-06,MO,Ray,146,9739,29177
2021-05-07,MO,Ray,66,9805,29177
2021-05-08,MO,Ray,21,9826,29177
2021-05-09,MO,Ray,9,9835,29177
2021-05-10,MO,Ray,26,9861,29177
2021-05-11,MO,Ray,95,9956,29177
2021-05-12,MO,Ray,23,9979,29177
2021-05-13,MO,Ray,72,10051,29177
2021-05-14,MO,Ray,68,10119,29177
2021-05-15,MO,Ray,64,10183,29177
2021-05-16,MO,Ray,6,10189,29177
2021-05-17,MO,Ray,39,10228,29177
2021-05-18,MO,Ray,77,10305,29177
2021-05-19,MO,Ray,78,10383,29177
2021-05-20,MO,Ray,48,10431,29177
2021-05-21,MO,Ray,39,10470,29177
2021-05-22,MO,Ray,24,10494,29177
2021-05-23,MO,Ray,6,10500,29177
2021-05-24,MO,Ray,31,10531,29177
2021-05-25,MO,Ray,36,10567,29177
2021-05-26,MO,Ray,26,10593,29177
2021-05-27,MO,Ray,29,10622,29177
2020-12-18,MO,Reynolds,1,1,29179
2020-12-23,MO,Reynolds,3,4,29179
2020-12-24,MO,Reynolds,1,5,29179
2020-12-29,MO,Reynolds,2,7,29179
2020-12-31,MO,Reynolds,6,13,29179
2021-01-01,MO,Reynolds,1,14,29179
2021-01-02,MO,Reynolds,3,17,29179
2021-01-04,MO,Reynolds,1,18,29179
2021-01-06,MO,Reynolds,1,19,29179
2021-01-07,MO,Reynolds,1,20,29179
2021-01-08,MO,Reynolds,1,21,29179
2021-01-09,MO,Reynolds,2,23,29179
2021-01-11,MO,Reynolds,2,25,29179
2021-01-12,MO,Reynolds,1,26,29179
2021-01-13,MO,Reynolds,9,35,29179
2021-01-14,MO,Reynolds,3,38,29179
2021-01-15,MO,Reynolds,3,41,29179
2021-01-18,MO,Reynolds,1,42,29179
2021-01-19,MO,Reynolds,4,46,29179
2021-01-20,MO,Reynolds,11,57,29179
2021-01-21,MO,Reynolds,2,59,29179
2021-01-22,MO,Reynolds,17,76,29179
2021-01-23,MO,Reynolds,2,78,29179
2021-01-25,MO,Reynolds,7,85,29179
2021-01-26,MO,Reynolds,2,87,29179
2021-01-27,MO,Reynolds,3,90,29179
2021-01-28,MO,Reynolds,9,99,29179
2021-01-29,MO,Reynolds,14,113,29179
2021-01-30,MO,Reynolds,3,116,29179
2021-02-01,MO,Reynolds,2,118,29179
2021-02-02,MO,Reynolds,61,179,29179
2021-02-03,MO,Reynolds,31,210,29179
2021-02-04,MO,Reynolds,13,223,29179
2021-02-05,MO,Reynolds,6,229,29179
2021-02-06,MO,Reynolds,9,238,29179
2021-02-08,MO,Reynolds,138,376,29179
2021-02-09,MO,Reynolds,39,415,29179
2021-02-10,MO,Reynolds,7,422,29179
2021-02-11,MO,Reynolds,21,443,29179
2021-02-12,MO,Reynolds,32,475,29179
2021-02-13,MO,Reynolds,1,476,29179
2021-02-16,MO,Reynolds,1,477,29179
2021-02-17,MO,Reynolds,3,480,29179
2021-02-18,MO,Reynolds,10,490,29179
2021-02-19,MO,Reynolds,17,507,29179
2021-02-20,MO,Reynolds,3,510,29179
2021-02-21,MO,Reynolds,1,511,29179
2021-02-22,MO,Reynolds,67,578,29179
2021-02-23,MO,Reynolds,9,587,29179
2021-02-24,MO,Reynolds,3,590,29179
2021-02-25,MO,Reynolds,27,617,29179
2021-02-26,MO,Reynolds,19,636,29179
2021-02-27,MO,Reynolds,32,668,29179
2021-03-01,MO,Reynolds,131,799,29179
2021-03-02,MO,Reynolds,67,866,29179
2021-03-03,MO,Reynolds,42,908,29179
2021-03-04,MO,Reynolds,9,917,29179
2021-03-05,MO,Reynolds,3,920,29179
2021-03-06,MO,Reynolds,11,931,29179
2021-03-08,MO,Reynolds,9,940,29179
2021-03-09,MO,Reynolds,7,947,29179
2021-03-10,MO,Reynolds,7,954,29179
2021-03-11,MO,Reynolds,20,974,29179
2021-03-12,MO,Reynolds,21,995,29179
2021-03-13,MO,Reynolds,2,997,29179
2021-03-15,MO,Reynolds,2,999,29179
2021-03-16,MO,Reynolds,6,1005,29179
2021-03-17,MO,Reynolds,9,1014,29179
2021-03-18,MO,Reynolds,27,1041,29179
2021-03-19,MO,Reynolds,19,1060,29179
2021-03-20,MO,Reynolds,5,1065,29179
2021-03-21,MO,Reynolds,2,1067,29179
2021-03-22,MO,Reynolds,14,1081,29179
2021-03-23,MO,Reynolds,74,1155,29179
2021-03-24,MO,Reynolds,6,1161,29179
2021-03-25,MO,Reynolds,17,1178,29179
2021-03-26,MO,Reynolds,4,1182,29179
2021-03-27,MO,Reynolds,27,1209,29179
2021-03-28,MO,Reynolds,3,1212,29179
2021-03-29,MO,Reynolds,12,1224,29179
2021-03-30,MO,Reynolds,12,1236,29179
2021-03-31,MO,Reynolds,39,1275,29179
2021-04-01,MO,Reynolds,15,1290,29179
2021-04-02,MO,Reynolds,4,1294,29179
2021-04-03,MO,Reynolds,5,1299,29179
2021-04-04,MO,Reynolds,1,1300,29179
2021-04-05,MO,Reynolds,6,1306,29179
2021-04-06,MO,Reynolds,7,1313,29179
2021-04-07,MO,Reynolds,25,1338,29179
2021-04-08,MO,Reynolds,11,1349,29179
2021-04-09,MO,Reynolds,19,1368,29179
2021-04-10,MO,Reynolds,6,1374,29179
2021-04-11,MO,Reynolds,3,1377,29179
2021-04-12,MO,Reynolds,3,1380,29179
2021-04-13,MO,Reynolds,16,1396,29179
2021-04-14,MO,Reynolds,10,1406,29179
2021-04-15,MO,Reynolds,27,1433,29179
2021-04-16,MO,Reynolds,7,1440,29179
2021-04-17,MO,Reynolds,1,1441,29179
2021-04-18,MO,Reynolds,1,1442,29179
2021-04-19,MO,Reynolds,9,1451,29179
2021-04-20,MO,Reynolds,9,1460,29179
2021-04-21,MO,Reynolds,23,1483,29179
2021-04-22,MO,Reynolds,16,1499,29179
2021-04-23,MO,Reynolds,12,1511,29179
2021-04-24,MO,Reynolds,1,1512,29179
2021-04-25,MO,Reynolds,3,1515,29179
2021-04-26,MO,Reynolds,3,1518,29179
2021-04-27,MO,Reynolds,5,1523,29179
2021-04-28,MO,Reynolds,33,1556,29179
2021-04-29,MO,Reynolds,13,1569,29179
2021-04-30,MO,Reynolds,5,1574,29179
2021-05-01,MO,Reynolds,2,1576,29179
2021-05-02,MO,Reynolds,2,1578,29179
2021-05-03,MO,Reynolds,1,1579,29179
2021-05-04,MO,Reynolds,9,1588,29179
2021-05-05,MO,Reynolds,27,1615,29179
2021-05-06,MO,Reynolds,6,1621,29179
2021-05-07,MO,Reynolds,10,1631,29179
2021-05-10,MO,Reynolds,3,1634,29179
2021-05-11,MO,Reynolds,21,1655,29179
2021-05-12,MO,Reynolds,13,1668,29179
2021-05-13,MO,Reynolds,6,1674,29179
2021-05-14,MO,Reynolds,13,1687,29179
2021-05-15,MO,Reynolds,2,1689,29179
2021-05-17,MO,Reynolds,13,1702,29179
2021-05-18,MO,Reynolds,8,1710,29179
2021-05-19,MO,Reynolds,15,1725,29179
2021-05-20,MO,Reynolds,2,1727,29179
2021-05-21,MO,Reynolds,4,1731,29179
2021-05-23,MO,Reynolds,5,1736,29179
2021-05-24,MO,Reynolds,5,1741,29179
2021-05-25,MO,Reynolds,5,1746,29179
2021-05-26,MO,Reynolds,16,1762,29179
2021-05-27,MO,Reynolds,2,1764,29179
2020-12-18,MO,Ripley,4,4,29181
2020-12-22,MO,Ripley,1,5,29181
2020-12-23,MO,Ripley,5,10,29181
2020-12-28,MO,Ripley,6,16,29181
2020-12-29,MO,Ripley,28,44,29181
2020-12-30,MO,Ripley,104,148,29181
2020-12-31,MO,Ripley,4,152,29181
2021-01-04,MO,Ripley,6,158,29181
2021-01-05,MO,Ripley,25,183,29181
2021-01-06,MO,Ripley,8,191,29181
2021-01-07,MO,Ripley,280,471,29181
2021-01-08,MO,Ripley,12,483,29181
2021-01-11,MO,Ripley,11,494,29181
2021-01-12,MO,Ripley,48,542,29181
2021-01-13,MO,Ripley,4,546,29181
2021-01-14,MO,Ripley,62,608,29181
2021-01-15,MO,Ripley,3,611,29181
2021-01-18,MO,Ripley,1,612,29181
2021-01-19,MO,Ripley,13,625,29181
2021-01-20,MO,Ripley,2,627,29181
2021-01-21,MO,Ripley,4,631,29181
2021-01-22,MO,Ripley,68,699,29181
2021-01-23,MO,Ripley,30,729,29181
2021-01-24,MO,Ripley,1,730,29181
2021-01-25,MO,Ripley,11,741,29181
2021-01-26,MO,Ripley,53,794,29181
2021-01-27,MO,Ripley,7,801,29181
2021-01-28,MO,Ripley,147,948,29181
2021-01-29,MO,Ripley,13,961,29181
2021-01-30,MO,Ripley,1,962,29181
2021-01-31,MO,Ripley,1,963,29181
2021-02-01,MO,Ripley,11,974,29181
2021-02-02,MO,Ripley,20,994,29181
2021-02-03,MO,Ripley,25,1019,29181
2021-02-04,MO,Ripley,152,1171,29181
2021-02-05,MO,Ripley,137,1308,29181
2021-02-06,MO,Ripley,491,1799,29181
2021-02-08,MO,Ripley,13,1812,29181
2021-02-09,MO,Ripley,63,1875,29181
2021-02-10,MO,Ripley,2,1877,29181
2021-02-11,MO,Ripley,2,1879,29181
2021-02-12,MO,Ripley,84,1963,29181
2021-02-13,MO,Ripley,1,1964,29181
2021-02-14,MO,Ripley,1,1965,29181
2021-02-15,MO,Ripley,1,1966,29181
2021-02-16,MO,Ripley,5,1971,29181
2021-02-17,MO,Ripley,3,1974,29181
2021-02-18,MO,Ripley,5,1979,29181
2021-02-19,MO,Ripley,11,1990,29181
2021-02-20,MO,Ripley,49,2039,29181
2021-02-21,MO,Ripley,7,2046,29181
2021-02-22,MO,Ripley,27,2073,29181
2021-02-23,MO,Ripley,16,2089,29181
2021-02-24,MO,Ripley,31,2120,29181
2021-02-25,MO,Ripley,10,2130,29181
2021-02-26,MO,Ripley,12,2142,29181
2021-02-27,MO,Ripley,4,2146,29181
2021-02-28,MO,Ripley,2,2148,29181
2021-03-01,MO,Ripley,12,2160,29181
2021-03-02,MO,Ripley,27,2187,29181
2021-03-03,MO,Ripley,24,2211,29181
2021-03-04,MO,Ripley,17,2228,29181
2021-03-05,MO,Ripley,21,2249,29181
2021-03-06,MO,Ripley,478,2727,29181
2021-03-07,MO,Ripley,1,2728,29181
2021-03-08,MO,Ripley,28,2756,29181
2021-03-09,MO,Ripley,69,2825,29181
2021-03-10,MO,Ripley,29,2854,29181
2021-03-11,MO,Ripley,107,2961,29181
2021-03-12,MO,Ripley,119,3080,29181
2021-03-13,MO,Ripley,6,3086,29181
2021-03-14,MO,Ripley,1,3087,29181
2021-03-15,MO,Ripley,12,3099,29181
2021-03-16,MO,Ripley,10,3109,29181
2021-03-17,MO,Ripley,32,3141,29181
2021-03-18,MO,Ripley,27,3168,29181
2021-03-19,MO,Ripley,25,3193,29181
2021-03-20,MO,Ripley,10,3203,29181
2021-03-21,MO,Ripley,3,3206,29181
2021-03-22,MO,Ripley,6,3212,29181
2021-03-23,MO,Ripley,30,3242,29181
2021-03-24,MO,Ripley,28,3270,29181
2021-03-25,MO,Ripley,11,3281,29181
2021-03-26,MO,Ripley,12,3293,29181
2021-03-27,MO,Ripley,4,3297,29181
2021-03-28,MO,Ripley,3,3300,29181
2021-03-29,MO,Ripley,8,3308,29181
2021-03-30,MO,Ripley,58,3366,29181
2021-03-31,MO,Ripley,27,3393,29181
2021-04-01,MO,Ripley,28,3421,29181
2021-04-02,MO,Ripley,10,3431,29181
2021-04-03,MO,Ripley,4,3435,29181
2021-04-04,MO,Ripley,5,3440,29181
2021-04-05,MO,Ripley,20,3460,29181
2021-04-06,MO,Ripley,40,3500,29181
2021-04-07,MO,Ripley,36,3536,29181
2021-04-08,MO,Ripley,105,3641,29181
2021-04-09,MO,Ripley,159,3800,29181
2021-04-10,MO,Ripley,13,3813,29181
2021-04-11,MO,Ripley,8,3821,29181
2021-04-12,MO,Ripley,18,3839,29181
2021-04-13,MO,Ripley,29,3868,29181
2021-04-14,MO,Ripley,29,3897,29181
2021-04-15,MO,Ripley,22,3919,29181
2021-04-16,MO,Ripley,34,3953,29181
2021-04-17,MO,Ripley,7,3960,29181
2021-04-18,MO,Ripley,6,3966,29181
2021-04-19,MO,Ripley,18,3984,29181
2021-04-20,MO,Ripley,12,3996,29181
2021-04-21,MO,Ripley,26,4022,29181
2021-04-22,MO,Ripley,25,4047,29181
2021-04-23,MO,Ripley,36,4083,29181
2021-04-24,MO,Ripley,6,4089,29181
2021-04-25,MO,Ripley,2,4091,29181
2021-04-26,MO,Ripley,14,4105,29181
2021-04-27,MO,Ripley,24,4129,29181
2021-04-28,MO,Ripley,22,4151,29181
2021-04-29,MO,Ripley,14,4165,29181
2021-04-30,MO,Ripley,14,4179,29181
2021-05-01,MO,Ripley,6,4185,29181
2021-05-02,MO,Ripley,4,4189,29181
2021-05-03,MO,Ripley,14,4203,29181
2021-05-04,MO,Ripley,10,4213,29181
2021-05-05,MO,Ripley,26,4239,29181
2021-05-06,MO,Ripley,16,4255,29181
2021-05-07,MO,Ripley,25,4280,29181
2021-05-08,MO,Ripley,3,4283,29181
2021-05-09,MO,Ripley,4,4287,29181
2021-05-10,MO,Ripley,24,4311,29181
2021-05-11,MO,Ripley,14,4325,29181
2021-05-12,MO,Ripley,22,4347,29181
2021-05-13,MO,Ripley,10,4357,29181
2021-05-14,MO,Ripley,37,4394,29181
2021-05-15,MO,Ripley,4,4398,29181
2021-05-16,MO,Ripley,2,4400,29181
2021-05-17,MO,Ripley,20,4420,29181
2021-05-18,MO,Ripley,17,4437,29181
2021-05-19,MO,Ripley,30,4467,29181
2021-05-20,MO,Ripley,10,4477,29181
2021-05-21,MO,Ripley,15,4492,29181
2021-05-22,MO,Ripley,4,4496,29181
2021-05-23,MO,Ripley,6,4502,29181
2021-05-24,MO,Ripley,10,4512,29181
2021-05-25,MO,Ripley,12,4524,29181
2021-05-26,MO,Ripley,14,4538,29181
2021-05-27,MO,Ripley,13,4551,29181
2020-12-16,MO,Saline,1,1,29195
2020-12-17,MO,Saline,4,5,29195
2020-12-18,MO,Saline,5,10,29195
2020-12-19,MO,Saline,4,14,29195
2020-12-20,MO,Saline,1,15,29195
2020-12-21,MO,Saline,10,25,29195
2020-12-22,MO,Saline,5,30,29195
2020-12-23,MO,Saline,10,40,29195
2020-12-24,MO,Saline,1,41,29195
2020-12-28,MO,Saline,102,143,29195
2020-12-29,MO,Saline,80,223,29195
2020-12-30,MO,Saline,44,267,29195
2020-12-31,MO,Saline,10,277,29195
2021-01-02,MO,Saline,1,278,29195
2021-01-03,MO,Saline,1,279,29195
2021-01-04,MO,Saline,20,299,29195
2021-01-05,MO,Saline,79,378,29195
2021-01-06,MO,Saline,102,480,29195
2021-01-07,MO,Saline,18,498,29195
2021-01-08,MO,Saline,9,507,29195
2021-01-09,MO,Saline,4,511,29195
2021-01-10,MO,Saline,9,520,29195
2021-01-11,MO,Saline,80,600,29195
2021-01-12,MO,Saline,143,743,29195
2021-01-13,MO,Saline,68,811,29195
2021-01-14,MO,Saline,42,853,29195
2021-01-15,MO,Saline,26,879,29195
2021-01-16,MO,Saline,6,885,29195
2021-01-18,MO,Saline,33,918,29195
2021-01-19,MO,Saline,135,1053,29195
2021-01-20,MO,Saline,86,1139,29195
2021-01-21,MO,Saline,52,1191,29195
2021-01-22,MO,Saline,27,1218,29195
2021-01-23,MO,Saline,7,1225,29195
2021-01-25,MO,Saline,46,1271,29195
2021-01-26,MO,Saline,147,1418,29195
2021-01-27,MO,Saline,88,1506,29195
2021-01-28,MO,Saline,330,1836,29195
2021-01-29,MO,Saline,337,2173,29195
2021-01-30,MO,Saline,25,2198,29195
2021-01-31,MO,Saline,2,2200,29195
2021-02-01,MO,Saline,216,2416,29195
2021-02-02,MO,Saline,86,2502,29195
2021-02-03,MO,Saline,383,2885,29195
2021-02-04,MO,Saline,307,3192,29195
2021-02-05,MO,Saline,86,3278,29195
2021-02-06,MO,Saline,4,3282,29195
2021-02-08,MO,Saline,187,3469,29195
2021-02-09,MO,Saline,452,3921,29195
2021-02-10,MO,Saline,309,4230,29195
2021-02-11,MO,Saline,86,4316,29195
2021-02-12,MO,Saline,92,4408,29195
2021-02-13,MO,Saline,16,4424,29195
2021-02-14,MO,Saline,5,4429,29195
2021-02-15,MO,Saline,27,4456,29195
2021-02-16,MO,Saline,251,4707,29195
2021-02-17,MO,Saline,89,4796,29195
2021-02-18,MO,Saline,83,4879,29195
2021-02-19,MO,Saline,95,4974,29195
2021-02-20,MO,Saline,9,4983,29195
2021-02-21,MO,Saline,1,4984,29195
2021-02-22,MO,Saline,18,5002,29195
2021-02-23,MO,Saline,528,5530,29195
2021-02-24,MO,Saline,275,5805,29195
2021-02-25,MO,Saline,252,6057,29195
2021-02-26,MO,Saline,109,6166,29195
2021-02-27,MO,Saline,17,6183,29195
2021-02-28,MO,Saline,6,6189,29195
2021-03-01,MO,Saline,242,6431,29195
2021-03-02,MO,Saline,326,6757,29195
2021-03-03,MO,Saline,546,7303,29195
2021-03-04,MO,Saline,155,7458,29195
2021-03-05,MO,Saline,28,7486,29195
2021-03-06,MO,Saline,12,7498,29195
2021-03-07,MO,Saline,3,7501,29195
2021-03-08,MO,Saline,164,7665,29195
2021-03-09,MO,Saline,51,7716,29195
2021-03-10,MO,Saline,187,7903,29195
2021-03-11,MO,Saline,24,7927,29195
2021-03-12,MO,Saline,492,8419,29195
2021-03-13,MO,Saline,25,8444,29195
2021-03-14,MO,Saline,9,8453,29195
2021-03-15,MO,Saline,151,8604,29195
2021-03-16,MO,Saline,334,8938,29195
2021-03-17,MO,Saline,129,9067,29195
2021-03-18,MO,Saline,105,9172,29195
2021-03-19,MO,Saline,41,9213,29195
2021-03-20,MO,Saline,12,9225,29195
2021-03-21,MO,Saline,5,9230,29195
2021-03-22,MO,Saline,48,9278,29195
2021-03-23,MO,Saline,62,9340,29195
2021-03-24,MO,Saline,298,9638,29195
2021-03-25,MO,Saline,215,9853,29195
2021-03-26,MO,Saline,173,10026,29195
2021-03-27,MO,Saline,240,10266,29195
2021-03-28,MO,Saline,16,10282,29195
2021-03-29,MO,Saline,63,10345,29195
2021-03-30,MO,Saline,55,10400,29195
2021-03-31,MO,Saline,184,10584,29195
2021-04-01,MO,Saline,123,10707,29195
2021-04-02,MO,Saline,532,11239,29195
2021-04-03,MO,Saline,24,11263,29195
2021-04-04,MO,Saline,3,11266,29195
2021-04-05,MO,Saline,151,11417,29195
2021-04-06,MO,Saline,58,11475,29195
2021-04-07,MO,Saline,107,11582,29195
2021-04-08,MO,Saline,49,11631,29195
2021-04-09,MO,Saline,79,11710,29195
2021-04-10,MO,Saline,20,11730,29195
2021-04-11,MO,Saline,6,11736,29195
2021-04-12,MO,Saline,174,11910,29195
2021-04-13,MO,Saline,46,11956,29195
2021-04-14,MO,Saline,124,12080,29195
2021-04-15,MO,Saline,90,12170,29195
2021-04-16,MO,Saline,44,12214,29195
2021-04-17,MO,Saline,214,12428,29195
2021-04-18,MO,Saline,6,12434,29195
2021-04-19,MO,Saline,37,12471,29195
2021-04-20,MO,Saline,78,12549,29195
2021-04-21,MO,Saline,134,12683,29195
2021-04-22,MO,Saline,67,12750,29195
2021-04-23,MO,Saline,107,12857,29195
2021-04-24,MO,Saline,22,12879,29195
2021-04-25,MO,Saline,7,12886,29195
2021-04-26,MO,Saline,58,12944,29195
2021-04-27,MO,Saline,26,12970,29195
2021-04-28,MO,Saline,77,13047,29195
2021-04-29,MO,Saline,149,13196,29195
2021-04-30,MO,Saline,56,13252,29195
2021-05-01,MO,Saline,11,13263,29195
2021-05-02,MO,Saline,7,13270,29195
2021-05-03,MO,Saline,135,13405,29195
2021-05-04,MO,Saline,24,13429,29195
2021-05-05,MO,Saline,85,13514,29195
2021-05-06,MO,Saline,49,13563,29195
2021-05-07,MO,Saline,44,13607,29195
2021-05-08,MO,Saline,12,13619,29195
2021-05-09,MO,Saline,1,13620,29195
2021-05-10,MO,Saline,44,13664,29195
2021-05-11,MO,Saline,35,13699,29195
2021-05-12,MO,Saline,70,13769,29195
2021-05-13,MO,Saline,67,13836,29195
2021-05-14,MO,Saline,39,13875,29195
2021-05-15,MO,Saline,22,13897,29195
2021-05-16,MO,Saline,20,13917,29195
2021-05-17,MO,Saline,24,13941,29195
2021-05-18,MO,Saline,47,13988,29195
2021-05-19,MO,Saline,56,14044,29195
2021-05-20,MO,Saline,64,14108,29195
2021-05-21,MO,Saline,29,14137,29195
2021-05-22,MO,Saline,12,14149,29195
2021-05-23,MO,Saline,5,14154,29195
2021-05-24,MO,Saline,45,14199,29195
2021-05-25,MO,Saline,20,14219,29195
2021-05-26,MO,Saline,36,14255,29195
2021-05-27,MO,Saline,64,14319,29195
2020-12-17,MO,Schuyler,1,1,29197
2020-12-20,MO,Schuyler,1,2,29197
2020-12-21,MO,Schuyler,10,12,29197
2020-12-22,MO,Schuyler,2,14,29197
2020-12-23,MO,Schuyler,14,28,29197
2020-12-28,MO,Schuyler,3,31,29197
2020-12-29,MO,Schuyler,1,32,29197
2020-12-30,MO,Schuyler,1,33,29197
2021-01-04,MO,Schuyler,1,34,29197
2021-01-05,MO,Schuyler,1,35,29197
2021-01-07,MO,Schuyler,2,37,29197
2021-01-10,MO,Schuyler,1,38,29197
2021-01-11,MO,Schuyler,13,51,29197
2021-01-12,MO,Schuyler,2,53,29197
2021-01-13,MO,Schuyler,10,63,29197
2021-01-14,MO,Schuyler,4,67,29197
2021-01-15,MO,Schuyler,36,103,29197
2021-01-17,MO,Schuyler,2,105,29197
2021-01-18,MO,Schuyler,1,106,29197
2021-01-19,MO,Schuyler,4,110,29197
2021-01-20,MO,Schuyler,5,115,29197
2021-01-21,MO,Schuyler,23,138,29197
2021-01-22,MO,Schuyler,3,141,29197
2021-01-23,MO,Schuyler,2,143,29197
2021-01-27,MO,Schuyler,15,158,29197
2021-01-28,MO,Schuyler,1,159,29197
2021-01-29,MO,Schuyler,1,160,29197
2021-02-01,MO,Schuyler,5,165,29197
2021-02-02,MO,Schuyler,13,178,29197
2021-02-03,MO,Schuyler,8,186,29197
2021-02-04,MO,Schuyler,7,193,29197
2021-02-05,MO,Schuyler,134,327,29197
2021-02-06,MO,Schuyler,20,347,29197
2021-02-08,MO,Schuyler,3,350,29197
2021-02-09,MO,Schuyler,2,352,29197
2021-02-10,MO,Schuyler,2,354,29197
2021-02-11,MO,Schuyler,28,382,29197
2021-02-12,MO,Schuyler,70,452,29197
2021-02-13,MO,Schuyler,2,454,29197
2021-02-14,MO,Schuyler,2,456,29197
2021-02-15,MO,Schuyler,1,457,29197
2021-02-16,MO,Schuyler,6,463,29197
2021-02-18,MO,Schuyler,4,467,29197
2021-02-19,MO,Schuyler,7,474,29197
2021-02-23,MO,Schuyler,65,539,29197
2021-02-24,MO,Schuyler,12,551,29197
2021-02-25,MO,Schuyler,21,572,29197
2021-02-26,MO,Schuyler,15,587,29197
2021-02-27,MO,Schuyler,8,595,29197
2021-02-28,MO,Schuyler,2,597,29197
2021-03-01,MO,Schuyler,20,617,29197
2021-03-02,MO,Schuyler,62,679,29197
2021-03-03,MO,Schuyler,6,685,29197
2021-03-04,MO,Schuyler,3,688,29197
2021-03-05,MO,Schuyler,134,822,29197
2021-03-06,MO,Schuyler,20,842,29197
2021-03-08,MO,Schuyler,4,846,29197
2021-03-09,MO,Schuyler,29,875,29197
2021-03-10,MO,Schuyler,3,878,29197
2021-03-11,MO,Schuyler,3,881,29197
2021-03-12,MO,Schuyler,42,923,29197
2021-03-13,MO,Schuyler,1,924,29197
2021-03-15,MO,Schuyler,1,925,29197
2021-03-16,MO,Schuyler,14,939,29197
2021-03-17,MO,Schuyler,13,952,29197
2021-03-18,MO,Schuyler,11,963,29197
2021-03-19,MO,Schuyler,17,980,29197
2021-03-20,MO,Schuyler,13,993,29197
2021-03-22,MO,Schuyler,4,997,29197
2021-03-23,MO,Schuyler,55,1052,29197
2021-03-24,MO,Schuyler,7,1059,29197
2021-03-25,MO,Schuyler,24,1083,29197
2021-03-26,MO,Schuyler,25,1108,29197
2021-03-30,MO,Schuyler,64,1172,29197
2021-03-31,MO,Schuyler,5,1177,29197
2021-04-01,MO,Schuyler,4,1181,29197
2021-04-02,MO,Schuyler,8,1189,29197
2021-04-03,MO,Schuyler,1,1190,29197
2021-04-05,MO,Schuyler,6,1196,29197
2021-04-06,MO,Schuyler,58,1254,29197
2021-04-07,MO,Schuyler,2,1256,29197
2021-04-08,MO,Schuyler,9,1265,29197
2021-04-09,MO,Schuyler,3,1268,29197
2021-04-10,MO,Schuyler,4,1272,29197
2021-04-11,MO,Schuyler,1,1273,29197
2021-04-12,MO,Schuyler,4,1277,29197
2021-04-13,MO,Schuyler,3,1280,29197
2021-04-14,MO,Schuyler,7,1287,29197
2021-04-15,MO,Schuyler,6,1293,29197
2021-04-16,MO,Schuyler,23,1316,29197
2021-04-17,MO,Schuyler,2,1318,29197
2021-04-19,MO,Schuyler,1,1319,29197
2021-04-20,MO,Schuyler,3,1322,29197
2021-04-21,MO,Schuyler,7,1329,29197
2021-04-22,MO,Schuyler,2,1331,29197
2021-04-23,MO,Schuyler,4,1335,29197
2021-04-26,MO,Schuyler,1,1336,29197
2021-04-27,MO,Schuyler,3,1339,29197
2021-04-28,MO,Schuyler,4,1343,29197
2021-04-29,MO,Schuyler,1,1344,29197
2021-04-30,MO,Schuyler,4,1348,29197
2021-05-03,MO,Schuyler,2,1350,29197
2021-05-04,MO,Schuyler,4,1354,29197
2021-05-05,MO,Schuyler,6,1360,29197
2021-05-06,MO,Schuyler,2,1362,29197
2021-05-07,MO,Schuyler,1,1363,29197
2021-05-08,MO,Schuyler,2,1365,29197
2021-05-09,MO,Schuyler,1,1366,29197
2021-05-10,MO,Schuyler,1,1367,29197
2021-05-11,MO,Schuyler,3,1370,29197
2021-05-12,MO,Schuyler,3,1373,29197
2021-05-13,MO,Schuyler,5,1378,29197
2021-05-14,MO,Schuyler,3,1381,29197
2021-05-15,MO,Schuyler,3,1384,29197
2021-05-17,MO,Schuyler,3,1387,29197
2021-05-18,MO,Schuyler,7,1394,29197
2021-05-19,MO,Schuyler,5,1399,29197
2021-05-20,MO,Schuyler,1,1400,29197
2021-05-21,MO,Schuyler,4,1404,29197
2021-05-24,MO,Schuyler,6,1410,29197
2021-05-25,MO,Schuyler,2,1412,29197
2021-05-26,MO,Schuyler,4,1416,29197
2020-12-21,MO,Scotland,4,4,29199
2020-12-22,MO,Scotland,4,8,29199
2020-12-23,MO,Scotland,26,34,29199
2020-12-28,MO,Scotland,14,48,29199
2020-12-29,MO,Scotland,1,49,29199
2021-01-04,MO,Scotland,1,50,29199
2021-01-05,MO,Scotland,5,55,29199
2021-01-07,MO,Scotland,1,56,29199
2021-01-08,MO,Scotland,1,57,29199
2021-01-11,MO,Scotland,7,64,29199
2021-01-12,MO,Scotland,1,65,29199
2021-01-13,MO,Scotland,5,70,29199
2021-01-14,MO,Scotland,1,71,29199
2021-01-15,MO,Scotland,5,76,29199
2021-01-17,MO,Scotland,26,102,29199
2021-01-18,MO,Scotland,2,104,29199
2021-01-19,MO,Scotland,3,107,29199
2021-01-20,MO,Scotland,28,135,29199
2021-01-21,MO,Scotland,46,181,29199
2021-01-22,MO,Scotland,1,182,29199
2021-01-25,MO,Scotland,12,194,29199
2021-01-26,MO,Scotland,1,195,29199
2021-01-27,MO,Scotland,32,227,29199
2021-01-28,MO,Scotland,2,229,29199
2021-01-29,MO,Scotland,52,281,29199
2021-01-30,MO,Scotland,1,282,29199
2021-02-01,MO,Scotland,43,325,29199
2021-02-02,MO,Scotland,48,373,29199
2021-02-03,MO,Scotland,48,421,29199
2021-02-04,MO,Scotland,17,438,29199
2021-02-05,MO,Scotland,5,443,29199
2021-02-06,MO,Scotland,128,571,29199
2021-02-08,MO,Scotland,5,576,29199
2021-02-09,MO,Scotland,3,579,29199
2021-02-10,MO,Scotland,3,582,29199
2021-02-11,MO,Scotland,43,625,29199
2021-02-12,MO,Scotland,110,735,29199
2021-02-14,MO,Scotland,27,762,29199
2021-02-15,MO,Scotland,13,775,29199
2021-02-16,MO,Scotland,7,782,29199
2021-02-17,MO,Scotland,1,783,29199
2021-02-19,MO,Scotland,6,789,29199
2021-02-20,MO,Scotland,1,790,29199
2021-02-23,MO,Scotland,2,792,29199
2021-02-24,MO,Scotland,3,795,29199
2021-02-25,MO,Scotland,68,863,29199
2021-02-26,MO,Scotland,35,898,29199
2021-02-27,MO,Scotland,1,899,29199
2021-03-01,MO,Scotland,112,1011,29199
2021-03-02,MO,Scotland,6,1017,29199
2021-03-03,MO,Scotland,26,1043,29199
2021-03-04,MO,Scotland,2,1045,29199
2021-03-05,MO,Scotland,36,1081,29199
2021-03-06,MO,Scotland,121,1202,29199
2021-03-07,MO,Scotland,1,1203,29199
2021-03-08,MO,Scotland,4,1207,29199
2021-03-09,MO,Scotland,5,1212,29199
2021-03-10,MO,Scotland,6,1218,29199
2021-03-11,MO,Scotland,2,1220,29199
2021-03-12,MO,Scotland,91,1311,29199
2021-03-13,MO,Scotland,1,1312,29199
2021-03-14,MO,Scotland,1,1313,29199
2021-03-15,MO,Scotland,6,1319,29199
2021-03-16,MO,Scotland,12,1331,29199
2021-03-17,MO,Scotland,19,1350,29199
2021-03-18,MO,Scotland,22,1372,29199
2021-03-19,MO,Scotland,33,1405,29199
2021-03-20,MO,Scotland,1,1406,29199
2021-03-23,MO,Scotland,2,1408,29199
2021-03-24,MO,Scotland,8,1416,29199
2021-03-25,MO,Scotland,5,1421,29199
2021-03-26,MO,Scotland,33,1454,29199
2021-03-28,MO,Scotland,1,1455,29199
2021-03-29,MO,Scotland,2,1457,29199
2021-03-30,MO,Scotland,4,1461,29199
2021-03-31,MO,Scotland,12,1473,29199
2021-04-01,MO,Scotland,5,1478,29199
2021-04-02,MO,Scotland,4,1482,29199
2021-04-03,MO,Scotland,1,1483,29199
2021-04-05,MO,Scotland,2,1485,29199
2021-04-06,MO,Scotland,6,1491,29199
2021-04-07,MO,Scotland,1,1492,29199
2021-04-08,MO,Scotland,3,1495,29199
2021-04-09,MO,Scotland,2,1497,29199
2021-04-10,MO,Scotland,11,1508,29199
2021-04-12,MO,Scotland,1,1509,29199
2021-04-14,MO,Scotland,3,1512,29199
2021-04-15,MO,Scotland,2,1514,29199
2021-04-16,MO,Scotland,19,1533,29199
2021-04-19,MO,Scotland,3,1536,29199
2021-04-21,MO,Scotland,2,1538,29199
2021-04-22,MO,Scotland,2,1540,29199
2021-04-23,MO,Scotland,10,1550,29199
2021-04-24,MO,Scotland,1,1551,29199
2021-04-26,MO,Scotland,1,1552,29199
2021-04-28,MO,Scotland,14,1566,29199
2021-04-29,MO,Scotland,5,1571,29199
2021-04-30,MO,Scotland,7,1578,29199
2021-05-02,MO,Scotland,1,1579,29199
2021-05-04,MO,Scotland,2,1581,29199
2021-05-05,MO,Scotland,2,1583,29199
2021-05-06,MO,Scotland,2,1585,29199
2021-05-07,MO,Scotland,1,1586,29199
2021-05-08,MO,Scotland,12,1598,29199
2021-05-09,MO,Scotland,2,1600,29199
2021-05-11,MO,Scotland,1,1601,29199
2021-05-12,MO,Scotland,15,1616,29199
2021-05-13,MO,Scotland,4,1620,29199
2021-05-14,MO,Scotland,11,1631,29199
2021-05-15,MO,Scotland,1,1632,29199
2021-05-16,MO,Scotland,2,1634,29199
2021-05-17,MO,Scotland,5,1639,29199
2021-05-18,MO,Scotland,4,1643,29199
2021-05-19,MO,Scotland,2,1645,29199
2021-05-20,MO,Scotland,1,1646,29199
2021-05-21,MO,Scotland,3,1649,29199
2021-05-25,MO,Scotland,11,1660,29199
2021-05-26,MO,Scotland,2,1662,29199
2021-05-27,MO,Scotland,1,1663,29199
2020-12-15,MO,Scott,1,1,29201
2020-12-17,MO,Scott,31,32,29201
2020-12-18,MO,Scott,22,54,29201
2020-12-19,MO,Scott,4,58,29201
2020-12-20,MO,Scott,4,62,29201
2020-12-21,MO,Scott,71,133,29201
2020-12-22,MO,Scott,204,337,29201
2020-12-23,MO,Scott,186,523,29201
2020-12-24,MO,Scott,7,530,29201
2020-12-26,MO,Scott,2,532,29201
2020-12-28,MO,Scott,7,539,29201
2020-12-29,MO,Scott,18,557,29201
2020-12-30,MO,Scott,88,645,29201
2020-12-31,MO,Scott,12,657,29201
2021-01-01,MO,Scott,9,666,29201
2021-01-02,MO,Scott,2,668,29201
2021-01-03,MO,Scott,1,669,29201
2021-01-04,MO,Scott,21,690,29201
2021-01-05,MO,Scott,50,740,29201
2021-01-06,MO,Scott,93,833,29201
2021-01-07,MO,Scott,32,865,29201
2021-01-08,MO,Scott,143,1008,29201
2021-01-09,MO,Scott,24,1032,29201
2021-01-10,MO,Scott,2,1034,29201
2021-01-11,MO,Scott,60,1094,29201
2021-01-12,MO,Scott,304,1398,29201
2021-01-13,MO,Scott,186,1584,29201
2021-01-14,MO,Scott,96,1680,29201
2021-01-15,MO,Scott,98,1778,29201
2021-01-16,MO,Scott,42,1820,29201
2021-01-17,MO,Scott,1,1821,29201
2021-01-18,MO,Scott,272,2093,29201
2021-01-19,MO,Scott,310,2403,29201
2021-01-20,MO,Scott,508,2911,29201
2021-01-21,MO,Scott,400,3311,29201
2021-01-22,MO,Scott,562,3873,29201
2021-01-23,MO,Scott,11,3884,29201
2021-01-24,MO,Scott,1,3885,29201
2021-01-25,MO,Scott,237,4122,29201
2021-01-26,MO,Scott,215,4337,29201
2021-01-27,MO,Scott,164,4501,29201
2021-01-28,MO,Scott,102,4603,29201
2021-01-29,MO,Scott,980,5583,29201
2021-01-30,MO,Scott,4,5587,29201
2021-02-01,MO,Scott,52,5639,29201
2021-02-02,MO,Scott,92,5731,29201
2021-02-03,MO,Scott,43,5774,29201
2021-02-04,MO,Scott,120,5894,29201
2021-02-05,MO,Scott,771,6665,29201
2021-02-06,MO,Scott,22,6687,29201
2021-02-07,MO,Scott,3,6690,29201
2021-02-08,MO,Scott,243,6933,29201
2021-02-09,MO,Scott,566,7499,29201
2021-02-10,MO,Scott,427,7926,29201
2021-02-11,MO,Scott,250,8176,29201
2021-02-12,MO,Scott,645,8821,29201
2021-02-13,MO,Scott,144,8965,29201
2021-02-14,MO,Scott,3,8968,29201
2021-02-15,MO,Scott,115,9083,29201
2021-02-16,MO,Scott,120,9203,29201
2021-02-17,MO,Scott,72,9275,29201
2021-02-18,MO,Scott,49,9324,29201
2021-02-19,MO,Scott,156,9480,29201
2021-02-20,MO,Scott,67,9547,29201
2021-02-22,MO,Scott,122,9669,29201
2021-02-23,MO,Scott,103,9772,29201
2021-02-24,MO,Scott,772,10544,29201
2021-02-25,MO,Scott,171,10715,29201
2021-02-26,MO,Scott,877,11592,29201
2021-02-27,MO,Scott,90,11682,29201
2021-02-28,MO,Scott,5,11687,29201
2021-03-01,MO,Scott,79,11766,29201
2021-03-02,MO,Scott,173,11939,29201
2021-03-03,MO,Scott,417,12356,29201
2021-03-04,MO,Scott,330,12686,29201
2021-03-05,MO,Scott,590,13276,29201
2021-03-06,MO,Scott,22,13298,29201
2021-03-07,MO,Scott,1,13299,29201
2021-03-08,MO,Scott,178,13477,29201
2021-03-09,MO,Scott,195,13672,29201
2021-03-10,MO,Scott,156,13828,29201
2021-03-11,MO,Scott,140,13968,29201
2021-03-12,MO,Scott,185,14153,29201
2021-03-13,MO,Scott,16,14169,29201
2021-03-14,MO,Scott,418,14587,29201
2021-03-15,MO,Scott,126,14713,29201
2021-03-16,MO,Scott,321,15034,29201
2021-03-17,MO,Scott,603,15637,29201
2021-03-18,MO,Scott,113,15750,29201
2021-03-19,MO,Scott,260,16010,29201
2021-03-20,MO,Scott,19,16029,29201
2021-03-21,MO,Scott,32,16061,29201
2021-03-22,MO,Scott,106,16167,29201
2021-03-23,MO,Scott,53,16220,29201
2021-03-24,MO,Scott,325,16545,29201
2021-03-25,MO,Scott,336,16881,29201
2021-03-26,MO,Scott,162,17043,29201
2021-03-27,MO,Scott,15,17058,29201
2021-03-28,MO,Scott,186,17244,29201
2021-03-29,MO,Scott,95,17339,29201
2021-03-30,MO,Scott,285,17624,29201
2021-03-31,MO,Scott,255,17879,29201
2021-04-01,MO,Scott,81,17960,29201
2021-04-02,MO,Scott,133,18093,29201
2021-04-03,MO,Scott,32,18125,29201
2021-04-04,MO,Scott,11,18136,29201
2021-04-05,MO,Scott,509,18645,29201
2021-04-06,MO,Scott,443,19088,29201
2021-04-07,MO,Scott,226,19314,29201
2021-04-08,MO,Scott,289,19603,29201
2021-04-09,MO,Scott,304,19907,29201
2021-04-10,MO,Scott,22,19929,29201
2021-04-11,MO,Scott,26,19955,29201
2021-04-12,MO,Scott,94,20049,29201
2021-04-13,MO,Scott,79,20128,29201
2021-04-14,MO,Scott,119,20247,29201
2021-04-15,MO,Scott,179,20426,29201
2021-04-16,MO,Scott,218,20644,29201
2021-04-17,MO,Scott,18,20662,29201
2021-04-18,MO,Scott,165,20827,29201
2021-04-19,MO,Scott,124,20951,29201
2021-04-20,MO,Scott,204,21155,29201
2021-04-21,MO,Scott,116,21271,29201
2021-04-22,MO,Scott,92,21363,29201
2021-04-23,MO,Scott,80,21443,29201
2021-04-24,MO,Scott,30,21473,29201
2021-04-25,MO,Scott,4,21477,29201
2021-04-26,MO,Scott,69,21546,29201
2021-04-27,MO,Scott,37,21583,29201
2021-04-28,MO,Scott,71,21654,29201
2021-04-29,MO,Scott,155,21809,29201
2021-04-30,MO,Scott,121,21930,29201
2021-05-01,MO,Scott,17,21947,29201
2021-05-02,MO,Scott,30,21977,29201
2021-05-03,MO,Scott,63,22040,29201
2021-05-04,MO,Scott,165,22205,29201
2021-05-05,MO,Scott,75,22280,29201
2021-05-06,MO,Scott,147,22427,29201
2021-05-07,MO,Scott,79,22506,29201
2021-05-08,MO,Scott,28,22534,29201
2021-05-09,MO,Scott,7,22541,29201
2021-05-10,MO,Scott,55,22596,29201
2021-05-11,MO,Scott,63,22659,29201
2021-05-12,MO,Scott,41,22700,29201
2021-05-13,MO,Scott,59,22759,29201
2021-05-14,MO,Scott,104,22863,29201
2021-05-15,MO,Scott,28,22891,29201
2021-05-16,MO,Scott,7,22898,29201
2021-05-17,MO,Scott,56,22954,29201
2021-05-18,MO,Scott,74,23028,29201
2021-05-19,MO,Scott,69,23097,29201
2021-05-20,MO,Scott,38,23135,29201
2021-05-21,MO,Scott,111,23246,29201
2021-05-22,MO,Scott,13,23259,29201
2021-05-23,MO,Scott,7,23266,29201
2021-05-24,MO,Scott,38,23304,29201
2021-05-25,MO,Scott,95,23399,29201
2021-05-26,MO,Scott,51,23450,29201
2021-05-27,MO,Scott,10,23460,29201
2020-12-18,MO,Shannon,1,1,29203
2020-12-21,MO,Shannon,1,2,29203
2020-12-22,MO,Shannon,4,6,29203
2020-12-23,MO,Shannon,4,10,29203
2020-12-24,MO,Shannon,1,11,29203
2020-12-26,MO,Shannon,1,12,29203
2020-12-28,MO,Shannon,1,13,29203
2020-12-29,MO,Shannon,5,18,29203
2020-12-30,MO,Shannon,5,23,29203
2021-01-02,MO,Shannon,2,25,29203
2021-01-05,MO,Shannon,10,35,29203
2021-01-06,MO,Shannon,2,37,29203
2021-01-07,MO,Shannon,1,38,29203
2021-01-08,MO,Shannon,5,43,29203
2021-01-09,MO,Shannon,3,46,29203
2021-01-11,MO,Shannon,2,48,29203
2021-01-12,MO,Shannon,4,52,29203
2021-01-13,MO,Shannon,5,57,29203
2021-01-14,MO,Shannon,2,59,29203
2021-01-15,MO,Shannon,1,60,29203
2021-01-18,MO,Shannon,2,62,29203
2021-01-19,MO,Shannon,40,102,29203
2021-01-20,MO,Shannon,5,107,29203
2021-01-21,MO,Shannon,16,123,29203
2021-01-22,MO,Shannon,7,130,29203
2021-01-23,MO,Shannon,1,131,29203
2021-01-25,MO,Shannon,3,134,29203
2021-01-26,MO,Shannon,6,140,29203
2021-01-27,MO,Shannon,21,161,29203
2021-01-28,MO,Shannon,33,194,29203
2021-01-29,MO,Shannon,70,264,29203
2021-01-30,MO,Shannon,4,268,29203
2021-02-01,MO,Shannon,2,270,29203
2021-02-02,MO,Shannon,28,298,29203
2021-02-03,MO,Shannon,13,311,29203
2021-02-04,MO,Shannon,15,326,29203
2021-02-05,MO,Shannon,175,501,29203
2021-02-06,MO,Shannon,3,504,29203
2021-02-08,MO,Shannon,11,515,29203
2021-02-09,MO,Shannon,11,526,29203
2021-02-10,MO,Shannon,7,533,29203
2021-02-11,MO,Shannon,22,555,29203
2021-02-12,MO,Shannon,260,815,29203
2021-02-13,MO,Shannon,2,817,29203
2021-02-14,MO,Shannon,2,819,29203
2021-02-15,MO,Shannon,8,827,29203
2021-02-16,MO,Shannon,16,843,29203
2021-02-17,MO,Shannon,1,844,29203
2021-02-18,MO,Shannon,5,849,29203
2021-02-19,MO,Shannon,23,872,29203
2021-02-20,MO,Shannon,6,878,29203
2021-02-21,MO,Shannon,1,879,29203
2021-02-22,MO,Shannon,2,881,29203
2021-02-23,MO,Shannon,23,904,29203
2021-02-24,MO,Shannon,31,935,29203
2021-02-25,MO,Shannon,120,1055,29203
2021-02-26,MO,Shannon,47,1102,29203
2021-02-27,MO,Shannon,7,1109,29203
2021-02-28,MO,Shannon,7,1116,29203
2021-03-01,MO,Shannon,1,1117,29203
2021-03-02,MO,Shannon,29,1146,29203
2021-03-03,MO,Shannon,20,1166,29203
2021-03-04,MO,Shannon,44,1210,29203
2021-03-05,MO,Shannon,18,1228,29203
2021-03-06,MO,Shannon,1,1229,29203
2021-03-08,MO,Shannon,177,1406,29203
2021-03-09,MO,Shannon,24,1430,29203
2021-03-10,MO,Shannon,9,1439,29203
2021-03-11,MO,Shannon,6,1445,29203
2021-03-12,MO,Shannon,245,1690,29203
2021-03-13,MO,Shannon,1,1691,29203
2021-03-15,MO,Shannon,19,1710,29203
2021-03-16,MO,Shannon,18,1728,29203
2021-03-17,MO,Shannon,125,1853,29203
2021-03-18,MO,Shannon,5,1858,29203
2021-03-19,MO,Shannon,5,1863,29203
2021-03-20,MO,Shannon,7,1870,29203
2021-03-21,MO,Shannon,2,1872,29203
2021-03-22,MO,Shannon,3,1875,29203
2021-03-23,MO,Shannon,22,1897,29203
2021-03-24,MO,Shannon,3,1900,29203
2021-03-25,MO,Shannon,136,2036,29203
2021-03-26,MO,Shannon,9,2045,29203
2021-03-27,MO,Shannon,50,2095,29203
2021-03-29,MO,Shannon,1,2096,29203
2021-03-30,MO,Shannon,25,2121,29203
2021-03-31,MO,Shannon,10,2131,29203
2021-04-01,MO,Shannon,60,2191,29203
2021-04-02,MO,Shannon,4,2195,29203
2021-04-05,MO,Shannon,20,2215,29203
2021-04-06,MO,Shannon,31,2246,29203
2021-04-07,MO,Shannon,7,2253,29203
2021-04-08,MO,Shannon,11,2264,29203
2021-04-09,MO,Shannon,30,2294,29203
2021-04-10,MO,Shannon,2,2296,29203
2021-04-12,MO,Shannon,8,2304,29203
2021-04-13,MO,Shannon,10,2314,29203
2021-04-14,MO,Shannon,173,2487,29203
2021-04-15,MO,Shannon,34,2521,29203
2021-04-16,MO,Shannon,8,2529,29203
2021-04-17,MO,Shannon,1,2530,29203
2021-04-19,MO,Shannon,5,2535,29203
2021-04-20,MO,Shannon,7,2542,29203
2021-04-21,MO,Shannon,17,2559,29203
2021-04-22,MO,Shannon,8,2567,29203
2021-04-23,MO,Shannon,2,2569,29203
2021-04-24,MO,Shannon,82,2651,29203
2021-04-25,MO,Shannon,1,2652,29203
2021-04-26,MO,Shannon,4,2656,29203
2021-04-27,MO,Shannon,7,2663,29203
2021-04-28,MO,Shannon,9,2672,29203
2021-04-29,MO,Shannon,35,2707,29203
2021-04-30,MO,Shannon,20,2727,29203
2021-05-01,MO,Shannon,1,2728,29203
2021-05-03,MO,Shannon,1,2729,29203
2021-05-04,MO,Shannon,5,2734,29203
2021-05-05,MO,Shannon,4,2738,29203
2021-05-06,MO,Shannon,9,2747,29203
2021-05-07,MO,Shannon,3,2750,29203
2021-05-08,MO,Shannon,2,2752,29203
2021-05-09,MO,Shannon,2,2754,29203
2021-05-10,MO,Shannon,7,2761,29203
2021-05-11,MO,Shannon,6,2767,29203
2021-05-12,MO,Shannon,10,2777,29203
2021-05-13,MO,Shannon,72,2849,29203
2021-05-14,MO,Shannon,6,2855,29203
2021-05-15,MO,Shannon,2,2857,29203
2021-05-17,MO,Shannon,3,2860,29203
2021-05-18,MO,Shannon,3,2863,29203
2021-05-19,MO,Shannon,4,2867,29203
2021-05-20,MO,Shannon,8,2875,29203
2021-05-21,MO,Shannon,4,2879,29203
2021-05-22,MO,Shannon,3,2882,29203
2021-05-24,MO,Shannon,41,2923,29203
2021-05-25,MO,Shannon,6,2929,29203
2021-05-26,MO,Shannon,1,2930,29203
2021-05-27,MO,Shannon,17,2947,29203
2020-12-16,MO,Shelby,1,1,29205
2020-12-17,MO,Shelby,2,3,29205
2020-12-19,MO,Shelby,1,4,29205
2020-12-21,MO,Shelby,2,6,29205
2020-12-22,MO,Shelby,4,10,29205
2020-12-23,MO,Shelby,4,14,29205
2020-12-28,MO,Shelby,17,31,29205
2020-12-29,MO,Shelby,9,40,29205
2020-12-30,MO,Shelby,8,48,29205
2020-12-31,MO,Shelby,1,49,29205
2021-01-04,MO,Shelby,5,54,29205
2021-01-05,MO,Shelby,13,67,29205
2021-01-06,MO,Shelby,89,156,29205
2021-01-07,MO,Shelby,6,162,29205
2021-01-08,MO,Shelby,5,167,29205
2021-01-09,MO,Shelby,5,172,29205
2021-01-11,MO,Shelby,2,174,29205
2021-01-12,MO,Shelby,6,180,29205
2021-01-13,MO,Shelby,11,191,29205
2021-01-14,MO,Shelby,3,194,29205
2021-01-15,MO,Shelby,4,198,29205
2021-01-17,MO,Shelby,1,199,29205
2021-01-18,MO,Shelby,57,256,29205
2021-01-19,MO,Shelby,39,295,29205
2021-01-20,MO,Shelby,123,418,29205
2021-01-21,MO,Shelby,109,527,29205
2021-01-22,MO,Shelby,45,572,29205
2021-01-24,MO,Shelby,1,573,29205
2021-01-25,MO,Shelby,8,581,29205
2021-01-26,MO,Shelby,5,586,29205
2021-01-27,MO,Shelby,2,588,29205
2021-01-28,MO,Shelby,287,875,29205
2021-01-29,MO,Shelby,15,890,29205
2021-01-30,MO,Shelby,31,921,29205
2021-02-01,MO,Shelby,16,937,29205
2021-02-02,MO,Shelby,40,977,29205
2021-02-03,MO,Shelby,236,1213,29205
2021-02-04,MO,Shelby,21,1234,29205
2021-02-05,MO,Shelby,15,1249,29205
2021-02-06,MO,Shelby,5,1254,29205
2021-02-08,MO,Shelby,42,1296,29205
2021-02-09,MO,Shelby,65,1361,29205
2021-02-10,MO,Shelby,11,1372,29205
2021-02-11,MO,Shelby,67,1439,29205
2021-02-12,MO,Shelby,208,1647,29205
2021-02-15,MO,Shelby,17,1664,29205
2021-02-16,MO,Shelby,56,1720,29205
2021-02-17,MO,Shelby,3,1723,29205
2021-02-18,MO,Shelby,53,1776,29205
2021-02-19,MO,Shelby,15,1791,29205
2021-02-21,MO,Shelby,1,1792,29205
2021-02-22,MO,Shelby,13,1805,29205
2021-02-23,MO,Shelby,3,1808,29205
2021-02-24,MO,Shelby,13,1821,29205
2021-02-25,MO,Shelby,324,2145,29205
2021-02-26,MO,Shelby,13,2158,29205
2021-02-27,MO,Shelby,1,2159,29205
2021-03-01,MO,Shelby,13,2172,29205
2021-03-02,MO,Shelby,35,2207,29205
2021-03-03,MO,Shelby,157,2364,29205
2021-03-04,MO,Shelby,45,2409,29205
2021-03-05,MO,Shelby,24,2433,29205
2021-03-06,MO,Shelby,4,2437,29205
2021-03-08,MO,Shelby,47,2484,29205
2021-03-09,MO,Shelby,54,2538,29205
2021-03-10,MO,Shelby,7,2545,29205
2021-03-11,MO,Shelby,165,2710,29205
2021-03-12,MO,Shelby,6,2716,29205
2021-03-13,MO,Shelby,13,2729,29205
2021-03-14,MO,Shelby,1,2730,29205
2021-03-15,MO,Shelby,10,2740,29205
2021-03-16,MO,Shelby,27,2767,29205
2021-03-17,MO,Shelby,13,2780,29205
2021-03-18,MO,Shelby,40,2820,29205
2021-03-19,MO,Shelby,16,2836,29205
2021-03-20,MO,Shelby,17,2853,29205
2021-03-21,MO,Shelby,1,2854,29205
2021-03-22,MO,Shelby,10,2864,29205
2021-03-23,MO,Shelby,6,2870,29205
2021-03-24,MO,Shelby,20,2890,29205
2021-03-25,MO,Shelby,34,2924,29205
2021-03-26,MO,Shelby,19,2943,29205
2021-03-27,MO,Shelby,19,2962,29205
2021-03-29,MO,Shelby,15,2977,29205
2021-03-30,MO,Shelby,18,2995,29205
2021-03-31,MO,Shelby,14,3009,29205
2021-04-01,MO,Shelby,41,3050,29205
2021-04-02,MO,Shelby,22,3072,29205
2021-04-03,MO,Shelby,8,3080,29205
2021-04-04,MO,Shelby,1,3081,29205
2021-04-05,MO,Shelby,50,3131,29205
2021-04-06,MO,Shelby,43,3174,29205
2021-04-07,MO,Shelby,25,3199,29205
2021-04-08,MO,Shelby,85,3284,29205
2021-04-09,MO,Shelby,31,3315,29205
2021-04-10,MO,Shelby,14,3329,29205
2021-04-11,MO,Shelby,1,3330,29205
2021-04-12,MO,Shelby,4,3334,29205
2021-04-13,MO,Shelby,30,3364,29205
2021-04-14,MO,Shelby,62,3426,29205
2021-04-15,MO,Shelby,27,3453,29205
2021-04-16,MO,Shelby,14,3467,29205
2021-04-17,MO,Shelby,14,3481,29205
2021-04-19,MO,Shelby,4,3485,29205
2021-04-20,MO,Shelby,12,3497,29205
2021-04-21,MO,Shelby,12,3509,29205
2021-04-22,MO,Shelby,19,3528,29205
2021-04-23,MO,Shelby,18,3546,29205
2021-04-24,MO,Shelby,19,3565,29205
2021-04-26,MO,Shelby,12,3577,29205
2021-04-27,MO,Shelby,15,3592,29205
2021-04-28,MO,Shelby,10,3602,29205
2021-04-29,MO,Shelby,18,3620,29205
2021-04-30,MO,Shelby,14,3634,29205
2021-05-01,MO,Shelby,10,3644,29205
2021-05-03,MO,Shelby,2,3646,29205
2021-05-04,MO,Shelby,9,3655,29205
2021-05-05,MO,Shelby,45,3700,29205
2021-05-06,MO,Shelby,18,3718,29205
2021-05-07,MO,Shelby,8,3726,29205
2021-05-09,MO,Shelby,2,3728,29205
2021-05-10,MO,Shelby,1,3729,29205
2021-05-11,MO,Shelby,19,3748,29205
2021-05-12,MO,Shelby,9,3757,29205
2021-05-13,MO,Shelby,39,3796,29205
2021-05-14,MO,Shelby,9,3805,29205
2021-05-16,MO,Shelby,2,3807,29205
2021-05-17,MO,Shelby,3,3810,29205
2021-05-18,MO,Shelby,15,3825,29205
2021-05-19,MO,Shelby,11,3836,29205
2021-05-20,MO,Shelby,17,3853,29205
2021-05-21,MO,Shelby,3,3856,29205
2021-05-22,MO,Shelby,2,3858,29205
2021-05-23,MO,Shelby,1,3859,29205
2021-05-24,MO,Shelby,5,3864,29205
2021-05-25,MO,Shelby,7,3871,29205
2021-05-26,MO,Shelby,5,3876,29205
2021-05-27,MO,Shelby,5,3881,29205
2020-12-14,MO,St. Charles,13,13,29183
2020-12-15,MO,St. Charles,70,83,29183
2020-12-16,MO,St. Charles,124,207,29183
2020-12-17,MO,St. Charles,525,732,29183
2020-12-18,MO,St. Charles,632,1364,29183
2020-12-19,MO,St. Charles,206,1570,29183
2020-12-20,MO,St. Charles,71,1641,29183
2020-12-21,MO,St. Charles,419,2060,29183
2020-12-22,MO,St. Charles,727,2787,29183
2020-12-23,MO,St. Charles,509,3296,29183
2020-12-24,MO,St. Charles,100,3396,29183
2020-12-26,MO,St. Charles,199,3595,29183
2020-12-27,MO,St. Charles,105,3700,29183
2020-12-28,MO,St. Charles,612,4312,29183
2020-12-29,MO,St. Charles,646,4958,29183
2020-12-30,MO,St. Charles,623,5581,29183
2020-12-31,MO,St. Charles,309,5890,29183
2021-01-01,MO,St. Charles,30,5920,29183
2021-01-02,MO,St. Charles,98,6018,29183
2021-01-03,MO,St. Charles,83,6101,29183
2021-01-04,MO,St. Charles,430,6531,29183
2021-01-05,MO,St. Charles,492,7023,29183
2021-01-06,MO,St. Charles,798,7821,29183
2021-01-07,MO,St. Charles,661,8482,29183
2021-01-08,MO,St. Charles,912,9394,29183
2021-01-09,MO,St. Charles,318,9712,29183
2021-01-10,MO,St. Charles,173,9885,29183
2021-01-11,MO,St. Charles,858,10743,29183
2021-01-12,MO,St. Charles,917,11660,29183
2021-01-13,MO,St. Charles,617,12277,29183
2021-01-14,MO,St. Charles,564,12841,29183
2021-01-15,MO,St. Charles,853,13694,29183
2021-01-16,MO,St. Charles,339,14033,29183
2021-01-17,MO,St. Charles,57,14090,29183
2021-01-18,MO,St. Charles,845,14935,29183
2021-01-19,MO,St. Charles,1211,16146,29183
2021-01-20,MO,St. Charles,1907,18053,29183
2021-01-21,MO,St. Charles,1081,19134,29183
2021-01-22,MO,St. Charles,1062,20196,29183
2021-01-23,MO,St. Charles,577,20773,29183
2021-01-24,MO,St. Charles,225,20998,29183
2021-01-25,MO,St. Charles,1382,22380,29183
2021-01-26,MO,St. Charles,1242,23622,29183
2021-01-27,MO,St. Charles,1548,25170,29183
2021-01-28,MO,St. Charles,1505,26675,29183
2021-01-29,MO,St. Charles,1710,28385,29183
2021-01-30,MO,St. Charles,902,29287,29183
2021-01-31,MO,St. Charles,156,29443,29183
2021-02-01,MO,St. Charles,1090,30533,29183
2021-02-02,MO,St. Charles,1262,31795,29183
2021-02-03,MO,St. Charles,2035,33830,29183
2021-02-04,MO,St. Charles,1374,35204,29183
2021-02-05,MO,St. Charles,1798,37002,29183
2021-02-06,MO,St. Charles,770,37772,29183
2021-02-07,MO,St. Charles,63,37835,29183
2021-02-08,MO,St. Charles,1343,39178,29183
2021-02-09,MO,St. Charles,1904,41082,29183
2021-02-10,MO,St. Charles,1881,42963,29183
2021-02-11,MO,St. Charles,1425,44388,29183
2021-02-12,MO,St. Charles,1906,46294,29183
2021-02-13,MO,St. Charles,1072,47366,29183
2021-02-14,MO,St. Charles,87,47453,29183
2021-02-15,MO,St. Charles,437,47890,29183
2021-02-16,MO,St. Charles,1562,49452,29183
2021-02-17,MO,St. Charles,1691,51143,29183
2021-02-18,MO,St. Charles,2452,53595,29183
2021-02-19,MO,St. Charles,2348,55943,29183
2021-02-20,MO,St. Charles,1734,57677,29183
2021-02-21,MO,St. Charles,298,57975,29183
2021-02-22,MO,St. Charles,1957,59932,29183
2021-02-23,MO,St. Charles,2044,61976,29183
2021-02-24,MO,St. Charles,3588,65564,29183
2021-02-25,MO,St. Charles,3210,68774,29183
2021-02-26,MO,St. Charles,1951,70725,29183
2021-02-27,MO,St. Charles,2183,72908,29183
2021-02-28,MO,St. Charles,878,73786,29183
2021-03-01,MO,St. Charles,2084,75870,29183
2021-03-02,MO,St. Charles,3402,79272,29183
2021-03-03,MO,St. Charles,2576,81848,29183
2021-03-04,MO,St. Charles,2827,84675,29183
2021-03-05,MO,St. Charles,2357,87032,29183
2021-03-06,MO,St. Charles,1565,88597,29183
2021-03-07,MO,St. Charles,1038,89635,29183
2021-03-08,MO,St. Charles,2429,92064,29183
2021-03-09,MO,St. Charles,3090,95154,29183
2021-03-10,MO,St. Charles,3093,98247,29183
2021-03-11,MO,St. Charles,2763,101010,29183
2021-03-12,MO,St. Charles,2339,103349,29183
2021-03-13,MO,St. Charles,1921,105270,29183
2021-03-14,MO,St. Charles,377,105647,29183
2021-03-15,MO,St. Charles,2226,107873,29183
2021-03-16,MO,St. Charles,3598,111471,29183
2021-03-17,MO,St. Charles,2714,114185,29183
2021-03-18,MO,St. Charles,6288,120473,29183
2021-03-19,MO,St. Charles,2572,123045,29183
2021-03-20,MO,St. Charles,3450,126495,29183
2021-03-21,MO,St. Charles,1562,128057,29183
2021-03-22,MO,St. Charles,2901,130958,29183
2021-03-23,MO,St. Charles,4343,135301,29183
2021-03-24,MO,St. Charles,4013,139314,29183
2021-03-25,MO,St. Charles,5784,145098,29183
2021-03-26,MO,St. Charles,5716,150814,29183
2021-03-27,MO,St. Charles,4155,154969,29183
2021-03-28,MO,St. Charles,1277,156246,29183
2021-03-29,MO,St. Charles,2435,158681,29183
2021-03-30,MO,St. Charles,5487,164168,29183
2021-03-31,MO,St. Charles,6026,170194,29183
2021-04-01,MO,St. Charles,5307,175501,29183
2021-04-02,MO,St. Charles,3439,178940,29183
2021-04-03,MO,St. Charles,2097,181037,29183
2021-04-04,MO,St. Charles,382,181419,29183
2021-04-05,MO,St. Charles,2924,184343,29183
2021-04-06,MO,St. Charles,3766,188109,29183
2021-04-07,MO,St. Charles,4181,192290,29183
2021-04-08,MO,St. Charles,7708,199998,29183
2021-04-09,MO,St. Charles,5001,204999,29183
2021-04-10,MO,St. Charles,3826,208825,29183
2021-04-11,MO,St. Charles,1290,210115,29183
2021-04-12,MO,St. Charles,3418,213533,29183
2021-04-13,MO,St. Charles,3451,216984,29183
2021-04-14,MO,St. Charles,3526,220510,29183
2021-04-15,MO,St. Charles,6879,227389,29183
2021-04-16,MO,St. Charles,6308,233697,29183
2021-04-17,MO,St. Charles,4645,238342,29183
2021-04-18,MO,St. Charles,1116,239458,29183
2021-04-19,MO,St. Charles,3146,242604,29183
2021-04-20,MO,St. Charles,4671,247275,29183
2021-04-21,MO,St. Charles,4271,251546,29183
2021-04-22,MO,St. Charles,3135,254681,29183
2021-04-23,MO,St. Charles,2911,257592,29183
2021-04-24,MO,St. Charles,2169,259761,29183
2021-04-25,MO,St. Charles,744,260505,29183
2021-04-26,MO,St. Charles,2373,262878,29183
2021-04-27,MO,St. Charles,2437,265315,29183
2021-04-28,MO,St. Charles,3456,268771,29183
2021-04-29,MO,St. Charles,3628,272399,29183
2021-04-30,MO,St. Charles,2374,274773,29183
2021-05-01,MO,St. Charles,1763,276536,29183
2021-05-02,MO,St. Charles,897,277433,29183
2021-05-03,MO,St. Charles,2104,279537,29183
2021-05-04,MO,St. Charles,2158,281695,29183
2021-05-05,MO,St. Charles,2649,284344,29183
2021-05-06,MO,St. Charles,3057,287401,29183
2021-05-07,MO,St. Charles,2597,289998,29183
2021-05-08,MO,St. Charles,2901,292899,29183
2021-05-09,MO,St. Charles,480,293379,29183
2021-05-10,MO,St. Charles,1857,295236,29183
2021-05-11,MO,St. Charles,1761,296997,29183
2021-05-12,MO,St. Charles,1875,298872,29183
2021-05-13,MO,St. Charles,2227,301099,29183
2021-05-14,MO,St. Charles,2265,303364,29183
2021-05-15,MO,St. Charles,2286,305650,29183
2021-05-16,MO,St. Charles,1130,306780,29183
2021-05-17,MO,St. Charles,2026,308806,29183
2021-05-18,MO,St. Charles,1808,310614,29183
2021-05-19,MO,St. Charles,1950,312564,29183
2021-05-20,MO,St. Charles,1322,313886,29183
2021-05-21,MO,St. Charles,1256,315142,29183
2021-05-22,MO,St. Charles,1149,316291,29183
2021-05-23,MO,St. Charles,466,316757,29183
2021-05-24,MO,St. Charles,1129,317886,29183
2021-05-25,MO,St. Charles,1177,319063,29183
2021-05-26,MO,St. Charles,1007,320070,29183
2021-05-27,MO,St. Charles,332,320402,29183
2020-12-17,MO,St. Clair,1,1,29185
2020-12-18,MO,St. Clair,4,5,29185
2020-12-19,MO,St. Clair,3,8,29185
2020-12-21,MO,St. Clair,10,18,29185
2020-12-22,MO,St. Clair,7,25,29185
2020-12-23,MO,St. Clair,3,28,29185
2020-12-28,MO,St. Clair,7,35,29185
2020-12-29,MO,St. Clair,7,42,29185
2020-12-30,MO,St. Clair,13,55,29185
2020-12-31,MO,St. Clair,10,65,29185
2021-01-04,MO,St. Clair,32,97,29185
2021-01-05,MO,St. Clair,10,107,29185
2021-01-06,MO,St. Clair,13,120,29185
2021-01-07,MO,St. Clair,4,124,29185
2021-01-08,MO,St. Clair,12,136,29185
2021-01-09,MO,St. Clair,1,137,29185
2021-01-10,MO,St. Clair,1,138,29185
2021-01-11,MO,St. Clair,10,148,29185
2021-01-12,MO,St. Clair,10,158,29185
2021-01-13,MO,St. Clair,8,166,29185
2021-01-14,MO,St. Clair,8,174,29185
2021-01-15,MO,St. Clair,5,179,29185
2021-01-16,MO,St. Clair,2,181,29185
2021-01-19,MO,St. Clair,38,219,29185
2021-01-20,MO,St. Clair,10,229,29185
2021-01-21,MO,St. Clair,31,260,29185
2021-01-22,MO,St. Clair,18,278,29185
2021-01-23,MO,St. Clair,51,329,29185
2021-01-24,MO,St. Clair,1,330,29185
2021-01-25,MO,St. Clair,19,349,29185
2021-01-26,MO,St. Clair,31,380,29185
2021-01-27,MO,St. Clair,44,424,29185
2021-01-28,MO,St. Clair,136,560,29185
2021-01-29,MO,St. Clair,31,591,29185
2021-01-31,MO,St. Clair,1,592,29185
2021-02-01,MO,St. Clair,30,622,29185
2021-02-02,MO,St. Clair,23,645,29185
2021-02-03,MO,St. Clair,21,666,29185
2021-02-04,MO,St. Clair,16,682,29185
2021-02-05,MO,St. Clair,48,730,29185
2021-02-06,MO,St. Clair,3,733,29185
2021-02-07,MO,St. Clair,1,734,29185
2021-02-08,MO,St. Clair,44,778,29185
2021-02-09,MO,St. Clair,43,821,29185
2021-02-10,MO,St. Clair,32,853,29185
2021-02-11,MO,St. Clair,77,930,29185
2021-02-12,MO,St. Clair,19,949,29185
2021-02-13,MO,St. Clair,91,1040,29185
2021-02-14,MO,St. Clair,45,1085,29185
2021-02-15,MO,St. Clair,4,1089,29185
2021-02-16,MO,St. Clair,28,1117,29185
2021-02-17,MO,St. Clair,26,1143,29185
2021-02-18,MO,St. Clair,44,1187,29185
2021-02-19,MO,St. Clair,7,1194,29185
2021-02-20,MO,St. Clair,3,1197,29185
2021-02-21,MO,St. Clair,2,1199,29185
2021-02-22,MO,St. Clair,11,1210,29185
2021-02-23,MO,St. Clair,20,1230,29185
2021-02-24,MO,St. Clair,81,1311,29185
2021-02-25,MO,St. Clair,212,1523,29185
2021-02-26,MO,St. Clair,83,1606,29185
2021-02-27,MO,St. Clair,38,1644,29185
2021-02-28,MO,St. Clair,27,1671,29185
2021-03-01,MO,St. Clair,58,1729,29185
2021-03-02,MO,St. Clair,63,1792,29185
2021-03-03,MO,St. Clair,33,1825,29185
2021-03-04,MO,St. Clair,28,1853,29185
2021-03-05,MO,St. Clair,98,1951,29185
2021-03-06,MO,St. Clair,10,1961,29185
2021-03-07,MO,St. Clair,1,1962,29185
2021-03-08,MO,St. Clair,13,1975,29185
2021-03-09,MO,St. Clair,59,2034,29185
2021-03-10,MO,St. Clair,35,2069,29185
2021-03-11,MO,St. Clair,132,2201,29185
2021-03-12,MO,St. Clair,33,2234,29185
2021-03-13,MO,St. Clair,71,2305,29185
2021-03-14,MO,St. Clair,45,2350,29185
2021-03-15,MO,St. Clair,24,2374,29185
2021-03-16,MO,St. Clair,23,2397,29185
2021-03-17,MO,St. Clair,29,2426,29185
2021-03-18,MO,St. Clair,47,2473,29185
2021-03-19,MO,St. Clair,34,2507,29185
2021-03-20,MO,St. Clair,5,2512,29185
2021-03-21,MO,St. Clair,2,2514,29185
2021-03-22,MO,St. Clair,16,2530,29185
2021-03-23,MO,St. Clair,14,2544,29185
2021-03-24,MO,St. Clair,76,2620,29185
2021-03-25,MO,St. Clair,95,2715,29185
2021-03-26,MO,St. Clair,115,2830,29185
2021-03-27,MO,St. Clair,41,2871,29185
2021-03-28,MO,St. Clair,27,2898,29185
2021-03-29,MO,St. Clair,37,2935,29185
2021-03-30,MO,St. Clair,80,3015,29185
2021-03-31,MO,St. Clair,25,3040,29185
2021-04-01,MO,St. Clair,38,3078,29185
2021-04-02,MO,St. Clair,52,3130,29185
2021-04-03,MO,St. Clair,11,3141,29185
2021-04-05,MO,St. Clair,18,3159,29185
2021-04-06,MO,St. Clair,40,3199,29185
2021-04-07,MO,St. Clair,19,3218,29185
2021-04-08,MO,St. Clair,77,3295,29185
2021-04-09,MO,St. Clair,29,3324,29185
2021-04-10,MO,St. Clair,34,3358,29185
2021-04-11,MO,St. Clair,2,3360,29185
2021-04-12,MO,St. Clair,24,3384,29185
2021-04-13,MO,St. Clair,23,3407,29185
2021-04-14,MO,St. Clair,26,3433,29185
2021-04-15,MO,St. Clair,41,3474,29185
2021-04-16,MO,St. Clair,38,3512,29185
2021-04-17,MO,St. Clair,7,3519,29185
2021-04-18,MO,St. Clair,1,3520,29185
2021-04-19,MO,St. Clair,13,3533,29185
2021-04-20,MO,St. Clair,17,3550,29185
2021-04-21,MO,St. Clair,14,3564,29185
2021-04-22,MO,St. Clair,17,3581,29185
2021-04-23,MO,St. Clair,38,3619,29185
2021-04-24,MO,St. Clair,4,3623,29185
2021-04-25,MO,St. Clair,4,3627,29185
2021-04-26,MO,St. Clair,8,3635,29185
2021-04-27,MO,St. Clair,33,3668,29185
2021-04-28,MO,St. Clair,6,3674,29185
2021-04-29,MO,St. Clair,11,3685,29185
2021-04-30,MO,St. Clair,14,3699,29185
2021-05-01,MO,St. Clair,1,3700,29185
2021-05-02,MO,St. Clair,4,3704,29185
2021-05-03,MO,St. Clair,18,3722,29185
2021-05-04,MO,St. Clair,16,3738,29185
2021-05-05,MO,St. Clair,11,3749,29185
2021-05-06,MO,St. Clair,8,3757,29185
2021-05-07,MO,St. Clair,16,3773,29185
2021-05-08,MO,St. Clair,2,3775,29185
2021-05-09,MO,St. Clair,1,3776,29185
2021-05-10,MO,St. Clair,11,3787,29185
2021-05-11,MO,St. Clair,10,3797,29185
2021-05-12,MO,St. Clair,10,3807,29185
2021-05-13,MO,St. Clair,15,3822,29185
2021-05-14,MO,St. Clair,22,3844,29185
2021-05-15,MO,St. Clair,8,3852,29185
2021-05-16,MO,St. Clair,4,3856,29185
2021-05-17,MO,St. Clair,7,3863,29185
2021-05-18,MO,St. Clair,17,3880,29185
2021-05-19,MO,St. Clair,12,3892,29185
2021-05-20,MO,St. Clair,18,3910,29185
2021-05-21,MO,St. Clair,15,3925,29185
2021-05-22,MO,St. Clair,3,3928,29185
2021-05-23,MO,St. Clair,3,3931,29185
2021-05-24,MO,St. Clair,3,3934,29185
2021-05-25,MO,St. Clair,8,3942,29185
2021-05-26,MO,St. Clair,8,3950,29185
2021-05-27,MO,St. Clair,10,3960,29185
2020-12-14,MO,St. Francois,3,3,29187
2020-12-16,MO,St. Francois,10,13,29187
2020-12-17,MO,St. Francois,74,87,29187
2020-12-18,MO,St. Francois,67,154,29187
2020-12-19,MO,St. Francois,17,171,29187
2020-12-20,MO,St. Francois,5,176,29187
2020-12-21,MO,St. Francois,61,237,29187
2020-12-22,MO,St. Francois,72,309,29187
2020-12-23,MO,St. Francois,143,452,29187
2020-12-24,MO,St. Francois,2,454,29187
2020-12-26,MO,St. Francois,1,455,29187
2020-12-27,MO,St. Francois,3,458,29187
2020-12-28,MO,St. Francois,36,494,29187
2020-12-29,MO,St. Francois,290,784,29187
2020-12-30,MO,St. Francois,233,1017,29187
2020-12-31,MO,St. Francois,90,1107,29187
2021-01-01,MO,St. Francois,1,1108,29187
2021-01-02,MO,St. Francois,40,1148,29187
2021-01-03,MO,St. Francois,6,1154,29187
2021-01-04,MO,St. Francois,73,1227,29187
2021-01-05,MO,St. Francois,107,1334,29187
2021-01-06,MO,St. Francois,62,1396,29187
2021-01-07,MO,St. Francois,97,1493,29187
2021-01-08,MO,St. Francois,133,1626,29187
2021-01-09,MO,St. Francois,192,1818,29187
2021-01-10,MO,St. Francois,4,1822,29187
2021-01-11,MO,St. Francois,92,1914,29187
2021-01-12,MO,St. Francois,89,2003,29187
2021-01-13,MO,St. Francois,156,2159,29187
2021-01-14,MO,St. Francois,118,2277,29187
2021-01-15,MO,St. Francois,111,2388,29187
2021-01-16,MO,St. Francois,5,2393,29187
2021-01-17,MO,St. Francois,31,2424,29187
2021-01-18,MO,St. Francois,56,2480,29187
2021-01-19,MO,St. Francois,395,2875,29187
2021-01-20,MO,St. Francois,254,3129,29187
2021-01-21,MO,St. Francois,159,3288,29187
2021-01-22,MO,St. Francois,252,3540,29187
2021-01-23,MO,St. Francois,61,3601,29187
2021-01-24,MO,St. Francois,15,3616,29187
2021-01-25,MO,St. Francois,206,3822,29187
2021-01-26,MO,St. Francois,138,3960,29187
2021-01-27,MO,St. Francois,172,4132,29187
2021-01-28,MO,St. Francois,539,4671,29187
2021-01-29,MO,St. Francois,457,5128,29187
2021-01-30,MO,St. Francois,121,5249,29187
2021-02-01,MO,St. Francois,283,5532,29187
2021-02-02,MO,St. Francois,231,5763,29187
2021-02-03,MO,St. Francois,218,5981,29187
2021-02-04,MO,St. Francois,1656,7637,29187
2021-02-05,MO,St. Francois,265,7902,29187
2021-02-06,MO,St. Francois,235,8137,29187
2021-02-07,MO,St. Francois,9,8146,29187
2021-02-08,MO,St. Francois,246,8392,29187
2021-02-09,MO,St. Francois,171,8563,29187
2021-02-10,MO,St. Francois,136,8699,29187
2021-02-11,MO,St. Francois,277,8976,29187
2021-02-12,MO,St. Francois,337,9313,29187
2021-02-13,MO,St. Francois,118,9431,29187
2021-02-14,MO,St. Francois,51,9482,29187
2021-02-15,MO,St. Francois,66,9548,29187
2021-02-16,MO,St. Francois,91,9639,29187
2021-02-17,MO,St. Francois,108,9747,29187
2021-02-18,MO,St. Francois,242,9989,29187
2021-02-19,MO,St. Francois,375,10364,29187
2021-02-20,MO,St. Francois,97,10461,29187
2021-02-21,MO,St. Francois,5,10466,29187
2021-02-22,MO,St. Francois,264,10730,29187
2021-02-23,MO,St. Francois,208,10938,29187
2021-02-24,MO,St. Francois,373,11311,29187
2021-02-25,MO,St. Francois,494,11805,29187
2021-02-26,MO,St. Francois,2074,13879,29187
2021-02-27,MO,St. Francois,126,14005,29187
2021-02-28,MO,St. Francois,62,14067,29187
2021-03-01,MO,St. Francois,494,14561,29187
2021-03-02,MO,St. Francois,395,14956,29187
2021-03-03,MO,St. Francois,340,15296,29187
2021-03-04,MO,St. Francois,500,15796,29187
2021-03-05,MO,St. Francois,441,16237,29187
2021-03-06,MO,St. Francois,88,16325,29187
2021-03-07,MO,St. Francois,11,16336,29187
2021-03-08,MO,St. Francois,241,16577,29187
2021-03-09,MO,St. Francois,229,16806,29187
2021-03-10,MO,St. Francois,343,17149,29187
2021-03-11,MO,St. Francois,297,17446,29187
2021-03-12,MO,St. Francois,431,17877,29187
2021-03-13,MO,St. Francois,133,18010,29187
2021-03-14,MO,St. Francois,17,18027,29187
2021-03-15,MO,St. Francois,248,18275,29187
2021-03-16,MO,St. Francois,465,18740,29187
2021-03-17,MO,St. Francois,377,19117,29187
2021-03-18,MO,St. Francois,601,19718,29187
2021-03-19,MO,St. Francois,267,19985,29187
2021-03-20,MO,St. Francois,114,20099,29187
2021-03-21,MO,St. Francois,19,20118,29187
2021-03-22,MO,St. Francois,294,20412,29187
2021-03-23,MO,St. Francois,248,20660,29187
2021-03-24,MO,St. Francois,289,20949,29187
2021-03-25,MO,St. Francois,310,21259,29187
2021-03-26,MO,St. Francois,391,21650,29187
2021-03-27,MO,St. Francois,299,21949,29187
2021-03-28,MO,St. Francois,15,21964,29187
2021-03-29,MO,St. Francois,577,22541,29187
2021-03-30,MO,St. Francois,559,23100,29187
2021-03-31,MO,St. Francois,526,23626,29187
2021-04-01,MO,St. Francois,289,23915,29187
2021-04-02,MO,St. Francois,222,24137,29187
2021-04-03,MO,St. Francois,56,24193,29187
2021-04-04,MO,St. Francois,15,24208,29187
2021-04-05,MO,St. Francois,228,24436,29187
2021-04-06,MO,St. Francois,407,24843,29187
2021-04-07,MO,St. Francois,739,25582,29187
2021-04-08,MO,St. Francois,521,26103,29187
2021-04-09,MO,St. Francois,472,26575,29187
2021-04-10,MO,St. Francois,360,26935,29187
2021-04-11,MO,St. Francois,41,26976,29187
2021-04-12,MO,St. Francois,294,27270,29187
2021-04-13,MO,St. Francois,290,27560,29187
2021-04-14,MO,St. Francois,307,27867,29187
2021-04-15,MO,St. Francois,247,28114,29187
2021-04-16,MO,St. Francois,389,28503,29187
2021-04-17,MO,St. Francois,293,28796,29187
2021-04-18,MO,St. Francois,41,28837,29187
2021-04-19,MO,St. Francois,687,29524,29187
2021-04-20,MO,St. Francois,166,29690,29187
2021-04-21,MO,St. Francois,325,30015,29187
2021-04-22,MO,St. Francois,296,30311,29187
2021-04-23,MO,St. Francois,314,30625,29187
2021-04-24,MO,St. Francois,69,30694,29187
2021-04-25,MO,St. Francois,17,30711,29187
2021-04-26,MO,St. Francois,133,30844,29187
2021-04-27,MO,St. Francois,134,30978,29187
2021-04-28,MO,St. Francois,525,31503,29187
2021-04-29,MO,St. Francois,442,31945,29187
2021-04-30,MO,St. Francois,196,32141,29187
2021-05-01,MO,St. Francois,56,32197,29187
2021-05-02,MO,St. Francois,36,32233,29187
2021-05-03,MO,St. Francois,176,32409,29187
2021-05-04,MO,St. Francois,168,32577,29187
2021-05-05,MO,St. Francois,159,32736,29187
2021-05-06,MO,St. Francois,365,33101,29187
2021-05-07,MO,St. Francois,145,33246,29187
2021-05-08,MO,St. Francois,77,33323,29187
2021-05-09,MO,St. Francois,26,33349,29187
2021-05-10,MO,St. Francois,95,33444,29187
2021-05-11,MO,St. Francois,210,33654,29187
2021-05-12,MO,St. Francois,106,33760,29187
2021-05-13,MO,St. Francois,231,33991,29187
2021-05-14,MO,St. Francois,159,34150,29187
2021-05-15,MO,St. Francois,88,34238,29187
2021-05-16,MO,St. Francois,79,34317,29187
2021-05-17,MO,St. Francois,115,34432,29187
2021-05-18,MO,St. Francois,99,34531,29187
2021-05-19,MO,St. Francois,661,35192,29187
2021-05-20,MO,St. Francois,125,35317,29187
2021-05-21,MO,St. Francois,120,35437,29187
2021-05-22,MO,St. Francois,32,35469,29187
2021-05-23,MO,St. Francois,29,35498,29187
2021-05-24,MO,St. Francois,97,35595,29187
2021-05-25,MO,St. Francois,123,35718,29187
2021-05-26,MO,St. Francois,125,35843,29187
2021-05-27,MO,St. Francois,52,35895,29187
2020-12-14,MO,St. Louis,90,90,29189
2020-12-15,MO,St. Louis,330,420,29189
2020-12-16,MO,St. Louis,544,964,29189
2020-12-17,MO,St. Louis,1679,2643,29189
2020-12-18,MO,St. Louis,1571,4214,29189
2020-12-19,MO,St. Louis,574,4788,29189
2020-12-20,MO,St. Louis,165,4953,29189
2020-12-21,MO,St. Louis,1075,6028,29189
2020-12-22,MO,St. Louis,1682,7710,29189
2020-12-23,MO,St. Louis,1558,9268,29189
2020-12-24,MO,St. Louis,323,9591,29189
2020-12-26,MO,St. Louis,627,10218,29189
2020-12-27,MO,St. Louis,355,10573,29189
2020-12-28,MO,St. Louis,1726,12299,29189
2020-12-29,MO,St. Louis,2118,14417,29189
2020-12-30,MO,St. Louis,2059,16476,29189
2020-12-31,MO,St. Louis,707,17183,29189
2021-01-01,MO,St. Louis,95,17278,29189
2021-01-02,MO,St. Louis,241,17519,29189
2021-01-03,MO,St. Louis,69,17588,29189
2021-01-04,MO,St. Louis,1418,19006,29189
2021-01-05,MO,St. Louis,2026,21032,29189
2021-01-06,MO,St. Louis,2344,23376,29189
2021-01-07,MO,St. Louis,2298,25674,29189
2021-01-08,MO,St. Louis,2512,28186,29189
2021-01-09,MO,St. Louis,922,29108,29189
2021-01-10,MO,St. Louis,459,29567,29189
2021-01-11,MO,St. Louis,2563,32130,29189
2021-01-12,MO,St. Louis,2351,34481,29189
2021-01-13,MO,St. Louis,2568,37049,29189
2021-01-14,MO,St. Louis,2623,39672,29189
2021-01-15,MO,St. Louis,2506,42178,29189
2021-01-16,MO,St. Louis,832,43010,29189
2021-01-17,MO,St. Louis,185,43195,29189
2021-01-18,MO,St. Louis,2862,46057,29189
2021-01-19,MO,St. Louis,3249,49306,29189
2021-01-20,MO,St. Louis,3371,52677,29189
2021-01-21,MO,St. Louis,4288,56965,29189
2021-01-22,MO,St. Louis,3565,60530,29189
2021-01-23,MO,St. Louis,1977,62507,29189
2021-01-24,MO,St. Louis,1086,63593,29189
2021-01-25,MO,St. Louis,3586,67179,29189
2021-01-26,MO,St. Louis,4816,71995,29189
2021-01-27,MO,St. Louis,4565,76560,29189
2021-01-28,MO,St. Louis,4541,81101,29189
2021-01-29,MO,St. Louis,6129,87230,29189
2021-01-30,MO,St. Louis,2240,89470,29189
2021-01-31,MO,St. Louis,271,89741,29189
2021-02-01,MO,St. Louis,3809,93550,29189
2021-02-02,MO,St. Louis,4428,97978,29189
2021-02-03,MO,St. Louis,4783,102761,29189
2021-02-04,MO,St. Louis,4355,107116,29189
2021-02-05,MO,St. Louis,5478,112594,29189
2021-02-06,MO,St. Louis,1475,114069,29189
2021-02-07,MO,St. Louis,423,114492,29189
2021-02-08,MO,St. Louis,3997,118489,29189
2021-02-09,MO,St. Louis,4104,122593,29189
2021-02-10,MO,St. Louis,4359,126952,29189
2021-02-11,MO,St. Louis,6103,133055,29189
2021-02-12,MO,St. Louis,5818,138873,29189
2021-02-13,MO,St. Louis,3437,142310,29189
2021-02-14,MO,St. Louis,561,142871,29189
2021-02-15,MO,St. Louis,2413,145284,29189
2021-02-16,MO,St. Louis,4908,150192,29189
2021-02-17,MO,St. Louis,5467,155659,29189
2021-02-18,MO,St. Louis,7415,163074,29189
2021-02-19,MO,St. Louis,7148,170222,29189
2021-02-20,MO,St. Louis,5340,175562,29189
2021-02-21,MO,St. Louis,534,176096,29189
2021-02-22,MO,St. Louis,5843,181939,29189
2021-02-23,MO,St. Louis,6291,188230,29189
2021-02-24,MO,St. Louis,6811,195041,29189
2021-02-25,MO,St. Louis,6767,201808,29189
2021-02-26,MO,St. Louis,7238,209046,29189
2021-02-27,MO,St. Louis,5540,214586,29189
2021-02-28,MO,St. Louis,1591,216177,29189
2021-03-01,MO,St. Louis,6982,223159,29189
2021-03-02,MO,St. Louis,7389,230548,29189
2021-03-03,MO,St. Louis,6228,236776,29189
2021-03-04,MO,St. Louis,6813,243589,29189
2021-03-05,MO,St. Louis,7681,251270,29189
2021-03-06,MO,St. Louis,5915,257185,29189
2021-03-07,MO,St. Louis,2222,259407,29189
2021-03-08,MO,St. Louis,6223,265630,29189
2021-03-09,MO,St. Louis,7202,272832,29189
2021-03-10,MO,St. Louis,8097,280929,29189
2021-03-11,MO,St. Louis,7799,288728,29189
2021-03-12,MO,St. Louis,7736,296464,29189
2021-03-13,MO,St. Louis,6556,303020,29189
2021-03-14,MO,St. Louis,1219,304239,29189
2021-03-15,MO,St. Louis,6741,310980,29189
2021-03-16,MO,St. Louis,8861,319841,29189
2021-03-17,MO,St. Louis,8423,328264,29189
2021-03-18,MO,St. Louis,9494,337758,29189
2021-03-19,MO,St. Louis,9460,347218,29189
2021-03-20,MO,St. Louis,7170,354388,29189
2021-03-21,MO,St. Louis,3136,357524,29189
2021-03-22,MO,St. Louis,8059,365583,29189
2021-03-23,MO,St. Louis,9475,375058,29189
2021-03-24,MO,St. Louis,9178,384236,29189
2021-03-25,MO,St. Louis,11272,395508,29189
2021-03-26,MO,St. Louis,10388,405896,29189
2021-03-27,MO,St. Louis,8914,414810,29189
2021-03-28,MO,St. Louis,3336,418146,29189
2021-03-29,MO,St. Louis,8060,426206,29189
2021-03-30,MO,St. Louis,10148,436354,29189
2021-03-31,MO,St. Louis,10150,446504,29189
2021-04-01,MO,St. Louis,11353,457857,29189
2021-04-02,MO,St. Louis,10563,468420,29189
2021-04-03,MO,St. Louis,8109,476529,29189
2021-04-04,MO,St. Louis,887,477416,29189
2021-04-05,MO,St. Louis,9816,487232,29189
2021-04-06,MO,St. Louis,12245,499477,29189
2021-04-07,MO,St. Louis,12746,512223,29189
2021-04-08,MO,St. Louis,12443,524666,29189
2021-04-09,MO,St. Louis,11515,536181,29189
2021-04-10,MO,St. Louis,8356,544537,29189
2021-04-11,MO,St. Louis,2813,547350,29189
2021-04-12,MO,St. Louis,9216,556566,29189
2021-04-13,MO,St. Louis,9106,565672,29189
2021-04-14,MO,St. Louis,10101,575773,29189
2021-04-15,MO,St. Louis,10408,586181,29189
2021-04-16,MO,St. Louis,10074,596255,29189
2021-04-17,MO,St. Louis,7668,603923,29189
2021-04-18,MO,St. Louis,2610,606533,29189
2021-04-19,MO,St. Louis,7330,613863,29189
2021-04-20,MO,St. Louis,8582,622445,29189
2021-04-21,MO,St. Louis,7776,630221,29189
2021-04-22,MO,St. Louis,8508,638729,29189
2021-04-23,MO,St. Louis,7565,646294,29189
2021-04-24,MO,St. Louis,5794,652088,29189
2021-04-25,MO,St. Louis,1656,653744,29189
2021-04-26,MO,St. Louis,5492,659236,29189
2021-04-27,MO,St. Louis,6824,666060,29189
2021-04-28,MO,St. Louis,7109,673169,29189
2021-04-29,MO,St. Louis,6927,680096,29189
2021-04-30,MO,St. Louis,5611,685707,29189
2021-05-01,MO,St. Louis,4630,690337,29189
2021-05-02,MO,St. Louis,2026,692363,29189
2021-05-03,MO,St. Louis,5604,697967,29189
2021-05-04,MO,St. Louis,5453,703420,29189
2021-05-05,MO,St. Louis,6291,709711,29189
2021-05-06,MO,St. Louis,5254,714965,29189
2021-05-07,MO,St. Louis,5869,720834,29189
2021-05-08,MO,St. Louis,4564,725398,29189
2021-05-09,MO,St. Louis,1016,726414,29189
2021-05-10,MO,St. Louis,4131,730545,29189
2021-05-11,MO,St. Louis,4270,734815,29189
2021-05-12,MO,St. Louis,3825,738640,29189
2021-05-13,MO,St. Louis,4790,743430,29189
2021-05-14,MO,St. Louis,5857,749287,29189
2021-05-15,MO,St. Louis,5898,755185,29189
2021-05-16,MO,St. Louis,2333,757518,29189
2021-05-17,MO,St. Louis,5562,763080,29189
2021-05-18,MO,St. Louis,4083,767163,29189
2021-05-19,MO,St. Louis,4971,772134,29189
2021-05-20,MO,St. Louis,2698,774832,29189
2021-05-21,MO,St. Louis,2776,777608,29189
2021-05-22,MO,St. Louis,3606,781214,29189
2021-05-23,MO,St. Louis,930,782144,29189
2021-05-24,MO,St. Louis,2308,784452,29189
2021-05-25,MO,St. Louis,2426,786878,29189
2021-05-26,MO,St. Louis,2486,789364,29189
2021-05-27,MO,St. Louis,870,790234,29189
2020-12-14,MO,St. Louis City,27,27,29510
2020-12-15,MO,St. Louis City,76,103,29510
2020-12-16,MO,St. Louis City,122,225,29510
2020-12-17,MO,St. Louis City,520,745,29510
2020-12-18,MO,St. Louis City,396,1141,29510
2020-12-19,MO,St. Louis City,120,1261,29510
2020-12-20,MO,St. Louis City,41,1302,29510
2020-12-21,MO,St. Louis City,320,1622,29510
2020-12-22,MO,St. Louis City,514,2136,29510
2020-12-23,MO,St. Louis City,489,2625,29510
2020-12-24,MO,St. Louis City,99,2724,29510
2020-12-26,MO,St. Louis City,430,3154,29510
2020-12-27,MO,St. Louis City,371,3525,29510
2020-12-28,MO,St. Louis City,497,4022,29510
2020-12-29,MO,St. Louis City,672,4694,29510
2020-12-30,MO,St. Louis City,659,5353,29510
2020-12-31,MO,St. Louis City,151,5504,29510
2021-01-01,MO,St. Louis City,21,5525,29510
2021-01-02,MO,St. Louis City,71,5596,29510
2021-01-03,MO,St. Louis City,48,5644,29510
2021-01-04,MO,St. Louis City,583,6227,29510
2021-01-05,MO,St. Louis City,617,6844,29510
2021-01-06,MO,St. Louis City,598,7442,29510
2021-01-07,MO,St. Louis City,593,8035,29510
2021-01-08,MO,St. Louis City,760,8795,29510
2021-01-09,MO,St. Louis City,405,9200,29510
2021-01-10,MO,St. Louis City,101,9301,29510
2021-01-11,MO,St. Louis City,771,10072,29510
2021-01-12,MO,St. Louis City,681,10753,29510
2021-01-13,MO,St. Louis City,825,11578,29510
2021-01-14,MO,St. Louis City,978,12556,29510
2021-01-15,MO,St. Louis City,805,13361,29510
2021-01-16,MO,St. Louis City,359,13720,29510
2021-01-17,MO,St. Louis City,30,13750,29510
2021-01-18,MO,St. Louis City,776,14526,29510
2021-01-19,MO,St. Louis City,967,15493,29510
2021-01-20,MO,St. Louis City,897,16390,29510
2021-01-21,MO,St. Louis City,706,17096,29510
2021-01-22,MO,St. Louis City,1033,18129,29510
2021-01-23,MO,St. Louis City,480,18609,29510
2021-01-24,MO,St. Louis City,215,18824,29510
2021-01-25,MO,St. Louis City,972,19796,29510
2021-01-26,MO,St. Louis City,1088,20884,29510
2021-01-27,MO,St. Louis City,961,21845,29510
2021-01-28,MO,St. Louis City,1352,23197,29510
2021-01-29,MO,St. Louis City,2115,25312,29510
2021-01-30,MO,St. Louis City,1266,26578,29510
2021-01-31,MO,St. Louis City,68,26646,29510
2021-02-01,MO,St. Louis City,932,27578,29510
2021-02-02,MO,St. Louis City,876,28454,29510
2021-02-03,MO,St. Louis City,823,29277,29510
2021-02-04,MO,St. Louis City,794,30071,29510
2021-02-05,MO,St. Louis City,1035,31106,29510
2021-02-06,MO,St. Louis City,252,31358,29510
2021-02-07,MO,St. Louis City,27,31385,29510
2021-02-08,MO,St. Louis City,748,32133,29510
2021-02-09,MO,St. Louis City,767,32900,29510
2021-02-10,MO,St. Louis City,813,33713,29510
2021-02-11,MO,St. Louis City,1232,34945,29510
2021-02-12,MO,St. Louis City,1297,36242,29510
2021-02-13,MO,St. Louis City,426,36668,29510
2021-02-14,MO,St. Louis City,69,36737,29510
2021-02-15,MO,St. Louis City,354,37091,29510
2021-02-16,MO,St. Louis City,700,37791,29510
2021-02-17,MO,St. Louis City,1012,38803,29510
2021-02-18,MO,St. Louis City,1683,40486,29510
2021-02-19,MO,St. Louis City,2146,42632,29510
2021-02-20,MO,St. Louis City,1871,44503,29510
2021-02-21,MO,St. Louis City,279,44782,29510
2021-02-22,MO,St. Louis City,1104,45886,29510
2021-02-23,MO,St. Louis City,1195,47081,29510
2021-02-24,MO,St. Louis City,1670,48751,29510
2021-02-25,MO,St. Louis City,1205,49956,29510
2021-02-26,MO,St. Louis City,1276,51232,29510
2021-02-27,MO,St. Louis City,1524,52756,29510
2021-02-28,MO,St. Louis City,166,52922,29510
2021-03-01,MO,St. Louis City,1309,54231,29510
2021-03-02,MO,St. Louis City,1326,55557,29510
2021-03-03,MO,St. Louis City,1147,56704,29510
2021-03-04,MO,St. Louis City,1113,57817,29510
2021-03-05,MO,St. Louis City,1416,59233,29510
2021-03-06,MO,St. Louis City,1411,60644,29510
2021-03-07,MO,St. Louis City,246,60890,29510
2021-03-08,MO,St. Louis City,1018,61908,29510
2021-03-09,MO,St. Louis City,1280,63188,29510
2021-03-10,MO,St. Louis City,1486,64674,29510
2021-03-11,MO,St. Louis City,1453,66127,29510
2021-03-12,MO,St. Louis City,1308,67435,29510
2021-03-13,MO,St. Louis City,904,68339,29510
2021-03-14,MO,St. Louis City,409,68748,29510
2021-03-15,MO,St. Louis City,1391,70139,29510
2021-03-16,MO,St. Louis City,1650,71789,29510
2021-03-17,MO,St. Louis City,2066,73855,29510
2021-03-18,MO,St. Louis City,1689,75544,29510
2021-03-19,MO,St. Louis City,1885,77429,29510
2021-03-20,MO,St. Louis City,2037,79466,29510
2021-03-21,MO,St. Louis City,1206,80672,29510
2021-03-22,MO,St. Louis City,1761,82433,29510
2021-03-23,MO,St. Louis City,1900,84333,29510
2021-03-24,MO,St. Louis City,1813,86146,29510
2021-03-25,MO,St. Louis City,4343,90489,29510
2021-03-26,MO,St. Louis City,4146,94635,29510
2021-03-27,MO,St. Louis City,2122,96757,29510
2021-03-28,MO,St. Louis City,524,97281,29510
2021-03-29,MO,St. Louis City,1607,98888,29510
2021-03-30,MO,St. Louis City,1947,100835,29510
2021-03-31,MO,St. Louis City,2291,103126,29510
2021-04-01,MO,St. Louis City,2016,105142,29510
2021-04-02,MO,St. Louis City,1871,107013,29510
2021-04-03,MO,St. Louis City,2608,109621,29510
2021-04-04,MO,St. Louis City,196,109817,29510
2021-04-05,MO,St. Louis City,1967,111784,29510
2021-04-06,MO,St. Louis City,2473,114257,29510
2021-04-07,MO,St. Louis City,2681,116938,29510
2021-04-08,MO,St. Louis City,2486,119424,29510
2021-04-09,MO,St. Louis City,2555,121979,29510
2021-04-10,MO,St. Louis City,2173,124152,29510
2021-04-11,MO,St. Louis City,570,124722,29510
2021-04-12,MO,St. Louis City,2203,126925,29510
2021-04-13,MO,St. Louis City,2133,129058,29510
2021-04-14,MO,St. Louis City,2483,131541,29510
2021-04-15,MO,St. Louis City,2146,133687,29510
2021-04-16,MO,St. Louis City,2176,135863,29510
2021-04-17,MO,St. Louis City,2017,137880,29510
2021-04-18,MO,St. Louis City,1088,138968,29510
2021-04-19,MO,St. Louis City,1760,140728,29510
2021-04-20,MO,St. Louis City,1835,142563,29510
2021-04-21,MO,St. Louis City,2081,144644,29510
2021-04-22,MO,St. Louis City,1779,146423,29510
2021-04-23,MO,St. Louis City,1713,148136,29510
2021-04-24,MO,St. Louis City,1591,149727,29510
2021-04-25,MO,St. Louis City,379,150106,29510
2021-04-26,MO,St. Louis City,1289,151395,29510
2021-04-27,MO,St. Louis City,1520,152915,29510
2021-04-28,MO,St. Louis City,1591,154506,29510
2021-04-29,MO,St. Louis City,1687,156193,29510
2021-04-30,MO,St. Louis City,1268,157461,29510
2021-05-01,MO,St. Louis City,984,158445,29510
2021-05-02,MO,St. Louis City,492,158937,29510
2021-05-03,MO,St. Louis City,1489,160426,29510
2021-05-04,MO,St. Louis City,1357,161783,29510
2021-05-05,MO,St. Louis City,1697,163480,29510
2021-05-06,MO,St. Louis City,1318,164798,29510
2021-05-07,MO,St. Louis City,1545,166343,29510
2021-05-08,MO,St. Louis City,932,167275,29510
2021-05-09,MO,St. Louis City,291,167566,29510
2021-05-10,MO,St. Louis City,1044,168610,29510
2021-05-11,MO,St. Louis City,1050,169660,29510
2021-05-12,MO,St. Louis City,1036,170696,29510
2021-05-13,MO,St. Louis City,1179,171875,29510
2021-05-14,MO,St. Louis City,1483,173358,29510
2021-05-15,MO,St. Louis City,1112,174470,29510
2021-05-16,MO,St. Louis City,479,174949,29510
2021-05-17,MO,St. Louis City,1150,176099,29510
2021-05-18,MO,St. Louis City,1041,177140,29510
2021-05-19,MO,St. Louis City,1289,178429,29510
2021-05-20,MO,St. Louis City,730,179159,29510
2021-05-21,MO,St. Louis City,718,179877,29510
2021-05-22,MO,St. Louis City,740,180617,29510
2021-05-23,MO,St. Louis City,200,180817,29510
2021-05-24,MO,St. Louis City,738,181555,29510
2021-05-25,MO,St. Louis City,860,182415,29510
2021-05-26,MO,St. Louis City,879,183294,29510
2021-05-27,MO,St. Louis City,215,183509,29510
2020-12-15,MO,Ste. Genevieve,1,1,29186
2020-12-16,MO,Ste. Genevieve,5,6,29186
2020-12-17,MO,Ste. Genevieve,7,13,29186
2020-12-18,MO,Ste. Genevieve,12,25,29186
2020-12-19,MO,Ste. Genevieve,4,29,29186
2020-12-20,MO,Ste. Genevieve,2,31,29186
2020-12-21,MO,Ste. Genevieve,11,42,29186
2020-12-22,MO,Ste. Genevieve,16,58,29186
2020-12-23,MO,Ste. Genevieve,19,77,29186
2020-12-24,MO,Ste. Genevieve,2,79,29186
2020-12-26,MO,Ste. Genevieve,1,80,29186
2020-12-27,MO,Ste. Genevieve,1,81,29186
2020-12-28,MO,Ste. Genevieve,46,127,29186
2020-12-29,MO,Ste. Genevieve,85,212,29186
2020-12-30,MO,Ste. Genevieve,94,306,29186
2020-12-31,MO,Ste. Genevieve,42,348,29186
2021-01-01,MO,Ste. Genevieve,1,349,29186
2021-01-02,MO,Ste. Genevieve,4,353,29186
2021-01-03,MO,Ste. Genevieve,1,354,29186
2021-01-04,MO,Ste. Genevieve,12,366,29186
2021-01-05,MO,Ste. Genevieve,12,378,29186
2021-01-06,MO,Ste. Genevieve,8,386,29186
2021-01-07,MO,Ste. Genevieve,13,399,29186
2021-01-08,MO,Ste. Genevieve,23,422,29186
2021-01-09,MO,Ste. Genevieve,11,433,29186
2021-01-11,MO,Ste. Genevieve,21,454,29186
2021-01-12,MO,Ste. Genevieve,15,469,29186
2021-01-13,MO,Ste. Genevieve,35,504,29186
2021-01-14,MO,Ste. Genevieve,40,544,29186
2021-01-15,MO,Ste. Genevieve,83,627,29186
2021-01-16,MO,Ste. Genevieve,4,631,29186
2021-01-17,MO,Ste. Genevieve,1,632,29186
2021-01-18,MO,Ste. Genevieve,34,666,29186
2021-01-19,MO,Ste. Genevieve,27,693,29186
2021-01-20,MO,Ste. Genevieve,30,723,29186
2021-01-21,MO,Ste. Genevieve,48,771,29186
2021-01-22,MO,Ste. Genevieve,83,854,29186
2021-01-23,MO,Ste. Genevieve,23,877,29186
2021-01-24,MO,Ste. Genevieve,8,885,29186
2021-01-25,MO,Ste. Genevieve,132,1017,29186
2021-01-26,MO,Ste. Genevieve,93,1110,29186
2021-01-27,MO,Ste. Genevieve,117,1227,29186
2021-01-28,MO,Ste. Genevieve,42,1269,29186
2021-01-29,MO,Ste. Genevieve,190,1459,29186
2021-01-30,MO,Ste. Genevieve,2,1461,29186
2021-02-01,MO,Ste. Genevieve,20,1481,29186
2021-02-02,MO,Ste. Genevieve,481,1962,29186
2021-02-03,MO,Ste. Genevieve,326,2288,29186
2021-02-04,MO,Ste. Genevieve,49,2337,29186
2021-02-05,MO,Ste. Genevieve,59,2396,29186
2021-02-06,MO,Ste. Genevieve,9,2405,29186
2021-02-07,MO,Ste. Genevieve,1,2406,29186
2021-02-08,MO,Ste. Genevieve,36,2442,29186
2021-02-09,MO,Ste. Genevieve,127,2569,29186
2021-02-10,MO,Ste. Genevieve,21,2590,29186
2021-02-11,MO,Ste. Genevieve,56,2646,29186
2021-02-12,MO,Ste. Genevieve,241,2887,29186
2021-02-13,MO,Ste. Genevieve,23,2910,29186
2021-02-14,MO,Ste. Genevieve,5,2915,29186
2021-02-15,MO,Ste. Genevieve,37,2952,29186
2021-02-16,MO,Ste. Genevieve,41,2993,29186
2021-02-17,MO,Ste. Genevieve,16,3009,29186
2021-02-18,MO,Ste. Genevieve,24,3033,29186
2021-02-19,MO,Ste. Genevieve,157,3190,29186
2021-02-20,MO,Ste. Genevieve,6,3196,29186
2021-02-21,MO,Ste. Genevieve,5,3201,29186
2021-02-22,MO,Ste. Genevieve,29,3230,29186
2021-02-23,MO,Ste. Genevieve,23,3253,29186
2021-02-24,MO,Ste. Genevieve,434,3687,29186
2021-02-25,MO,Ste. Genevieve,49,3736,29186
2021-02-26,MO,Ste. Genevieve,120,3856,29186
2021-02-27,MO,Ste. Genevieve,26,3882,29186
2021-02-28,MO,Ste. Genevieve,2,3884,29186
2021-03-01,MO,Ste. Genevieve,21,3905,29186
2021-03-02,MO,Ste. Genevieve,501,4406,29186
2021-03-03,MO,Ste. Genevieve,377,4783,29186
2021-03-04,MO,Ste. Genevieve,27,4810,29186
2021-03-05,MO,Ste. Genevieve,72,4882,29186
2021-03-06,MO,Ste. Genevieve,5,4887,29186
2021-03-07,MO,Ste. Genevieve,4,4891,29186
2021-03-08,MO,Ste. Genevieve,64,4955,29186
2021-03-09,MO,Ste. Genevieve,273,5228,29186
2021-03-10,MO,Ste. Genevieve,114,5342,29186
2021-03-11,MO,Ste. Genevieve,69,5411,29186
2021-03-12,MO,Ste. Genevieve,94,5505,29186
2021-03-13,MO,Ste. Genevieve,16,5521,29186
2021-03-14,MO,Ste. Genevieve,2,5523,29186
2021-03-15,MO,Ste. Genevieve,50,5573,29186
2021-03-16,MO,Ste. Genevieve,51,5624,29186
2021-03-17,MO,Ste. Genevieve,79,5703,29186
2021-03-18,MO,Ste. Genevieve,121,5824,29186
2021-03-19,MO,Ste. Genevieve,118,5942,29186
2021-03-20,MO,Ste. Genevieve,10,5952,29186
2021-03-21,MO,Ste. Genevieve,4,5956,29186
2021-03-22,MO,Ste. Genevieve,33,5989,29186
2021-03-23,MO,Ste. Genevieve,24,6013,29186
2021-03-24,MO,Ste. Genevieve,384,6397,29186
2021-03-25,MO,Ste. Genevieve,136,6533,29186
2021-03-26,MO,Ste. Genevieve,67,6600,29186
2021-03-27,MO,Ste. Genevieve,8,6608,29186
2021-03-28,MO,Ste. Genevieve,4,6612,29186
2021-03-29,MO,Ste. Genevieve,16,6628,29186
2021-03-30,MO,Ste. Genevieve,312,6940,29186
2021-03-31,MO,Ste. Genevieve,252,7192,29186
2021-04-01,MO,Ste. Genevieve,153,7345,29186
2021-04-02,MO,Ste. Genevieve,82,7427,29186
2021-04-03,MO,Ste. Genevieve,8,7435,29186
2021-04-04,MO,Ste. Genevieve,1,7436,29186
2021-04-05,MO,Ste. Genevieve,45,7481,29186
2021-04-06,MO,Ste. Genevieve,268,7749,29186
2021-04-07,MO,Ste. Genevieve,138,7887,29186
2021-04-08,MO,Ste. Genevieve,191,8078,29186
2021-04-09,MO,Ste. Genevieve,91,8169,29186
2021-04-10,MO,Ste. Genevieve,36,8205,29186
2021-04-11,MO,Ste. Genevieve,7,8212,29186
2021-04-12,MO,Ste. Genevieve,57,8269,29186
2021-04-13,MO,Ste. Genevieve,45,8314,29186
2021-04-14,MO,Ste. Genevieve,98,8412,29186
2021-04-15,MO,Ste. Genevieve,175,8587,29186
2021-04-16,MO,Ste. Genevieve,72,8659,29186
2021-04-17,MO,Ste. Genevieve,12,8671,29186
2021-04-18,MO,Ste. Genevieve,6,8677,29186
2021-04-19,MO,Ste. Genevieve,18,8695,29186
2021-04-20,MO,Ste. Genevieve,40,8735,29186
2021-04-21,MO,Ste. Genevieve,40,8775,29186
2021-04-22,MO,Ste. Genevieve,111,8886,29186
2021-04-23,MO,Ste. Genevieve,96,8982,29186
2021-04-24,MO,Ste. Genevieve,13,8995,29186
2021-04-25,MO,Ste. Genevieve,7,9002,29186
2021-04-26,MO,Ste. Genevieve,29,9031,29186
2021-04-27,MO,Ste. Genevieve,99,9130,29186
2021-04-28,MO,Ste. Genevieve,273,9403,29186
2021-04-29,MO,Ste. Genevieve,190,9593,29186
2021-04-30,MO,Ste. Genevieve,28,9621,29186
2021-05-01,MO,Ste. Genevieve,14,9635,29186
2021-05-02,MO,Ste. Genevieve,7,9642,29186
2021-05-03,MO,Ste. Genevieve,29,9671,29186
2021-05-04,MO,Ste. Genevieve,106,9777,29186
2021-05-05,MO,Ste. Genevieve,32,9809,29186
2021-05-06,MO,Ste. Genevieve,86,9895,29186
2021-05-07,MO,Ste. Genevieve,32,9927,29186
2021-05-08,MO,Ste. Genevieve,15,9942,29186
2021-05-09,MO,Ste. Genevieve,4,9946,29186
2021-05-10,MO,Ste. Genevieve,24,9970,29186
2021-05-11,MO,Ste. Genevieve,128,10098,29186
2021-05-12,MO,Ste. Genevieve,28,10126,29186
2021-05-13,MO,Ste. Genevieve,35,10161,29186
2021-05-14,MO,Ste. Genevieve,35,10196,29186
2021-05-15,MO,Ste. Genevieve,19,10215,29186
2021-05-16,MO,Ste. Genevieve,8,10223,29186
2021-05-17,MO,Ste. Genevieve,20,10243,29186
2021-05-18,MO,Ste. Genevieve,94,10337,29186
2021-05-19,MO,Ste. Genevieve,43,10380,29186
2021-05-20,MO,Ste. Genevieve,54,10434,29186
2021-05-21,MO,Ste. Genevieve,25,10459,29186
2021-05-22,MO,Ste. Genevieve,8,10467,29186
2021-05-23,MO,Ste. Genevieve,5,10472,29186
2021-05-24,MO,Ste. Genevieve,21,10493,29186
2021-05-25,MO,Ste. Genevieve,82,10575,29186
2021-05-26,MO,Ste. Genevieve,27,10602,29186
2021-05-27,MO,Ste. Genevieve,24,10626,29186
2020-12-15,MO,Stoddard,3,3,29207
2020-12-17,MO,Stoddard,3,6,29207
2020-12-18,MO,Stoddard,44,50,29207
2020-12-20,MO,Stoddard,2,52,29207
2020-12-21,MO,Stoddard,6,58,29207
2020-12-22,MO,Stoddard,28,86,29207
2020-12-23,MO,Stoddard,32,118,29207
2020-12-24,MO,Stoddard,1,119,29207
2020-12-26,MO,Stoddard,1,120,29207
2020-12-28,MO,Stoddard,58,178,29207
2020-12-29,MO,Stoddard,57,235,29207
2020-12-30,MO,Stoddard,44,279,29207
2020-12-31,MO,Stoddard,29,308,29207
2021-01-01,MO,Stoddard,2,310,29207
2021-01-02,MO,Stoddard,1,311,29207
2021-01-03,MO,Stoddard,5,316,29207
2021-01-04,MO,Stoddard,59,375,29207
2021-01-05,MO,Stoddard,97,472,29207
2021-01-06,MO,Stoddard,12,484,29207
2021-01-07,MO,Stoddard,26,510,29207
2021-01-08,MO,Stoddard,60,570,29207
2021-01-09,MO,Stoddard,11,581,29207
2021-01-10,MO,Stoddard,2,583,29207
2021-01-11,MO,Stoddard,14,597,29207
2021-01-12,MO,Stoddard,43,640,29207
2021-01-13,MO,Stoddard,47,687,29207
2021-01-14,MO,Stoddard,28,715,29207
2021-01-15,MO,Stoddard,36,751,29207
2021-01-16,MO,Stoddard,7,758,29207
2021-01-18,MO,Stoddard,54,812,29207
2021-01-19,MO,Stoddard,98,910,29207
2021-01-20,MO,Stoddard,193,1103,29207
2021-01-21,MO,Stoddard,140,1243,29207
2021-01-22,MO,Stoddard,366,1609,29207
2021-01-23,MO,Stoddard,74,1683,29207
2021-01-24,MO,Stoddard,3,1686,29207
2021-01-25,MO,Stoddard,137,1823,29207
2021-01-26,MO,Stoddard,156,1979,29207
2021-01-27,MO,Stoddard,441,2420,29207
2021-01-28,MO,Stoddard,47,2467,29207
2021-01-29,MO,Stoddard,132,2599,29207
2021-01-30,MO,Stoddard,4,2603,29207
2021-02-01,MO,Stoddard,88,2691,29207
2021-02-02,MO,Stoddard,63,2754,29207
2021-02-03,MO,Stoddard,30,2784,29207
2021-02-04,MO,Stoddard,166,2950,29207
2021-02-05,MO,Stoddard,434,3384,29207
2021-02-06,MO,Stoddard,13,3397,29207
2021-02-07,MO,Stoddard,3,3400,29207
2021-02-08,MO,Stoddard,63,3463,29207
2021-02-09,MO,Stoddard,255,3718,29207
2021-02-10,MO,Stoddard,154,3872,29207
2021-02-11,MO,Stoddard,72,3944,29207
2021-02-12,MO,Stoddard,358,4302,29207
2021-02-13,MO,Stoddard,24,4326,29207
2021-02-14,MO,Stoddard,9,4335,29207
2021-02-15,MO,Stoddard,33,4368,29207
2021-02-16,MO,Stoddard,59,4427,29207
2021-02-17,MO,Stoddard,17,4444,29207
2021-02-18,MO,Stoddard,16,4460,29207
2021-02-19,MO,Stoddard,119,4579,29207
2021-02-20,MO,Stoddard,24,4603,29207
2021-02-21,MO,Stoddard,4,4607,29207
2021-02-22,MO,Stoddard,65,4672,29207
2021-02-23,MO,Stoddard,237,4909,29207
2021-02-24,MO,Stoddard,535,5444,29207
2021-02-25,MO,Stoddard,84,5528,29207
2021-02-26,MO,Stoddard,133,5661,29207
2021-02-27,MO,Stoddard,37,5698,29207
2021-02-28,MO,Stoddard,1,5699,29207
2021-03-01,MO,Stoddard,61,5760,29207
2021-03-02,MO,Stoddard,202,5962,29207
2021-03-03,MO,Stoddard,490,6452,29207
2021-03-04,MO,Stoddard,163,6615,29207
2021-03-05,MO,Stoddard,356,6971,29207
2021-03-06,MO,Stoddard,13,6984,29207
2021-03-07,MO,Stoddard,7,6991,29207
2021-03-08,MO,Stoddard,165,7156,29207
2021-03-09,MO,Stoddard,103,7259,29207
2021-03-10,MO,Stoddard,67,7326,29207
2021-03-11,MO,Stoddard,61,7387,29207
2021-03-12,MO,Stoddard,114,7501,29207
2021-03-13,MO,Stoddard,32,7533,29207
2021-03-14,MO,Stoddard,29,7562,29207
2021-03-15,MO,Stoddard,107,7669,29207
2021-03-16,MO,Stoddard,100,7769,29207
2021-03-17,MO,Stoddard,125,7894,29207
2021-03-18,MO,Stoddard,91,7985,29207
2021-03-19,MO,Stoddard,397,8382,29207
2021-03-20,MO,Stoddard,65,8447,29207
2021-03-21,MO,Stoddard,24,8471,29207
2021-03-22,MO,Stoddard,86,8557,29207
2021-03-23,MO,Stoddard,269,8826,29207
2021-03-24,MO,Stoddard,87,8913,29207
2021-03-25,MO,Stoddard,248,9161,29207
2021-03-26,MO,Stoddard,58,9219,29207
2021-03-27,MO,Stoddard,28,9247,29207
2021-03-28,MO,Stoddard,21,9268,29207
2021-03-29,MO,Stoddard,67,9335,29207
2021-03-30,MO,Stoddard,218,9553,29207
2021-03-31,MO,Stoddard,490,10043,29207
2021-04-01,MO,Stoddard,66,10109,29207
2021-04-02,MO,Stoddard,104,10213,29207
2021-04-03,MO,Stoddard,41,10254,29207
2021-04-04,MO,Stoddard,12,10266,29207
2021-04-05,MO,Stoddard,125,10391,29207
2021-04-06,MO,Stoddard,122,10513,29207
2021-04-07,MO,Stoddard,98,10611,29207
2021-04-08,MO,Stoddard,116,10727,29207
2021-04-09,MO,Stoddard,231,10958,29207
2021-04-10,MO,Stoddard,33,10991,29207
2021-04-11,MO,Stoddard,25,11016,29207
2021-04-12,MO,Stoddard,78,11094,29207
2021-04-13,MO,Stoddard,115,11209,29207
2021-04-14,MO,Stoddard,95,11304,29207
2021-04-15,MO,Stoddard,111,11415,29207
2021-04-16,MO,Stoddard,317,11732,29207
2021-04-17,MO,Stoddard,47,11779,29207
2021-04-18,MO,Stoddard,31,11810,29207
2021-04-19,MO,Stoddard,79,11889,29207
2021-04-20,MO,Stoddard,61,11950,29207
2021-04-21,MO,Stoddard,97,12047,29207
2021-04-22,MO,Stoddard,224,12271,29207
2021-04-23,MO,Stoddard,74,12345,29207
2021-04-24,MO,Stoddard,48,12393,29207
2021-04-25,MO,Stoddard,13,12406,29207
2021-04-26,MO,Stoddard,59,12465,29207
2021-04-27,MO,Stoddard,30,12495,29207
2021-04-28,MO,Stoddard,66,12561,29207
2021-04-29,MO,Stoddard,58,12619,29207
2021-04-30,MO,Stoddard,80,12699,29207
2021-05-01,MO,Stoddard,38,12737,29207
2021-05-02,MO,Stoddard,19,12756,29207
2021-05-03,MO,Stoddard,55,12811,29207
2021-05-04,MO,Stoddard,53,12864,29207
2021-05-05,MO,Stoddard,50,12914,29207
2021-05-06,MO,Stoddard,49,12963,29207
2021-05-07,MO,Stoddard,85,13048,29207
2021-05-08,MO,Stoddard,29,13077,29207
2021-05-09,MO,Stoddard,18,13095,29207
2021-05-10,MO,Stoddard,34,13129,29207
2021-05-11,MO,Stoddard,51,13180,29207
2021-05-12,MO,Stoddard,36,13216,29207
2021-05-13,MO,Stoddard,64,13280,29207
2021-05-14,MO,Stoddard,75,13355,29207
2021-05-15,MO,Stoddard,55,13410,29207
2021-05-16,MO,Stoddard,17,13427,29207
2021-05-17,MO,Stoddard,61,13488,29207
2021-05-18,MO,Stoddard,45,13533,29207
2021-05-19,MO,Stoddard,48,13581,29207
2021-05-20,MO,Stoddard,49,13630,29207
2021-05-21,MO,Stoddard,67,13697,29207
2021-05-22,MO,Stoddard,21,13718,29207
2021-05-23,MO,Stoddard,12,13730,29207
2021-05-24,MO,Stoddard,50,13780,29207
2021-05-25,MO,Stoddard,24,13804,29207
2021-05-26,MO,Stoddard,28,13832,29207
2021-05-27,MO,Stoddard,16,13848,29207
2020-12-16,MO,Stone,11,11,29209
2020-12-17,MO,Stone,6,17,29209
2020-12-18,MO,Stone,5,22,29209
2020-12-20,MO,Stone,1,23,29209
2020-12-21,MO,Stone,10,33,29209
2020-12-22,MO,Stone,38,71,29209
2020-12-23,MO,Stone,21,92,29209
2020-12-24,MO,Stone,17,109,29209
2020-12-26,MO,Stone,3,112,29209
2020-12-27,MO,Stone,7,119,29209
2020-12-28,MO,Stone,22,141,29209
2020-12-29,MO,Stone,29,170,29209
2020-12-30,MO,Stone,30,200,29209
2020-12-31,MO,Stone,21,221,29209
2021-01-02,MO,Stone,5,226,29209
2021-01-04,MO,Stone,11,237,29209
2021-01-05,MO,Stone,11,248,29209
2021-01-06,MO,Stone,6,254,29209
2021-01-07,MO,Stone,7,261,29209
2021-01-08,MO,Stone,19,280,29209
2021-01-09,MO,Stone,1,281,29209
2021-01-10,MO,Stone,1,282,29209
2021-01-11,MO,Stone,12,294,29209
2021-01-12,MO,Stone,11,305,29209
2021-01-13,MO,Stone,46,351,29209
2021-01-14,MO,Stone,27,378,29209
2021-01-15,MO,Stone,10,388,29209
2021-01-16,MO,Stone,11,399,29209
2021-01-17,MO,Stone,2,401,29209
2021-01-18,MO,Stone,11,412,29209
2021-01-19,MO,Stone,15,427,29209
2021-01-20,MO,Stone,75,502,29209
2021-01-21,MO,Stone,84,586,29209
2021-01-22,MO,Stone,74,660,29209
2021-01-23,MO,Stone,23,683,29209
2021-01-24,MO,Stone,2,685,29209
2021-01-25,MO,Stone,39,724,29209
2021-01-26,MO,Stone,190,914,29209
2021-01-27,MO,Stone,224,1138,29209
2021-01-28,MO,Stone,54,1192,29209
2021-01-29,MO,Stone,43,1235,29209
2021-01-30,MO,Stone,11,1246,29209
2021-02-01,MO,Stone,277,1523,29209
2021-02-02,MO,Stone,298,1821,29209
2021-02-03,MO,Stone,286,2107,29209
2021-02-04,MO,Stone,118,2225,29209
2021-02-05,MO,Stone,84,2309,29209
2021-02-06,MO,Stone,46,2355,29209
2021-02-07,MO,Stone,1,2356,29209
2021-02-08,MO,Stone,49,2405,29209
2021-02-09,MO,Stone,84,2489,29209
2021-02-10,MO,Stone,42,2531,29209
2021-02-11,MO,Stone,152,2683,29209
2021-02-12,MO,Stone,723,3406,29209
2021-02-13,MO,Stone,65,3471,29209
2021-02-14,MO,Stone,14,3485,29209
2021-02-15,MO,Stone,8,3493,29209
2021-02-16,MO,Stone,18,3511,29209
2021-02-17,MO,Stone,19,3530,29209
2021-02-18,MO,Stone,130,3660,29209
2021-02-19,MO,Stone,101,3761,29209
2021-02-20,MO,Stone,14,3775,29209
2021-02-22,MO,Stone,86,3861,29209
2021-02-23,MO,Stone,357,4218,29209
2021-02-24,MO,Stone,227,4445,29209
2021-02-25,MO,Stone,116,4561,29209
2021-02-26,MO,Stone,83,4644,29209
2021-02-27,MO,Stone,114,4758,29209
2021-02-28,MO,Stone,2,4760,29209
2021-03-01,MO,Stone,321,5081,29209
2021-03-02,MO,Stone,422,5503,29209
2021-03-03,MO,Stone,443,5946,29209
2021-03-04,MO,Stone,551,6497,29209
2021-03-05,MO,Stone,195,6692,29209
2021-03-06,MO,Stone,67,6759,29209
2021-03-07,MO,Stone,4,6763,29209
2021-03-08,MO,Stone,162,6925,29209
2021-03-09,MO,Stone,224,7149,29209
2021-03-10,MO,Stone,51,7200,29209
2021-03-11,MO,Stone,452,7652,29209
2021-03-12,MO,Stone,726,8378,29209
2021-03-13,MO,Stone,80,8458,29209
2021-03-14,MO,Stone,8,8466,29209
2021-03-15,MO,Stone,57,8523,29209
2021-03-16,MO,Stone,95,8618,29209
2021-03-17,MO,Stone,274,8892,29209
2021-03-18,MO,Stone,260,9152,29209
2021-03-19,MO,Stone,184,9336,29209
2021-03-20,MO,Stone,92,9428,29209
2021-03-21,MO,Stone,12,9440,29209
2021-03-22,MO,Stone,163,9603,29209
2021-03-23,MO,Stone,461,10064,29209
2021-03-24,MO,Stone,144,10208,29209
2021-03-25,MO,Stone,364,10572,29209
2021-03-26,MO,Stone,124,10696,29209
2021-03-27,MO,Stone,90,10786,29209
2021-03-28,MO,Stone,12,10798,29209
2021-03-29,MO,Stone,47,10845,29209
2021-03-30,MO,Stone,266,11111,29209
2021-03-31,MO,Stone,266,11377,29209
2021-04-01,MO,Stone,480,11857,29209
2021-04-02,MO,Stone,241,12098,29209
2021-04-03,MO,Stone,98,12196,29209
2021-04-04,MO,Stone,6,12202,29209
2021-04-05,MO,Stone,124,12326,29209
2021-04-06,MO,Stone,382,12708,29209
2021-04-07,MO,Stone,324,13032,29209
2021-04-08,MO,Stone,210,13242,29209
2021-04-09,MO,Stone,164,13406,29209
2021-04-10,MO,Stone,76,13482,29209
2021-04-11,MO,Stone,15,13497,29209
2021-04-12,MO,Stone,178,13675,29209
2021-04-13,MO,Stone,206,13881,29209
2021-04-14,MO,Stone,100,13981,29209
2021-04-15,MO,Stone,90,14071,29209
2021-04-16,MO,Stone,99,14170,29209
2021-04-17,MO,Stone,63,14233,29209
2021-04-18,MO,Stone,10,14243,29209
2021-04-19,MO,Stone,41,14284,29209
2021-04-20,MO,Stone,156,14440,29209
2021-04-21,MO,Stone,85,14525,29209
2021-04-22,MO,Stone,96,14621,29209
2021-04-23,MO,Stone,158,14779,29209
2021-04-24,MO,Stone,68,14847,29209
2021-04-25,MO,Stone,15,14862,29209
2021-04-26,MO,Stone,70,14932,29209
2021-04-27,MO,Stone,134,15066,29209
2021-04-28,MO,Stone,66,15132,29209
2021-04-29,MO,Stone,78,15210,29209
2021-04-30,MO,Stone,39,15249,29209
2021-05-01,MO,Stone,30,15279,29209
2021-05-02,MO,Stone,14,15293,29209
2021-05-03,MO,Stone,36,15329,29209
2021-05-04,MO,Stone,84,15413,29209
2021-05-05,MO,Stone,128,15541,29209
2021-05-06,MO,Stone,67,15608,29209
2021-05-07,MO,Stone,49,15657,29209
2021-05-08,MO,Stone,24,15681,29209
2021-05-09,MO,Stone,11,15692,29209
2021-05-10,MO,Stone,55,15747,29209
2021-05-11,MO,Stone,115,15862,29209
2021-05-12,MO,Stone,39,15901,29209
2021-05-13,MO,Stone,61,15962,29209
2021-05-14,MO,Stone,32,15994,29209
2021-05-15,MO,Stone,48,16042,29209
2021-05-16,MO,Stone,11,16053,29209
2021-05-17,MO,Stone,54,16107,29209
2021-05-18,MO,Stone,79,16186,29209
2021-05-19,MO,Stone,58,16244,29209
2021-05-20,MO,Stone,31,16275,29209
2021-05-21,MO,Stone,34,16309,29209
2021-05-22,MO,Stone,22,16331,29209
2021-05-23,MO,Stone,8,16339,29209
2021-05-24,MO,Stone,20,16359,29209
2021-05-25,MO,Stone,59,16418,29209
2021-05-26,MO,Stone,23,16441,29209
2021-05-27,MO,Stone,17,16458,29209
2020-12-19,MO,Sullivan,1,1,29211
2020-12-21,MO,Sullivan,16,17,29211
2020-12-23,MO,Sullivan,12,29,29211
2020-12-28,MO,Sullivan,1,30,29211
2020-12-29,MO,Sullivan,2,32,29211
2020-12-31,MO,Sullivan,1,33,29211
2021-01-05,MO,Sullivan,3,36,29211
2021-01-06,MO,Sullivan,1,37,29211
2021-01-07,MO,Sullivan,2,39,29211
2021-01-08,MO,Sullivan,1,40,29211
2021-01-09,MO,Sullivan,2,42,29211
2021-01-11,MO,Sullivan,19,61,29211
2021-01-12,MO,Sullivan,39,100,29211
2021-01-13,MO,Sullivan,13,113,29211
2021-01-14,MO,Sullivan,6,119,29211
2021-01-15,MO,Sullivan,9,128,29211
2021-01-18,MO,Sullivan,1,129,29211
2021-01-19,MO,Sullivan,5,134,29211
2021-01-20,MO,Sullivan,8,142,29211
2021-01-21,MO,Sullivan,4,146,29211
2021-01-22,MO,Sullivan,55,201,29211
2021-01-25,MO,Sullivan,2,203,29211
2021-01-27,MO,Sullivan,35,238,29211
2021-01-28,MO,Sullivan,39,277,29211
2021-01-29,MO,Sullivan,25,302,29211
2021-01-30,MO,Sullivan,1,303,29211
2021-02-01,MO,Sullivan,200,503,29211
2021-02-02,MO,Sullivan,14,517,29211
2021-02-03,MO,Sullivan,3,520,29211
2021-02-04,MO,Sullivan,25,545,29211
2021-02-05,MO,Sullivan,122,667,29211
2021-02-06,MO,Sullivan,3,670,29211
2021-02-08,MO,Sullivan,14,684,29211
2021-02-09,MO,Sullivan,44,728,29211
2021-02-10,MO,Sullivan,13,741,29211
2021-02-11,MO,Sullivan,8,749,29211
2021-02-12,MO,Sullivan,14,763,29211
2021-02-13,MO,Sullivan,1,764,29211
2021-02-14,MO,Sullivan,2,766,29211
2021-02-15,MO,Sullivan,1,767,29211
2021-02-16,MO,Sullivan,4,771,29211
2021-02-17,MO,Sullivan,1,772,29211
2021-02-18,MO,Sullivan,58,830,29211
2021-02-19,MO,Sullivan,7,837,29211
2021-02-20,MO,Sullivan,1,838,29211
2021-02-22,MO,Sullivan,5,843,29211
2021-02-23,MO,Sullivan,3,846,29211
2021-02-24,MO,Sullivan,44,890,29211
2021-02-25,MO,Sullivan,105,995,29211
2021-02-26,MO,Sullivan,121,1116,29211
2021-02-27,MO,Sullivan,28,1144,29211
2021-02-28,MO,Sullivan,1,1145,29211
2021-03-01,MO,Sullivan,32,1177,29211
2021-03-02,MO,Sullivan,20,1197,29211
2021-03-03,MO,Sullivan,95,1292,29211
2021-03-04,MO,Sullivan,208,1500,29211
2021-03-05,MO,Sullivan,40,1540,29211
2021-03-06,MO,Sullivan,9,1549,29211
2021-03-07,MO,Sullivan,2,1551,29211
2021-03-08,MO,Sullivan,9,1560,29211
2021-03-09,MO,Sullivan,16,1576,29211
2021-03-10,MO,Sullivan,7,1583,29211
2021-03-11,MO,Sullivan,11,1594,29211
2021-03-12,MO,Sullivan,93,1687,29211
2021-03-13,MO,Sullivan,4,1691,29211
2021-03-15,MO,Sullivan,2,1693,29211
2021-03-16,MO,Sullivan,20,1713,29211
2021-03-17,MO,Sullivan,11,1724,29211
2021-03-18,MO,Sullivan,26,1750,29211
2021-03-19,MO,Sullivan,107,1857,29211
2021-03-20,MO,Sullivan,22,1879,29211
2021-03-22,MO,Sullivan,5,1884,29211
2021-03-23,MO,Sullivan,84,1968,29211
2021-03-24,MO,Sullivan,8,1976,29211
2021-03-25,MO,Sullivan,72,2048,29211
2021-03-26,MO,Sullivan,200,2248,29211
2021-03-27,MO,Sullivan,5,2253,29211
2021-03-28,MO,Sullivan,3,2256,29211
2021-03-29,MO,Sullivan,16,2272,29211
2021-03-30,MO,Sullivan,22,2294,29211
2021-03-31,MO,Sullivan,20,2314,29211
2021-04-01,MO,Sullivan,15,2329,29211
2021-04-02,MO,Sullivan,132,2461,29211
2021-04-03,MO,Sullivan,9,2470,29211
2021-04-04,MO,Sullivan,2,2472,29211
2021-04-05,MO,Sullivan,3,2475,29211
2021-04-06,MO,Sullivan,18,2493,29211
2021-04-07,MO,Sullivan,10,2503,29211
2021-04-08,MO,Sullivan,14,2517,29211
2021-04-09,MO,Sullivan,26,2543,29211
2021-04-10,MO,Sullivan,3,2546,29211
2021-04-11,MO,Sullivan,4,2550,29211
2021-04-12,MO,Sullivan,12,2562,29211
2021-04-13,MO,Sullivan,7,2569,29211
2021-04-14,MO,Sullivan,12,2581,29211
2021-04-15,MO,Sullivan,24,2605,29211
2021-04-16,MO,Sullivan,164,2769,29211
2021-04-17,MO,Sullivan,10,2779,29211
2021-04-18,MO,Sullivan,1,2780,29211
2021-04-19,MO,Sullivan,4,2784,29211
2021-04-20,MO,Sullivan,13,2797,29211
2021-04-21,MO,Sullivan,12,2809,29211
2021-04-22,MO,Sullivan,10,2819,29211
2021-04-23,MO,Sullivan,16,2835,29211
2021-04-24,MO,Sullivan,9,2844,29211
2021-04-25,MO,Sullivan,1,2845,29211
2021-04-26,MO,Sullivan,3,2848,29211
2021-04-27,MO,Sullivan,18,2866,29211
2021-04-28,MO,Sullivan,126,2992,29211
2021-04-29,MO,Sullivan,7,2999,29211
2021-04-30,MO,Sullivan,1,3000,29211
2021-05-01,MO,Sullivan,5,3005,29211
2021-05-02,MO,Sullivan,4,3009,29211
2021-05-03,MO,Sullivan,10,3019,29211
2021-05-04,MO,Sullivan,8,3027,29211
2021-05-05,MO,Sullivan,58,3085,29211
2021-05-06,MO,Sullivan,11,3096,29211
2021-05-07,MO,Sullivan,18,3114,29211
2021-05-08,MO,Sullivan,8,3122,29211
2021-05-09,MO,Sullivan,1,3123,29211
2021-05-10,MO,Sullivan,3,3126,29211
2021-05-11,MO,Sullivan,3,3129,29211
2021-05-12,MO,Sullivan,6,3135,29211
2021-05-13,MO,Sullivan,9,3144,29211
2021-05-14,MO,Sullivan,6,3150,29211
2021-05-15,MO,Sullivan,6,3156,29211
2021-05-16,MO,Sullivan,5,3161,29211
2021-05-17,MO,Sullivan,10,3171,29211
2021-05-18,MO,Sullivan,7,3178,29211
2021-05-19,MO,Sullivan,10,3188,29211
2021-05-20,MO,Sullivan,9,3197,29211
2021-05-21,MO,Sullivan,17,3214,29211
2021-05-22,MO,Sullivan,10,3224,29211
2021-05-23,MO,Sullivan,4,3228,29211
2021-05-24,MO,Sullivan,6,3234,29211
2021-05-25,MO,Sullivan,5,3239,29211
2021-05-26,MO,Sullivan,18,3257,29211
2021-05-27,MO,Sullivan,2,3259,29211
2020-12-14,MO,Taney,2,2,29213
2020-12-15,MO,Taney,2,4,29213
2020-12-16,MO,Taney,6,10,29213
2020-12-17,MO,Taney,8,18,29213
2020-12-18,MO,Taney,1,19,29213
2020-12-19,MO,Taney,3,22,29213
2020-12-20,MO,Taney,1,23,29213
2020-12-21,MO,Taney,33,56,29213
2020-12-22,MO,Taney,168,224,29213
2020-12-23,MO,Taney,112,336,29213
2020-12-24,MO,Taney,19,355,29213
2020-12-26,MO,Taney,9,364,29213
2020-12-27,MO,Taney,16,380,29213
2020-12-28,MO,Taney,46,426,29213
2020-12-29,MO,Taney,79,505,29213
2020-12-30,MO,Taney,54,559,29213
2020-12-31,MO,Taney,23,582,29213
2021-01-02,MO,Taney,2,584,29213
2021-01-03,MO,Taney,1,585,29213
2021-01-04,MO,Taney,23,608,29213
2021-01-05,MO,Taney,12,620,29213
2021-01-06,MO,Taney,25,645,29213
2021-01-07,MO,Taney,9,654,29213
2021-01-08,MO,Taney,32,686,29213
2021-01-09,MO,Taney,2,688,29213
2021-01-10,MO,Taney,25,713,29213
2021-01-11,MO,Taney,15,728,29213
2021-01-12,MO,Taney,17,745,29213
2021-01-13,MO,Taney,22,767,29213
2021-01-14,MO,Taney,155,922,29213
2021-01-15,MO,Taney,19,941,29213
2021-01-16,MO,Taney,7,948,29213
2021-01-17,MO,Taney,5,953,29213
2021-01-18,MO,Taney,33,986,29213
2021-01-19,MO,Taney,56,1042,29213
2021-01-20,MO,Taney,256,1298,29213
2021-01-21,MO,Taney,219,1517,29213
2021-01-22,MO,Taney,351,1868,29213
2021-01-23,MO,Taney,42,1910,29213
2021-01-24,MO,Taney,11,1921,29213
2021-01-25,MO,Taney,39,1960,29213
2021-01-26,MO,Taney,112,2072,29213
2021-01-27,MO,Taney,110,2182,29213
2021-01-28,MO,Taney,326,2508,29213
2021-01-29,MO,Taney,260,2768,29213
2021-01-30,MO,Taney,7,2775,29213
2021-01-31,MO,Taney,2,2777,29213
2021-02-01,MO,Taney,103,2880,29213
2021-02-02,MO,Taney,136,3016,29213
2021-02-03,MO,Taney,74,3090,29213
2021-02-04,MO,Taney,273,3363,29213
2021-02-05,MO,Taney,221,3584,29213
2021-02-06,MO,Taney,24,3608,29213
2021-02-07,MO,Taney,27,3635,29213
2021-02-08,MO,Taney,167,3802,29213
2021-02-09,MO,Taney,199,4001,29213
2021-02-10,MO,Taney,19,4020,29213
2021-02-11,MO,Taney,260,4280,29213
2021-02-12,MO,Taney,337,4617,29213
2021-02-13,MO,Taney,269,4886,29213
2021-02-14,MO,Taney,16,4902,29213
2021-02-15,MO,Taney,7,4909,29213
2021-02-16,MO,Taney,20,4929,29213
2021-02-17,MO,Taney,20,4949,29213
2021-02-18,MO,Taney,183,5132,29213
2021-02-19,MO,Taney,309,5441,29213
2021-02-20,MO,Taney,11,5452,29213
2021-02-21,MO,Taney,3,5455,29213
2021-02-22,MO,Taney,153,5608,29213
2021-02-23,MO,Taney,190,5798,29213
2021-02-24,MO,Taney,426,6224,29213
2021-02-25,MO,Taney,102,6326,29213
2021-02-26,MO,Taney,123,6449,29213
2021-02-27,MO,Taney,672,7121,29213
2021-02-28,MO,Taney,3,7124,29213
2021-03-01,MO,Taney,361,7485,29213
2021-03-02,MO,Taney,323,7808,29213
2021-03-03,MO,Taney,639,8447,29213
2021-03-04,MO,Taney,359,8806,29213
2021-03-05,MO,Taney,351,9157,29213
2021-03-06,MO,Taney,40,9197,29213
2021-03-07,MO,Taney,20,9217,29213
2021-03-08,MO,Taney,467,9684,29213
2021-03-09,MO,Taney,453,10137,29213
2021-03-10,MO,Taney,70,10207,29213
2021-03-11,MO,Taney,198,10405,29213
2021-03-12,MO,Taney,257,10662,29213
2021-03-13,MO,Taney,251,10913,29213
2021-03-14,MO,Taney,12,10925,29213
2021-03-15,MO,Taney,456,11381,29213
2021-03-16,MO,Taney,341,11722,29213
2021-03-17,MO,Taney,448,12170,29213
2021-03-18,MO,Taney,604,12774,29213
2021-03-19,MO,Taney,373,13147,29213
2021-03-20,MO,Taney,576,13723,29213
2021-03-21,MO,Taney,22,13745,29213
2021-03-22,MO,Taney,618,14363,29213
2021-03-23,MO,Taney,550,14913,29213
2021-03-24,MO,Taney,518,15431,29213
2021-03-25,MO,Taney,105,15536,29213
2021-03-26,MO,Taney,188,15724,29213
2021-03-27,MO,Taney,149,15873,29213
2021-03-28,MO,Taney,22,15895,29213
2021-03-29,MO,Taney,128,16023,29213
2021-03-30,MO,Taney,299,16322,29213
2021-03-31,MO,Taney,490,16812,29213
2021-04-01,MO,Taney,398,17210,29213
2021-04-02,MO,Taney,532,17742,29213
2021-04-03,MO,Taney,112,17854,29213
2021-04-04,MO,Taney,14,17868,29213
2021-04-05,MO,Taney,688,18556,29213
2021-04-06,MO,Taney,699,19255,29213
2021-04-07,MO,Taney,468,19723,29213
2021-04-08,MO,Taney,496,20219,29213
2021-04-09,MO,Taney,407,20626,29213
2021-04-10,MO,Taney,125,20751,29213
2021-04-11,MO,Taney,33,20784,29213
2021-04-12,MO,Taney,319,21103,29213
2021-04-13,MO,Taney,318,21421,29213
2021-04-14,MO,Taney,374,21795,29213
2021-04-15,MO,Taney,277,22072,29213
2021-04-16,MO,Taney,132,22204,29213
2021-04-17,MO,Taney,37,22241,29213
2021-04-18,MO,Taney,12,22253,29213
2021-04-19,MO,Taney,110,22363,29213
2021-04-20,MO,Taney,236,22599,29213
2021-04-21,MO,Taney,60,22659,29213
2021-04-22,MO,Taney,366,23025,29213
2021-04-23,MO,Taney,325,23350,29213
2021-04-24,MO,Taney,80,23430,29213
2021-04-25,MO,Taney,18,23448,29213
2021-04-26,MO,Taney,161,23609,29213
2021-04-27,MO,Taney,136,23745,29213
2021-04-28,MO,Taney,79,23824,29213
2021-04-29,MO,Taney,173,23997,29213
2021-04-30,MO,Taney,111,24108,29213
2021-05-01,MO,Taney,33,24141,29213
2021-05-02,MO,Taney,34,24175,29213
2021-05-03,MO,Taney,118,24293,29213
2021-05-04,MO,Taney,109,24402,29213
2021-05-05,MO,Taney,231,24633,29213
2021-05-06,MO,Taney,177,24810,29213
2021-05-07,MO,Taney,80,24890,29213
2021-05-08,MO,Taney,41,24931,29213
2021-05-09,MO,Taney,13,24944,29213
2021-05-10,MO,Taney,66,25010,29213
2021-05-11,MO,Taney,182,25192,29213
2021-05-12,MO,Taney,87,25279,29213
2021-05-13,MO,Taney,135,25414,29213
2021-05-14,MO,Taney,90,25504,29213
2021-05-15,MO,Taney,69,25573,29213
2021-05-16,MO,Taney,33,25606,29213
2021-05-17,MO,Taney,88,25694,29213
2021-05-18,MO,Taney,121,25815,29213
2021-05-19,MO,Taney,137,25952,29213
2021-05-20,MO,Taney,76,26028,29213
2021-05-21,MO,Taney,60,26088,29213
2021-05-22,MO,Taney,39,26127,29213
2021-05-23,MO,Taney,26,26153,29213
2021-05-24,MO,Taney,50,26203,29213
2021-05-25,MO,Taney,70,26273,29213
2021-05-26,MO,Taney,87,26360,29213
2021-05-27,MO,Taney,28,26388,29213
2020-12-15,MO,Texas,2,2,29215
2020-12-16,MO,Texas,6,8,29215
2020-12-17,MO,Texas,2,10,29215
2020-12-18,MO,Texas,1,11,29215
2020-12-20,MO,Texas,1,12,29215
2020-12-21,MO,Texas,3,15,29215
2020-12-22,MO,Texas,7,22,29215
2020-12-23,MO,Texas,9,31,29215
2020-12-26,MO,Texas,2,33,29215
2020-12-28,MO,Texas,4,37,29215
2020-12-29,MO,Texas,27,64,29215
2020-12-30,MO,Texas,13,77,29215
2020-12-31,MO,Texas,4,81,29215
2021-01-01,MO,Texas,5,86,29215
2021-01-02,MO,Texas,12,98,29215
2021-01-03,MO,Texas,1,99,29215
2021-01-04,MO,Texas,10,109,29215
2021-01-05,MO,Texas,22,131,29215
2021-01-06,MO,Texas,30,161,29215
2021-01-07,MO,Texas,12,173,29215
2021-01-08,MO,Texas,32,205,29215
2021-01-09,MO,Texas,2,207,29215
2021-01-10,MO,Texas,3,210,29215
2021-01-11,MO,Texas,6,216,29215
2021-01-12,MO,Texas,15,231,29215
2021-01-13,MO,Texas,16,247,29215
2021-01-14,MO,Texas,6,253,29215
2021-01-15,MO,Texas,10,263,29215
2021-01-16,MO,Texas,2,265,29215
2021-01-18,MO,Texas,9,274,29215
2021-01-19,MO,Texas,22,296,29215
2021-01-20,MO,Texas,19,315,29215
2021-01-21,MO,Texas,67,382,29215
2021-01-22,MO,Texas,32,414,29215
2021-01-23,MO,Texas,10,424,29215
2021-01-24,MO,Texas,2,426,29215
2021-01-25,MO,Texas,18,444,29215
2021-01-26,MO,Texas,13,457,29215
2021-01-27,MO,Texas,16,473,29215
2021-01-28,MO,Texas,76,549,29215
2021-01-29,MO,Texas,124,673,29215
2021-01-30,MO,Texas,74,747,29215
2021-02-01,MO,Texas,17,764,29215
2021-02-02,MO,Texas,32,796,29215
2021-02-03,MO,Texas,50,846,29215
2021-02-04,MO,Texas,57,903,29215
2021-02-05,MO,Texas,827,1730,29215
2021-02-06,MO,Texas,9,1739,29215
2021-02-08,MO,Texas,20,1759,29215
2021-02-09,MO,Texas,36,1795,29215
2021-02-10,MO,Texas,30,1825,29215
2021-02-11,MO,Texas,158,1983,29215
2021-02-12,MO,Texas,134,2117,29215
2021-02-13,MO,Texas,22,2139,29215
2021-02-14,MO,Texas,5,2144,29215
2021-02-15,MO,Texas,9,2153,29215
2021-02-16,MO,Texas,20,2173,29215
2021-02-17,MO,Texas,8,2181,29215
2021-02-18,MO,Texas,62,2243,29215
2021-02-19,MO,Texas,58,2301,29215
2021-02-20,MO,Texas,11,2312,29215
2021-02-21,MO,Texas,4,2316,29215
2021-02-22,MO,Texas,28,2344,29215
2021-02-23,MO,Texas,106,2450,29215
2021-02-24,MO,Texas,35,2485,29215
2021-02-25,MO,Texas,72,2557,29215
2021-02-26,MO,Texas,129,2686,29215
2021-02-27,MO,Texas,96,2782,29215
2021-02-28,MO,Texas,9,2791,29215
2021-03-01,MO,Texas,16,2807,29215
2021-03-02,MO,Texas,349,3156,29215
2021-03-03,MO,Texas,83,3239,29215
2021-03-04,MO,Texas,81,3320,29215
2021-03-05,MO,Texas,43,3363,29215
2021-03-06,MO,Texas,13,3376,29215
2021-03-07,MO,Texas,3,3379,29215
2021-03-08,MO,Texas,47,3426,29215
2021-03-09,MO,Texas,755,4181,29215
2021-03-10,MO,Texas,46,4227,29215
2021-03-11,MO,Texas,188,4415,29215
2021-03-12,MO,Texas,134,4549,29215
2021-03-13,MO,Texas,20,4569,29215
2021-03-14,MO,Texas,2,4571,29215
2021-03-15,MO,Texas,131,4702,29215
2021-03-16,MO,Texas,147,4849,29215
2021-03-17,MO,Texas,53,4902,29215
2021-03-18,MO,Texas,56,4958,29215
2021-03-19,MO,Texas,59,5017,29215
2021-03-20,MO,Texas,31,5048,29215
2021-03-21,MO,Texas,7,5055,29215
2021-03-22,MO,Texas,43,5098,29215
2021-03-23,MO,Texas,181,5279,29215
2021-03-24,MO,Texas,44,5323,29215
2021-03-25,MO,Texas,139,5462,29215
2021-03-26,MO,Texas,65,5527,29215
2021-03-27,MO,Texas,66,5593,29215
2021-03-28,MO,Texas,10,5603,29215
2021-03-29,MO,Texas,34,5637,29215
2021-03-30,MO,Texas,356,5993,29215
2021-03-31,MO,Texas,92,6085,29215
2021-04-01,MO,Texas,77,6162,29215
2021-04-02,MO,Texas,43,6205,29215
2021-04-03,MO,Texas,26,6231,29215
2021-04-04,MO,Texas,5,6236,29215
2021-04-05,MO,Texas,35,6271,29215
2021-04-06,MO,Texas,107,6378,29215
2021-04-07,MO,Texas,100,6478,29215
2021-04-08,MO,Texas,65,6543,29215
2021-04-09,MO,Texas,108,6651,29215
2021-04-10,MO,Texas,62,6713,29215
2021-04-11,MO,Texas,7,6720,29215
2021-04-12,MO,Texas,154,6874,29215
2021-04-13,MO,Texas,171,7045,29215
2021-04-14,MO,Texas,61,7106,29215
2021-04-15,MO,Texas,70,7176,29215
2021-04-16,MO,Texas,84,7260,29215
2021-04-17,MO,Texas,35,7295,29215
2021-04-18,MO,Texas,5,7300,29215
2021-04-19,MO,Texas,39,7339,29215
2021-04-20,MO,Texas,77,7416,29215
2021-04-21,MO,Texas,46,7462,29215
2021-04-22,MO,Texas,125,7587,29215
2021-04-23,MO,Texas,44,7631,29215
2021-04-24,MO,Texas,48,7679,29215
2021-04-25,MO,Texas,10,7689,29215
2021-04-26,MO,Texas,50,7739,29215
2021-04-27,MO,Texas,311,8050,29215
2021-04-28,MO,Texas,238,8288,29215
2021-04-29,MO,Texas,18,8306,29215
2021-04-30,MO,Texas,48,8354,29215
2021-05-01,MO,Texas,21,8375,29215
2021-05-02,MO,Texas,12,8387,29215
2021-05-03,MO,Texas,15,8402,29215
2021-05-04,MO,Texas,64,8466,29215
2021-05-05,MO,Texas,45,8511,29215
2021-05-06,MO,Texas,29,8540,29215
2021-05-07,MO,Texas,25,8565,29215
2021-05-08,MO,Texas,27,8592,29215
2021-05-09,MO,Texas,6,8598,29215
2021-05-10,MO,Texas,17,8615,29215
2021-05-11,MO,Texas,47,8662,29215
2021-05-12,MO,Texas,119,8781,29215
2021-05-13,MO,Texas,60,8841,29215
2021-05-14,MO,Texas,38,8879,29215
2021-05-15,MO,Texas,35,8914,29215
2021-05-16,MO,Texas,11,8925,29215
2021-05-17,MO,Texas,33,8958,29215
2021-05-18,MO,Texas,55,9013,29215
2021-05-19,MO,Texas,15,9028,29215
2021-05-20,MO,Texas,20,9048,29215
2021-05-21,MO,Texas,40,9088,29215
2021-05-22,MO,Texas,28,9116,29215
2021-05-23,MO,Texas,3,9119,29215
2021-05-24,MO,Texas,433,9552,29215
2021-05-25,MO,Texas,48,9600,29215
2021-05-26,MO,Texas,17,9617,29215
2021-05-27,MO,Texas,19,9636,29215
2020-12-16,MO,Vernon,2,2,29217
2020-12-17,MO,Vernon,1,3,29217
2020-12-18,MO,Vernon,16,19,29217
2020-12-19,MO,Vernon,8,27,29217
2020-12-20,MO,Vernon,1,28,29217
2020-12-21,MO,Vernon,1,29,29217
2020-12-22,MO,Vernon,3,32,29217
2020-12-23,MO,Vernon,9,41,29217
2020-12-24,MO,Vernon,1,42,29217
2020-12-26,MO,Vernon,1,43,29217
2020-12-28,MO,Vernon,33,76,29217
2020-12-29,MO,Vernon,4,80,29217
2020-12-30,MO,Vernon,10,90,29217
2020-12-31,MO,Vernon,12,102,29217
2021-01-01,MO,Vernon,2,104,29217
2021-01-03,MO,Vernon,1,105,29217
2021-01-04,MO,Vernon,5,110,29217
2021-01-05,MO,Vernon,19,129,29217
2021-01-06,MO,Vernon,129,258,29217
2021-01-07,MO,Vernon,106,364,29217
2021-01-08,MO,Vernon,86,450,29217
2021-01-09,MO,Vernon,5,455,29217
2021-01-10,MO,Vernon,1,456,29217
2021-01-11,MO,Vernon,3,459,29217
2021-01-12,MO,Vernon,36,495,29217
2021-01-13,MO,Vernon,9,504,29217
2021-01-14,MO,Vernon,4,508,29217
2021-01-15,MO,Vernon,46,554,29217
2021-01-19,MO,Vernon,7,561,29217
2021-01-20,MO,Vernon,14,575,29217
2021-01-21,MO,Vernon,15,590,29217
2021-01-22,MO,Vernon,22,612,29217
2021-01-23,MO,Vernon,2,614,29217
2021-01-25,MO,Vernon,20,634,29217
2021-01-26,MO,Vernon,75,709,29217
2021-01-27,MO,Vernon,56,765,29217
2021-01-28,MO,Vernon,89,854,29217
2021-01-29,MO,Vernon,90,944,29217
2021-01-30,MO,Vernon,232,1176,29217
2021-01-31,MO,Vernon,1,1177,29217
2021-02-01,MO,Vernon,63,1240,29217
2021-02-02,MO,Vernon,120,1360,29217
2021-02-03,MO,Vernon,99,1459,29217
2021-02-04,MO,Vernon,99,1558,29217
2021-02-05,MO,Vernon,322,1880,29217
2021-02-08,MO,Vernon,13,1893,29217
2021-02-09,MO,Vernon,69,1962,29217
2021-02-10,MO,Vernon,67,2029,29217
2021-02-11,MO,Vernon,166,2195,29217
2021-02-12,MO,Vernon,45,2240,29217
2021-02-13,MO,Vernon,7,2247,29217
2021-02-14,MO,Vernon,1,2248,29217
2021-02-15,MO,Vernon,6,2254,29217
2021-02-16,MO,Vernon,9,2263,29217
2021-02-17,MO,Vernon,11,2274,29217
2021-02-18,MO,Vernon,73,2347,29217
2021-02-19,MO,Vernon,30,2377,29217
2021-02-20,MO,Vernon,5,2382,29217
2021-02-21,MO,Vernon,2,2384,29217
2021-02-22,MO,Vernon,8,2392,29217
2021-02-23,MO,Vernon,109,2501,29217
2021-02-24,MO,Vernon,97,2598,29217
2021-02-25,MO,Vernon,66,2664,29217
2021-02-26,MO,Vernon,257,2921,29217
2021-02-27,MO,Vernon,8,2929,29217
2021-02-28,MO,Vernon,1,2930,29217
2021-03-01,MO,Vernon,44,2974,29217
2021-03-02,MO,Vernon,90,3064,29217
2021-03-03,MO,Vernon,542,3606,29217
2021-03-04,MO,Vernon,244,3850,29217
2021-03-05,MO,Vernon,332,4182,29217
2021-03-06,MO,Vernon,5,4187,29217
2021-03-07,MO,Vernon,4,4191,29217
2021-03-08,MO,Vernon,19,4210,29217
2021-03-09,MO,Vernon,99,4309,29217
2021-03-10,MO,Vernon,67,4376,29217
2021-03-11,MO,Vernon,172,4548,29217
2021-03-12,MO,Vernon,37,4585,29217
2021-03-13,MO,Vernon,15,4600,29217
2021-03-14,MO,Vernon,1,4601,29217
2021-03-15,MO,Vernon,55,4656,29217
2021-03-16,MO,Vernon,442,5098,29217
2021-03-17,MO,Vernon,21,5119,29217
2021-03-18,MO,Vernon,107,5226,29217
2021-03-19,MO,Vernon,27,5253,29217
2021-03-20,MO,Vernon,6,5259,29217
2021-03-21,MO,Vernon,6,5265,29217
2021-03-22,MO,Vernon,16,5281,29217
2021-03-23,MO,Vernon,161,5442,29217
2021-03-24,MO,Vernon,85,5527,29217
2021-03-25,MO,Vernon,37,5564,29217
2021-03-26,MO,Vernon,43,5607,29217
2021-03-27,MO,Vernon,6,5613,29217
2021-03-28,MO,Vernon,1,5614,29217
2021-03-29,MO,Vernon,129,5743,29217
2021-03-30,MO,Vernon,173,5916,29217
2021-03-31,MO,Vernon,526,6442,29217
2021-04-01,MO,Vernon,225,6667,29217
2021-04-02,MO,Vernon,74,6741,29217
2021-04-03,MO,Vernon,13,6754,29217
2021-04-05,MO,Vernon,33,6787,29217
2021-04-06,MO,Vernon,27,6814,29217
2021-04-07,MO,Vernon,108,6922,29217
2021-04-08,MO,Vernon,28,6950,29217
2021-04-09,MO,Vernon,67,7017,29217
2021-04-10,MO,Vernon,24,7041,29217
2021-04-11,MO,Vernon,9,7050,29217
2021-04-12,MO,Vernon,54,7104,29217
2021-04-13,MO,Vernon,23,7127,29217
2021-04-14,MO,Vernon,81,7208,29217
2021-04-15,MO,Vernon,90,7298,29217
2021-04-16,MO,Vernon,171,7469,29217
2021-04-17,MO,Vernon,6,7475,29217
2021-04-18,MO,Vernon,5,7480,29217
2021-04-19,MO,Vernon,14,7494,29217
2021-04-20,MO,Vernon,87,7581,29217
2021-04-21,MO,Vernon,30,7611,29217
2021-04-22,MO,Vernon,21,7632,29217
2021-04-23,MO,Vernon,44,7676,29217
2021-04-24,MO,Vernon,4,7680,29217
2021-04-25,MO,Vernon,4,7684,29217
2021-04-26,MO,Vernon,38,7722,29217
2021-04-27,MO,Vernon,103,7825,29217
2021-04-28,MO,Vernon,29,7854,29217
2021-04-29,MO,Vernon,87,7941,29217
2021-04-30,MO,Vernon,91,8032,29217
2021-05-01,MO,Vernon,11,8043,29217
2021-05-02,MO,Vernon,3,8046,29217
2021-05-03,MO,Vernon,29,8075,29217
2021-05-04,MO,Vernon,13,8088,29217
2021-05-05,MO,Vernon,102,8190,29217
2021-05-06,MO,Vernon,18,8208,29217
2021-05-07,MO,Vernon,17,8225,29217
2021-05-08,MO,Vernon,10,8235,29217
2021-05-09,MO,Vernon,4,8239,29217
2021-05-10,MO,Vernon,22,8261,29217
2021-05-11,MO,Vernon,23,8284,29217
2021-05-12,MO,Vernon,36,8320,29217
2021-05-13,MO,Vernon,90,8410,29217
2021-05-14,MO,Vernon,19,8429,29217
2021-05-15,MO,Vernon,19,8448,29217
2021-05-16,MO,Vernon,5,8453,29217
2021-05-17,MO,Vernon,19,8472,29217
2021-05-18,MO,Vernon,11,8483,29217
2021-05-19,MO,Vernon,23,8506,29217
2021-05-20,MO,Vernon,31,8537,29217
2021-05-21,MO,Vernon,26,8563,29217
2021-05-22,MO,Vernon,10,8573,29217
2021-05-23,MO,Vernon,1,8574,29217
2021-05-24,MO,Vernon,11,8585,29217
2021-05-25,MO,Vernon,12,8597,29217
2021-05-26,MO,Vernon,47,8644,29217
2021-05-27,MO,Vernon,54,8698,29217
2020-12-15,MO,Warren,5,5,29219
2020-12-16,MO,Warren,8,13,29219
2020-12-17,MO,Warren,30,43,29219
2020-12-18,MO,Warren,36,79,29219
2020-12-19,MO,Warren,7,86,29219
2020-12-21,MO,Warren,34,120,29219
2020-12-22,MO,Warren,59,179,29219
2020-12-23,MO,Warren,33,212,29219
2020-12-24,MO,Warren,5,217,29219
2020-12-26,MO,Warren,7,224,29219
2020-12-27,MO,Warren,4,228,29219
2020-12-28,MO,Warren,35,263,29219
2020-12-29,MO,Warren,25,288,29219
2020-12-30,MO,Warren,28,316,29219
2020-12-31,MO,Warren,22,338,29219
2021-01-01,MO,Warren,2,340,29219
2021-01-02,MO,Warren,3,343,29219
2021-01-04,MO,Warren,21,364,29219
2021-01-05,MO,Warren,24,388,29219
2021-01-06,MO,Warren,93,481,29219
2021-01-07,MO,Warren,39,520,29219
2021-01-08,MO,Warren,45,565,29219
2021-01-09,MO,Warren,10,575,29219
2021-01-10,MO,Warren,5,580,29219
2021-01-11,MO,Warren,62,642,29219
2021-01-12,MO,Warren,44,686,29219
2021-01-13,MO,Warren,28,714,29219
2021-01-14,MO,Warren,28,742,29219
2021-01-15,MO,Warren,67,809,29219
2021-01-16,MO,Warren,10,819,29219
2021-01-17,MO,Warren,1,820,29219
2021-01-18,MO,Warren,49,869,29219
2021-01-19,MO,Warren,73,942,29219
2021-01-20,MO,Warren,76,1018,29219
2021-01-21,MO,Warren,114,1132,29219
2021-01-22,MO,Warren,56,1188,29219
2021-01-23,MO,Warren,26,1214,29219
2021-01-24,MO,Warren,22,1236,29219
2021-01-25,MO,Warren,70,1306,29219
2021-01-26,MO,Warren,77,1383,29219
2021-01-27,MO,Warren,58,1441,29219
2021-01-28,MO,Warren,61,1502,29219
2021-01-29,MO,Warren,77,1579,29219
2021-01-30,MO,Warren,70,1649,29219
2021-01-31,MO,Warren,16,1665,29219
2021-02-01,MO,Warren,79,1744,29219
2021-02-02,MO,Warren,78,1822,29219
2021-02-03,MO,Warren,145,1967,29219
2021-02-04,MO,Warren,65,2032,29219
2021-02-05,MO,Warren,105,2137,29219
2021-02-06,MO,Warren,31,2168,29219
2021-02-07,MO,Warren,1,2169,29219
2021-02-08,MO,Warren,81,2250,29219
2021-02-09,MO,Warren,115,2365,29219
2021-02-10,MO,Warren,58,2423,29219
2021-02-11,MO,Warren,83,2506,29219
2021-02-12,MO,Warren,153,2659,29219
2021-02-13,MO,Warren,70,2729,29219
2021-02-14,MO,Warren,20,2749,29219
2021-02-15,MO,Warren,64,2813,29219
2021-02-16,MO,Warren,84,2897,29219
2021-02-17,MO,Warren,91,2988,29219
2021-02-18,MO,Warren,161,3149,29219
2021-02-19,MO,Warren,86,3235,29219
2021-02-20,MO,Warren,98,3333,29219
2021-02-21,MO,Warren,13,3346,29219
2021-02-22,MO,Warren,139,3485,29219
2021-02-23,MO,Warren,290,3775,29219
2021-02-24,MO,Warren,181,3956,29219
2021-02-25,MO,Warren,175,4131,29219
2021-02-26,MO,Warren,112,4243,29219
2021-02-27,MO,Warren,112,4355,29219
2021-02-28,MO,Warren,25,4380,29219
2021-03-01,MO,Warren,209,4589,29219
2021-03-02,MO,Warren,318,4907,29219
2021-03-03,MO,Warren,131,5038,29219
2021-03-04,MO,Warren,131,5169,29219
2021-03-05,MO,Warren,163,5332,29219
2021-03-06,MO,Warren,67,5399,29219
2021-03-07,MO,Warren,31,5430,29219
2021-03-08,MO,Warren,268,5698,29219
2021-03-09,MO,Warren,230,5928,29219
2021-03-10,MO,Warren,180,6108,29219
2021-03-11,MO,Warren,211,6319,29219
2021-03-12,MO,Warren,244,6563,29219
2021-03-13,MO,Warren,95,6658,29219
2021-03-14,MO,Warren,11,6669,29219
2021-03-15,MO,Warren,196,6865,29219
2021-03-16,MO,Warren,292,7157,29219
2021-03-17,MO,Warren,180,7337,29219
2021-03-18,MO,Warren,196,7533,29219
2021-03-19,MO,Warren,155,7688,29219
2021-03-20,MO,Warren,158,7846,29219
2021-03-21,MO,Warren,50,7896,29219
2021-03-22,MO,Warren,180,8076,29219
2021-03-23,MO,Warren,368,8444,29219
2021-03-24,MO,Warren,232,8676,29219
2021-03-25,MO,Warren,225,8901,29219
2021-03-26,MO,Warren,221,9122,29219
2021-03-27,MO,Warren,125,9247,29219
2021-03-28,MO,Warren,33,9280,29219
2021-03-29,MO,Warren,267,9547,29219
2021-03-30,MO,Warren,385,9932,29219
2021-03-31,MO,Warren,321,10253,29219
2021-04-01,MO,Warren,301,10554,29219
2021-04-02,MO,Warren,287,10841,29219
2021-04-03,MO,Warren,122,10963,29219
2021-04-04,MO,Warren,20,10983,29219
2021-04-05,MO,Warren,306,11289,29219
2021-04-06,MO,Warren,315,11604,29219
2021-04-07,MO,Warren,250,11854,29219
2021-04-08,MO,Warren,349,12203,29219
2021-04-09,MO,Warren,340,12543,29219
2021-04-10,MO,Warren,144,12687,29219
2021-04-11,MO,Warren,46,12733,29219
2021-04-12,MO,Warren,330,13063,29219
2021-04-13,MO,Warren,326,13389,29219
2021-04-14,MO,Warren,231,13620,29219
2021-04-15,MO,Warren,193,13813,29219
2021-04-16,MO,Warren,289,14102,29219
2021-04-17,MO,Warren,143,14245,29219
2021-04-18,MO,Warren,119,14364,29219
2021-04-19,MO,Warren,192,14556,29219
2021-04-20,MO,Warren,308,14864,29219
2021-04-21,MO,Warren,217,15081,29219
2021-04-22,MO,Warren,168,15249,29219
2021-04-23,MO,Warren,184,15433,29219
2021-04-24,MO,Warren,110,15543,29219
2021-04-25,MO,Warren,32,15575,29219
2021-04-26,MO,Warren,195,15770,29219
2021-04-27,MO,Warren,244,16014,29219
2021-04-28,MO,Warren,277,16291,29219
2021-04-29,MO,Warren,200,16491,29219
2021-04-30,MO,Warren,188,16679,29219
2021-05-01,MO,Warren,79,16758,29219
2021-05-02,MO,Warren,31,16789,29219
2021-05-03,MO,Warren,143,16932,29219
2021-05-04,MO,Warren,196,17128,29219
2021-05-05,MO,Warren,185,17313,29219
2021-05-06,MO,Warren,139,17452,29219
2021-05-07,MO,Warren,271,17723,29219
2021-05-08,MO,Warren,84,17807,29219
2021-05-09,MO,Warren,28,17835,29219
2021-05-10,MO,Warren,96,17931,29219
2021-05-11,MO,Warren,75,18006,29219
2021-05-12,MO,Warren,127,18133,29219
2021-05-13,MO,Warren,142,18275,29219
2021-05-14,MO,Warren,201,18476,29219
2021-05-15,MO,Warren,102,18578,29219
2021-05-16,MO,Warren,30,18608,29219
2021-05-17,MO,Warren,137,18745,29219
2021-05-18,MO,Warren,262,19007,29219
2021-05-19,MO,Warren,105,19112,29219
2021-05-20,MO,Warren,102,19214,29219
2021-05-21,MO,Warren,105,19319,29219
2021-05-22,MO,Warren,70,19389,29219
2021-05-23,MO,Warren,25,19414,29219
2021-05-24,MO,Warren,109,19523,29219
2021-05-25,MO,Warren,134,19657,29219
2021-05-26,MO,Warren,59,19716,29219
2021-05-27,MO,Warren,30,19746,29219
2020-12-16,MO,Washington,4,4,29221
2020-12-17,MO,Washington,6,10,29221
2020-12-18,MO,Washington,9,19,29221
2020-12-19,MO,Washington,2,21,29221
2020-12-20,MO,Washington,1,22,29221
2020-12-21,MO,Washington,8,30,29221
2020-12-22,MO,Washington,22,52,29221
2020-12-23,MO,Washington,40,92,29221
2020-12-27,MO,Washington,1,93,29221
2020-12-28,MO,Washington,23,116,29221
2020-12-29,MO,Washington,8,124,29221
2020-12-30,MO,Washington,51,175,29221
2020-12-31,MO,Washington,12,187,29221
2021-01-01,MO,Washington,1,188,29221
2021-01-02,MO,Washington,8,196,29221
2021-01-03,MO,Washington,1,197,29221
2021-01-04,MO,Washington,33,230,29221
2021-01-05,MO,Washington,17,247,29221
2021-01-06,MO,Washington,6,253,29221
2021-01-07,MO,Washington,11,264,29221
2021-01-08,MO,Washington,19,283,29221
2021-01-09,MO,Washington,11,294,29221
2021-01-11,MO,Washington,15,309,29221
2021-01-12,MO,Washington,6,315,29221
2021-01-13,MO,Washington,21,336,29221
2021-01-14,MO,Washington,21,357,29221
2021-01-15,MO,Washington,12,369,29221
2021-01-16,MO,Washington,2,371,29221
2021-01-17,MO,Washington,3,374,29221
2021-01-18,MO,Washington,11,385,29221
2021-01-19,MO,Washington,32,417,29221
2021-01-20,MO,Washington,34,451,29221
2021-01-21,MO,Washington,29,480,29221
2021-01-22,MO,Washington,41,521,29221
2021-01-23,MO,Washington,4,525,29221
2021-01-24,MO,Washington,1,526,29221
2021-01-25,MO,Washington,101,627,29221
2021-01-26,MO,Washington,70,697,29221
2021-01-27,MO,Washington,95,792,29221
2021-01-28,MO,Washington,309,1101,29221
2021-01-29,MO,Washington,353,1454,29221
2021-01-30,MO,Washington,7,1461,29221
2021-02-01,MO,Washington,74,1535,29221
2021-02-02,MO,Washington,45,1580,29221
2021-02-03,MO,Washington,72,1652,29221
2021-02-04,MO,Washington,128,1780,29221
2021-02-05,MO,Washington,72,1852,29221
2021-02-06,MO,Washington,16,1868,29221
2021-02-07,MO,Washington,3,1871,29221
2021-02-08,MO,Washington,49,1920,29221
2021-02-09,MO,Washington,41,1961,29221
2021-02-10,MO,Washington,29,1990,29221
2021-02-11,MO,Washington,289,2279,29221
2021-02-12,MO,Washington,166,2445,29221
2021-02-13,MO,Washington,100,2545,29221
2021-02-14,MO,Washington,3,2548,29221
2021-02-15,MO,Washington,10,2558,29221
2021-02-16,MO,Washington,19,2577,29221
2021-02-17,MO,Washington,22,2599,29221
2021-02-18,MO,Washington,49,2648,29221
2021-02-19,MO,Washington,28,2676,29221
2021-02-20,MO,Washington,9,2685,29221
2021-02-22,MO,Washington,88,2773,29221
2021-02-23,MO,Washington,64,2837,29221
2021-02-24,MO,Washington,117,2954,29221
2021-02-25,MO,Washington,302,3256,29221
2021-02-26,MO,Washington,359,3615,29221
2021-02-27,MO,Washington,18,3633,29221
2021-02-28,MO,Washington,2,3635,29221
2021-03-01,MO,Washington,265,3900,29221
2021-03-02,MO,Washington,107,4007,29221
2021-03-03,MO,Washington,113,4120,29221
2021-03-04,MO,Washington,128,4248,29221
2021-03-05,MO,Washington,69,4317,29221
2021-03-06,MO,Washington,11,4328,29221
2021-03-07,MO,Washington,2,4330,29221
2021-03-08,MO,Washington,88,4418,29221
2021-03-09,MO,Washington,104,4522,29221
2021-03-10,MO,Washington,54,4576,29221
2021-03-11,MO,Washington,278,4854,29221
2021-03-12,MO,Washington,170,5024,29221
2021-03-13,MO,Washington,95,5119,29221
2021-03-14,MO,Washington,3,5122,29221
2021-03-15,MO,Washington,90,5212,29221
2021-03-16,MO,Washington,97,5309,29221
2021-03-17,MO,Washington,70,5379,29221
2021-03-18,MO,Washington,63,5442,29221
2021-03-19,MO,Washington,86,5528,29221
2021-03-20,MO,Washington,14,5542,29221
2021-03-21,MO,Washington,11,5553,29221
2021-03-22,MO,Washington,49,5602,29221
2021-03-23,MO,Washington,46,5648,29221
2021-03-24,MO,Washington,295,5943,29221
2021-03-25,MO,Washington,67,6010,29221
2021-03-26,MO,Washington,74,6084,29221
2021-03-27,MO,Washington,12,6096,29221
2021-03-28,MO,Washington,9,6105,29221
2021-03-29,MO,Washington,59,6164,29221
2021-03-30,MO,Washington,225,6389,29221
2021-03-31,MO,Washington,116,6505,29221
2021-04-01,MO,Washington,117,6622,29221
2021-04-02,MO,Washington,35,6657,29221
2021-04-03,MO,Washington,7,6664,29221
2021-04-04,MO,Washington,11,6675,29221
2021-04-05,MO,Washington,83,6758,29221
2021-04-06,MO,Washington,114,6872,29221
2021-04-07,MO,Washington,81,6953,29221
2021-04-08,MO,Washington,105,7058,29221
2021-04-09,MO,Washington,106,7164,29221
2021-04-10,MO,Washington,36,7200,29221
2021-04-11,MO,Washington,6,7206,29221
2021-04-12,MO,Washington,109,7315,29221
2021-04-13,MO,Washington,102,7417,29221
2021-04-14,MO,Washington,73,7490,29221
2021-04-15,MO,Washington,95,7585,29221
2021-04-16,MO,Washington,152,7737,29221
2021-04-17,MO,Washington,16,7753,29221
2021-04-18,MO,Washington,13,7766,29221
2021-04-19,MO,Washington,48,7814,29221
2021-04-20,MO,Washington,141,7955,29221
2021-04-21,MO,Washington,277,8232,29221
2021-04-22,MO,Washington,56,8288,29221
2021-04-23,MO,Washington,39,8327,29221
2021-04-24,MO,Washington,20,8347,29221
2021-04-25,MO,Washington,19,8366,29221
2021-04-26,MO,Washington,63,8429,29221
2021-04-27,MO,Washington,64,8493,29221
2021-04-28,MO,Washington,70,8563,29221
2021-04-29,MO,Washington,69,8632,29221
2021-04-30,MO,Washington,55,8687,29221
2021-05-01,MO,Washington,12,8699,29221
2021-05-02,MO,Washington,13,8712,29221
2021-05-03,MO,Washington,48,8760,29221
2021-05-04,MO,Washington,72,8832,29221
2021-05-05,MO,Washington,65,8897,29221
2021-05-06,MO,Washington,83,8980,29221
2021-05-07,MO,Washington,39,9019,29221
2021-05-08,MO,Washington,15,9034,29221
2021-05-09,MO,Washington,16,9050,29221
2021-05-10,MO,Washington,53,9103,29221
2021-05-11,MO,Washington,64,9167,29221
2021-05-12,MO,Washington,31,9198,29221
2021-05-13,MO,Washington,57,9255,29221
2021-05-14,MO,Washington,182,9437,29221
2021-05-15,MO,Washington,18,9455,29221
2021-05-16,MO,Washington,25,9480,29221
2021-05-17,MO,Washington,41,9521,29221
2021-05-18,MO,Washington,149,9670,29221
2021-05-19,MO,Washington,61,9731,29221
2021-05-20,MO,Washington,37,9768,29221
2021-05-21,MO,Washington,19,9787,29221
2021-05-22,MO,Washington,13,9800,29221
2021-05-23,MO,Washington,16,9816,29221
2021-05-24,MO,Washington,32,9848,29221
2021-05-25,MO,Washington,34,9882,29221
2021-05-26,MO,Washington,53,9935,29221
2021-05-27,MO,Washington,17,9952,29221
2020-12-18,MO,Wayne,1,1,29223
2020-12-21,MO,Wayne,2,3,29223
2020-12-22,MO,Wayne,3,6,29223
2020-12-23,MO,Wayne,17,23,29223
2020-12-28,MO,Wayne,3,26,29223
2020-12-29,MO,Wayne,5,31,29223
2020-12-30,MO,Wayne,7,38,29223
2020-12-31,MO,Wayne,17,55,29223
2021-01-02,MO,Wayne,1,56,29223
2021-01-04,MO,Wayne,3,59,29223
2021-01-05,MO,Wayne,31,90,29223
2021-01-06,MO,Wayne,6,96,29223
2021-01-07,MO,Wayne,9,105,29223
2021-01-08,MO,Wayne,6,111,29223
2021-01-09,MO,Wayne,3,114,29223
2021-01-11,MO,Wayne,3,117,29223
2021-01-12,MO,Wayne,6,123,29223
2021-01-13,MO,Wayne,13,136,29223
2021-01-14,MO,Wayne,24,160,29223
2021-01-15,MO,Wayne,6,166,29223
2021-01-16,MO,Wayne,1,167,29223
2021-01-18,MO,Wayne,9,176,29223
2021-01-19,MO,Wayne,9,185,29223
2021-01-20,MO,Wayne,43,228,29223
2021-01-21,MO,Wayne,59,287,29223
2021-01-22,MO,Wayne,190,477,29223
2021-01-23,MO,Wayne,28,505,29223
2021-01-24,MO,Wayne,3,508,29223
2021-01-25,MO,Wayne,14,522,29223
2021-01-26,MO,Wayne,49,571,29223
2021-01-27,MO,Wayne,18,589,29223
2021-01-28,MO,Wayne,48,637,29223
2021-01-29,MO,Wayne,81,718,29223
2021-01-30,MO,Wayne,1,719,29223
2021-02-01,MO,Wayne,23,742,29223
2021-02-02,MO,Wayne,24,766,29223
2021-02-03,MO,Wayne,32,798,29223
2021-02-04,MO,Wayne,52,850,29223
2021-02-05,MO,Wayne,62,912,29223
2021-02-06,MO,Wayne,101,1013,29223
2021-02-08,MO,Wayne,13,1026,29223
2021-02-09,MO,Wayne,92,1118,29223
2021-02-10,MO,Wayne,18,1136,29223
2021-02-11,MO,Wayne,14,1150,29223
2021-02-12,MO,Wayne,198,1348,29223
2021-02-13,MO,Wayne,6,1354,29223
2021-02-14,MO,Wayne,1,1355,29223
2021-02-15,MO,Wayne,13,1368,29223
2021-02-16,MO,Wayne,21,1389,29223
2021-02-17,MO,Wayne,20,1409,29223
2021-02-18,MO,Wayne,28,1437,29223
2021-02-19,MO,Wayne,65,1502,29223
2021-02-20,MO,Wayne,9,1511,29223
2021-02-21,MO,Wayne,48,1559,29223
2021-02-22,MO,Wayne,30,1589,29223
2021-02-23,MO,Wayne,43,1632,29223
2021-02-24,MO,Wayne,339,1971,29223
2021-02-25,MO,Wayne,43,2014,29223
2021-02-26,MO,Wayne,79,2093,29223
2021-02-27,MO,Wayne,9,2102,29223
2021-02-28,MO,Wayne,4,2106,29223
2021-03-01,MO,Wayne,189,2295,29223
2021-03-02,MO,Wayne,51,2346,29223
2021-03-03,MO,Wayne,77,2423,29223
2021-03-04,MO,Wayne,56,2479,29223
2021-03-05,MO,Wayne,91,2570,29223
2021-03-06,MO,Wayne,99,2669,29223
2021-03-08,MO,Wayne,38,2707,29223
2021-03-09,MO,Wayne,82,2789,29223
2021-03-10,MO,Wayne,44,2833,29223
2021-03-11,MO,Wayne,25,2858,29223
2021-03-12,MO,Wayne,37,2895,29223
2021-03-13,MO,Wayne,10,2905,29223
2021-03-14,MO,Wayne,6,2911,29223
2021-03-15,MO,Wayne,53,2964,29223
2021-03-16,MO,Wayne,40,3004,29223
2021-03-17,MO,Wayne,69,3073,29223
2021-03-18,MO,Wayne,78,3151,29223
2021-03-19,MO,Wayne,122,3273,29223
2021-03-20,MO,Wayne,1,3274,29223
2021-03-21,MO,Wayne,5,3279,29223
2021-03-22,MO,Wayne,29,3308,29223
2021-03-23,MO,Wayne,36,3344,29223
2021-03-24,MO,Wayne,456,3800,29223
2021-03-25,MO,Wayne,45,3845,29223
2021-03-26,MO,Wayne,25,3870,29223
2021-03-27,MO,Wayne,1,3871,29223
2021-03-28,MO,Wayne,4,3875,29223
2021-03-29,MO,Wayne,244,4119,29223
2021-03-30,MO,Wayne,72,4191,29223
2021-03-31,MO,Wayne,67,4258,29223
2021-04-01,MO,Wayne,45,4303,29223
2021-04-02,MO,Wayne,68,4371,29223
2021-04-03,MO,Wayne,3,4374,29223
2021-04-04,MO,Wayne,11,4385,29223
2021-04-05,MO,Wayne,39,4424,29223
2021-04-06,MO,Wayne,46,4470,29223
2021-04-07,MO,Wayne,42,4512,29223
2021-04-08,MO,Wayne,27,4539,29223
2021-04-09,MO,Wayne,116,4655,29223
2021-04-10,MO,Wayne,9,4664,29223
2021-04-11,MO,Wayne,5,4669,29223
2021-04-12,MO,Wayne,43,4712,29223
2021-04-13,MO,Wayne,35,4747,29223
2021-04-14,MO,Wayne,70,4817,29223
2021-04-15,MO,Wayne,23,4840,29223
2021-04-16,MO,Wayne,43,4883,29223
2021-04-17,MO,Wayne,2,4885,29223
2021-04-18,MO,Wayne,10,4895,29223
2021-04-19,MO,Wayne,90,4985,29223
2021-04-20,MO,Wayne,19,5004,29223
2021-04-21,MO,Wayne,194,5198,29223
2021-04-22,MO,Wayne,41,5239,29223
2021-04-23,MO,Wayne,29,5268,29223
2021-04-24,MO,Wayne,7,5275,29223
2021-04-25,MO,Wayne,7,5282,29223
2021-04-26,MO,Wayne,26,5308,29223
2021-04-27,MO,Wayne,27,5335,29223
2021-04-28,MO,Wayne,18,5353,29223
2021-04-29,MO,Wayne,34,5387,29223
2021-04-30,MO,Wayne,37,5424,29223
2021-05-01,MO,Wayne,3,5427,29223
2021-05-02,MO,Wayne,5,5432,29223
2021-05-03,MO,Wayne,13,5445,29223
2021-05-04,MO,Wayne,21,5466,29223
2021-05-05,MO,Wayne,26,5492,29223
2021-05-06,MO,Wayne,20,5512,29223
2021-05-07,MO,Wayne,44,5556,29223
2021-05-08,MO,Wayne,7,5563,29223
2021-05-09,MO,Wayne,2,5565,29223
2021-05-10,MO,Wayne,18,5583,29223
2021-05-11,MO,Wayne,13,5596,29223
2021-05-12,MO,Wayne,25,5621,29223
2021-05-13,MO,Wayne,12,5633,29223
2021-05-14,MO,Wayne,52,5685,29223
2021-05-15,MO,Wayne,4,5689,29223
2021-05-16,MO,Wayne,5,5694,29223
2021-05-17,MO,Wayne,23,5717,29223
2021-05-18,MO,Wayne,25,5742,29223
2021-05-19,MO,Wayne,41,5783,29223
2021-05-20,MO,Wayne,19,5802,29223
2021-05-21,MO,Wayne,38,5840,29223
2021-05-22,MO,Wayne,3,5843,29223
2021-05-23,MO,Wayne,6,5849,29223
2021-05-24,MO,Wayne,20,5869,29223
2021-05-25,MO,Wayne,14,5883,29223
2021-05-26,MO,Wayne,14,5897,29223
2021-05-27,MO,Wayne,17,5914,29223
2020-12-14,MO,Webster,2,2,29225
2020-12-15,MO,Webster,2,4,29225
2020-12-16,MO,Webster,41,45,29225
2020-12-17,MO,Webster,30,75,29225
2020-12-18,MO,Webster,30,105,29225
2020-12-19,MO,Webster,9,114,29225
2020-12-20,MO,Webster,4,118,29225
2020-12-21,MO,Webster,32,150,29225
2020-12-22,MO,Webster,73,223,29225
2020-12-23,MO,Webster,69,292,29225
2020-12-24,MO,Webster,35,327,29225
2020-12-26,MO,Webster,26,353,29225
2020-12-27,MO,Webster,13,366,29225
2020-12-28,MO,Webster,55,421,29225
2020-12-29,MO,Webster,51,472,29225
2020-12-30,MO,Webster,48,520,29225
2020-12-31,MO,Webster,55,575,29225
2021-01-02,MO,Webster,12,587,29225
2021-01-03,MO,Webster,1,588,29225
2021-01-04,MO,Webster,64,652,29225
2021-01-05,MO,Webster,45,697,29225
2021-01-06,MO,Webster,53,750,29225
2021-01-07,MO,Webster,15,765,29225
2021-01-08,MO,Webster,67,832,29225
2021-01-09,MO,Webster,13,845,29225
2021-01-10,MO,Webster,5,850,29225
2021-01-11,MO,Webster,58,908,29225
2021-01-12,MO,Webster,73,981,29225
2021-01-13,MO,Webster,58,1039,29225
2021-01-14,MO,Webster,42,1081,29225
2021-01-15,MO,Webster,166,1247,29225
2021-01-16,MO,Webster,29,1276,29225
2021-01-17,MO,Webster,5,1281,29225
2021-01-18,MO,Webster,101,1382,29225
2021-01-19,MO,Webster,92,1474,29225
2021-01-20,MO,Webster,96,1570,29225
2021-01-21,MO,Webster,137,1707,29225
2021-01-22,MO,Webster,343,2050,29225
2021-01-23,MO,Webster,33,2083,29225
2021-01-24,MO,Webster,12,2095,29225
2021-01-25,MO,Webster,164,2259,29225
2021-01-26,MO,Webster,298,2557,29225
2021-01-27,MO,Webster,140,2697,29225
2021-01-28,MO,Webster,163,2860,29225
2021-01-29,MO,Webster,116,2976,29225
2021-01-30,MO,Webster,53,3029,29225
2021-01-31,MO,Webster,1,3030,29225
2021-02-01,MO,Webster,123,3153,29225
2021-02-02,MO,Webster,65,3218,29225
2021-02-03,MO,Webster,119,3337,29225
2021-02-04,MO,Webster,54,3391,29225
2021-02-05,MO,Webster,378,3769,29225
2021-02-06,MO,Webster,152,3921,29225
2021-02-07,MO,Webster,2,3923,29225
2021-02-08,MO,Webster,118,4041,29225
2021-02-09,MO,Webster,96,4137,29225
2021-02-10,MO,Webster,63,4200,29225
2021-02-11,MO,Webster,255,4455,29225
2021-02-12,MO,Webster,608,5063,29225
2021-02-13,MO,Webster,69,5132,29225
2021-02-14,MO,Webster,33,5165,29225
2021-02-15,MO,Webster,69,5234,29225
2021-02-16,MO,Webster,73,5307,29225
2021-02-17,MO,Webster,67,5374,29225
2021-02-18,MO,Webster,99,5473,29225
2021-02-19,MO,Webster,250,5723,29225
2021-02-20,MO,Webster,8,5731,29225
2021-02-21,MO,Webster,2,5733,29225
2021-02-22,MO,Webster,71,5804,29225
2021-02-23,MO,Webster,214,6018,29225
2021-02-24,MO,Webster,131,6149,29225
2021-02-25,MO,Webster,141,6290,29225
2021-02-26,MO,Webster,462,6752,29225
2021-02-27,MO,Webster,230,6982,29225
2021-02-28,MO,Webster,20,7002,29225
2021-03-01,MO,Webster,226,7228,29225
2021-03-02,MO,Webster,100,7328,29225
2021-03-03,MO,Webster,222,7550,29225
2021-03-04,MO,Webster,417,7967,29225
2021-03-05,MO,Webster,394,8361,29225
2021-03-06,MO,Webster,172,8533,29225
2021-03-07,MO,Webster,14,8547,29225
2021-03-08,MO,Webster,177,8724,29225
2021-03-09,MO,Webster,287,9011,29225
2021-03-10,MO,Webster,132,9143,29225
2021-03-11,MO,Webster,418,9561,29225
2021-03-12,MO,Webster,384,9945,29225
2021-03-13,MO,Webster,73,10018,29225
2021-03-14,MO,Webster,23,10041,29225
2021-03-15,MO,Webster,201,10242,29225
2021-03-16,MO,Webster,165,10407,29225
2021-03-17,MO,Webster,156,10563,29225
2021-03-18,MO,Webster,212,10775,29225
2021-03-19,MO,Webster,414,11189,29225
2021-03-20,MO,Webster,73,11262,29225
2021-03-21,MO,Webster,36,11298,29225
2021-03-22,MO,Webster,297,11595,29225
2021-03-23,MO,Webster,261,11856,29225
2021-03-24,MO,Webster,176,12032,29225
2021-03-25,MO,Webster,169,12201,29225
2021-03-26,MO,Webster,497,12698,29225
2021-03-27,MO,Webster,132,12830,29225
2021-03-28,MO,Webster,25,12855,29225
2021-03-29,MO,Webster,187,13042,29225
2021-03-30,MO,Webster,183,13225,29225
2021-03-31,MO,Webster,214,13439,29225
2021-04-01,MO,Webster,323,13762,29225
2021-04-02,MO,Webster,373,14135,29225
2021-04-03,MO,Webster,168,14303,29225
2021-04-04,MO,Webster,37,14340,29225
2021-04-05,MO,Webster,359,14699,29225
2021-04-06,MO,Webster,339,15038,29225
2021-04-07,MO,Webster,192,15230,29225
2021-04-08,MO,Webster,410,15640,29225
2021-04-09,MO,Webster,441,16081,29225
2021-04-10,MO,Webster,156,16237,29225
2021-04-11,MO,Webster,28,16265,29225
2021-04-12,MO,Webster,232,16497,29225
2021-04-13,MO,Webster,235,16732,29225
2021-04-14,MO,Webster,186,16918,29225
2021-04-15,MO,Webster,138,17056,29225
2021-04-16,MO,Webster,445,17501,29225
2021-04-17,MO,Webster,55,17556,29225
2021-04-18,MO,Webster,21,17577,29225
2021-04-19,MO,Webster,262,17839,29225
2021-04-20,MO,Webster,181,18020,29225
2021-04-21,MO,Webster,96,18116,29225
2021-04-22,MO,Webster,144,18260,29225
2021-04-23,MO,Webster,113,18373,29225
2021-04-24,MO,Webster,108,18481,29225
2021-04-25,MO,Webster,23,18504,29225
2021-04-26,MO,Webster,102,18606,29225
2021-04-27,MO,Webster,126,18732,29225
2021-04-28,MO,Webster,96,18828,29225
2021-04-29,MO,Webster,77,18905,29225
2021-04-30,MO,Webster,186,19091,29225
2021-05-01,MO,Webster,46,19137,29225
2021-05-02,MO,Webster,18,19155,29225
2021-05-03,MO,Webster,71,19226,29225
2021-05-04,MO,Webster,84,19310,29225
2021-05-05,MO,Webster,122,19432,29225
2021-05-06,MO,Webster,64,19496,29225
2021-05-07,MO,Webster,107,19603,29225
2021-05-08,MO,Webster,67,19670,29225
2021-05-09,MO,Webster,11,19681,29225
2021-05-10,MO,Webster,70,19751,29225
2021-05-11,MO,Webster,88,19839,29225
2021-05-12,MO,Webster,81,19920,29225
2021-05-13,MO,Webster,66,19986,29225
2021-05-14,MO,Webster,92,20078,29225
2021-05-15,MO,Webster,61,20139,29225
2021-05-16,MO,Webster,22,20161,29225
2021-05-17,MO,Webster,112,20273,29225
2021-05-18,MO,Webster,78,20351,29225
2021-05-19,MO,Webster,78,20429,29225
2021-05-20,MO,Webster,67,20496,29225
2021-05-21,MO,Webster,78,20574,29225
2021-05-22,MO,Webster,29,20603,29225
2021-05-23,MO,Webster,16,20619,29225
2021-05-24,MO,Webster,47,20666,29225
2021-05-25,MO,Webster,52,20718,29225
2021-05-26,MO,Webster,61,20779,29225
2021-05-27,MO,Webster,24,20803,29225
2020-12-17,MO,Worth,1,1,29227
2020-12-22,MO,Worth,3,4,29227
2020-12-27,MO,Worth,1,5,29227
2020-12-28,MO,Worth,4,9,29227
2020-12-29,MO,Worth,1,10,29227
2020-12-30,MO,Worth,1,11,29227
2021-01-03,MO,Worth,19,30,29227
2021-01-04,MO,Worth,6,36,29227
2021-01-05,MO,Worth,1,37,29227
2021-01-06,MO,Worth,1,38,29227
2021-01-07,MO,Worth,1,39,29227
2021-01-08,MO,Worth,1,40,29227
2021-01-11,MO,Worth,1,41,29227
2021-01-12,MO,Worth,15,56,29227
2021-01-13,MO,Worth,1,57,29227
2021-01-14,MO,Worth,2,59,29227
2021-01-15,MO,Worth,1,60,29227
2021-01-20,MO,Worth,15,75,29227
2021-01-21,MO,Worth,6,81,29227
2021-01-22,MO,Worth,15,96,29227
2021-01-25,MO,Worth,1,97,29227
2021-01-26,MO,Worth,2,99,29227
2021-01-27,MO,Worth,10,109,29227
2021-01-28,MO,Worth,7,116,29227
2021-01-29,MO,Worth,4,120,29227
2021-01-30,MO,Worth,2,122,29227
2021-02-01,MO,Worth,109,231,29227
2021-02-02,MO,Worth,13,244,29227
2021-02-03,MO,Worth,42,286,29227
2021-02-04,MO,Worth,22,308,29227
2021-02-05,MO,Worth,8,316,29227
2021-02-09,MO,Worth,11,327,29227
2021-02-10,MO,Worth,10,337,29227
2021-02-11,MO,Worth,105,442,29227
2021-02-12,MO,Worth,14,456,29227
2021-02-13,MO,Worth,1,457,29227
2021-02-15,MO,Worth,2,459,29227
2021-02-17,MO,Worth,5,464,29227
2021-02-18,MO,Worth,7,471,29227
2021-02-19,MO,Worth,9,480,29227
2021-02-22,MO,Worth,107,587,29227
2021-02-23,MO,Worth,5,592,29227
2021-02-24,MO,Worth,12,604,29227
2021-02-25,MO,Worth,5,609,29227
2021-02-26,MO,Worth,36,645,29227
2021-02-27,MO,Worth,20,665,29227
2021-03-01,MO,Worth,1,666,29227
2021-03-02,MO,Worth,6,672,29227
2021-03-03,MO,Worth,8,680,29227
2021-03-04,MO,Worth,88,768,29227
2021-03-05,MO,Worth,7,775,29227
2021-03-06,MO,Worth,5,780,29227
2021-03-08,MO,Worth,1,781,29227
2021-03-10,MO,Worth,18,799,29227
2021-03-11,MO,Worth,5,804,29227
2021-03-12,MO,Worth,24,828,29227
2021-03-13,MO,Worth,1,829,29227
2021-03-15,MO,Worth,19,848,29227
2021-03-16,MO,Worth,3,851,29227
2021-03-17,MO,Worth,7,858,29227
2021-03-18,MO,Worth,11,869,29227
2021-03-19,MO,Worth,8,877,29227
2021-03-20,MO,Worth,1,878,29227
2021-03-22,MO,Worth,3,881,29227
2021-03-23,MO,Worth,1,882,29227
2021-03-24,MO,Worth,10,892,29227
2021-03-25,MO,Worth,4,896,29227
2021-03-26,MO,Worth,20,916,29227
2021-03-27,MO,Worth,2,918,29227
2021-03-30,MO,Worth,3,921,29227
2021-03-31,MO,Worth,8,929,29227
2021-04-01,MO,Worth,1,930,29227
2021-04-02,MO,Worth,17,947,29227
2021-04-06,MO,Worth,1,948,29227
2021-04-07,MO,Worth,4,952,29227
2021-04-08,MO,Worth,8,960,29227
2021-04-09,MO,Worth,20,980,29227
2021-04-10,MO,Worth,1,981,29227
2021-04-11,MO,Worth,1,982,29227
2021-04-12,MO,Worth,11,993,29227
2021-04-13,MO,Worth,2,995,29227
2021-04-14,MO,Worth,6,1001,29227
2021-04-15,MO,Worth,8,1009,29227
2021-04-16,MO,Worth,2,1011,29227
2021-04-20,MO,Worth,3,1014,29227
2021-04-21,MO,Worth,1,1015,29227
2021-04-22,MO,Worth,17,1032,29227
2021-04-23,MO,Worth,13,1045,29227
2021-04-24,MO,Worth,1,1046,29227
2021-04-25,MO,Worth,1,1047,29227
2021-04-27,MO,Worth,1,1048,29227
2021-04-28,MO,Worth,3,1051,29227
2021-04-29,MO,Worth,5,1056,29227
2021-04-30,MO,Worth,4,1060,29227
2021-05-01,MO,Worth,3,1063,29227
2021-05-03,MO,Worth,9,1072,29227
2021-05-04,MO,Worth,1,1073,29227
2021-05-06,MO,Worth,1,1074,29227
2021-05-07,MO,Worth,1,1075,29227
2021-05-08,MO,Worth,1,1076,29227
2021-05-12,MO,Worth,2,1078,29227
2021-05-13,MO,Worth,4,1082,29227
2021-05-14,MO,Worth,11,1093,29227
2021-05-16,MO,Worth,1,1094,29227
2021-05-17,MO,Worth,5,1099,29227
2021-05-19,MO,Worth,3,1102,29227
2021-05-20,MO,Worth,3,1105,29227
2021-05-21,MO,Worth,1,1106,29227
2021-05-22,MO,Worth,3,1109,29227
2021-05-24,MO,Worth,2,1111,29227
2021-05-25,MO,Worth,3,1114,29227
2021-05-27,MO,Worth,2,1116,29227
2020-12-16,MO,Wright,10,10,29229
2020-12-17,MO,Wright,1,11,29229
2020-12-20,MO,Wright,1,12,29229
2020-12-21,MO,Wright,3,15,29229
2020-12-22,MO,Wright,10,25,29229
2020-12-23,MO,Wright,21,46,29229
2020-12-24,MO,Wright,4,50,29229
2020-12-26,MO,Wright,7,57,29229
2020-12-27,MO,Wright,1,58,29229
2020-12-28,MO,Wright,5,63,29229
2020-12-29,MO,Wright,32,95,29229
2020-12-30,MO,Wright,48,143,29229
2020-12-31,MO,Wright,4,147,29229
2021-01-01,MO,Wright,1,148,29229
2021-01-02,MO,Wright,7,155,29229
2021-01-04,MO,Wright,7,162,29229
2021-01-05,MO,Wright,9,171,29229
2021-01-06,MO,Wright,21,192,29229
2021-01-07,MO,Wright,31,223,29229
2021-01-08,MO,Wright,14,237,29229
2021-01-09,MO,Wright,2,239,29229
2021-01-10,MO,Wright,1,240,29229
2021-01-11,MO,Wright,8,248,29229
2021-01-12,MO,Wright,9,257,29229
2021-01-13,MO,Wright,9,266,29229
2021-01-14,MO,Wright,7,273,29229
2021-01-15,MO,Wright,15,288,29229
2021-01-16,MO,Wright,5,293,29229
2021-01-17,MO,Wright,3,296,29229
2021-01-18,MO,Wright,10,306,29229
2021-01-19,MO,Wright,26,332,29229
2021-01-20,MO,Wright,18,350,29229
2021-01-21,MO,Wright,12,362,29229
2021-01-22,MO,Wright,31,393,29229
2021-01-23,MO,Wright,38,431,29229
2021-01-25,MO,Wright,19,450,29229
2021-01-26,MO,Wright,28,478,29229
2021-01-27,MO,Wright,103,581,29229
2021-01-28,MO,Wright,47,628,29229
2021-01-29,MO,Wright,86,714,29229
2021-01-30,MO,Wright,16,730,29229
2021-02-01,MO,Wright,16,746,29229
2021-02-02,MO,Wright,20,766,29229
2021-02-03,MO,Wright,102,868,29229
2021-02-04,MO,Wright,80,948,29229
2021-02-05,MO,Wright,105,1053,29229
2021-02-06,MO,Wright,73,1126,29229
2021-02-07,MO,Wright,1,1127,29229
2021-02-08,MO,Wright,26,1153,29229
2021-02-09,MO,Wright,111,1264,29229
2021-02-10,MO,Wright,71,1335,29229
2021-02-11,MO,Wright,70,1405,29229
2021-02-12,MO,Wright,98,1503,29229
2021-02-13,MO,Wright,107,1610,29229
2021-02-14,MO,Wright,2,1612,29229
2021-02-15,MO,Wright,3,1615,29229
2021-02-16,MO,Wright,28,1643,29229
2021-02-17,MO,Wright,5,1648,29229
2021-02-18,MO,Wright,20,1668,29229
2021-02-19,MO,Wright,67,1735,29229
2021-02-20,MO,Wright,1,1736,29229
2021-02-21,MO,Wright,5,1741,29229
2021-02-22,MO,Wright,20,1761,29229
2021-02-23,MO,Wright,86,1847,29229
2021-02-24,MO,Wright,156,2003,29229
2021-02-25,MO,Wright,50,2053,29229
2021-02-26,MO,Wright,98,2151,29229
2021-02-27,MO,Wright,181,2332,29229
2021-02-28,MO,Wright,3,2335,29229
2021-03-01,MO,Wright,32,2367,29229
2021-03-02,MO,Wright,130,2497,29229
2021-03-03,MO,Wright,167,2664,29229
2021-03-04,MO,Wright,123,2787,29229
2021-03-05,MO,Wright,71,2858,29229
2021-03-06,MO,Wright,33,2891,29229
2021-03-07,MO,Wright,9,2900,29229
2021-03-08,MO,Wright,65,2965,29229
2021-03-09,MO,Wright,137,3102,29229
2021-03-10,MO,Wright,102,3204,29229
2021-03-11,MO,Wright,71,3275,29229
2021-03-12,MO,Wright,64,3339,29229
2021-03-13,MO,Wright,103,3442,29229
2021-03-14,MO,Wright,1,3443,29229
2021-03-15,MO,Wright,56,3499,29229
2021-03-16,MO,Wright,167,3666,29229
2021-03-17,MO,Wright,94,3760,29229
2021-03-18,MO,Wright,75,3835,29229
2021-03-19,MO,Wright,120,3955,29229
2021-03-20,MO,Wright,15,3970,29229
2021-03-21,MO,Wright,5,3975,29229
2021-03-22,MO,Wright,48,4023,29229
2021-03-23,MO,Wright,71,4094,29229
2021-03-24,MO,Wright,171,4265,29229
2021-03-25,MO,Wright,110,4375,29229
2021-03-26,MO,Wright,102,4477,29229
2021-03-27,MO,Wright,152,4629,29229
2021-03-28,MO,Wright,12,4641,29229
2021-03-29,MO,Wright,29,4670,29229
2021-03-30,MO,Wright,100,4770,29229
2021-03-31,MO,Wright,93,4863,29229
2021-04-01,MO,Wright,102,4965,29229
2021-04-02,MO,Wright,41,5006,29229
2021-04-03,MO,Wright,24,5030,29229
2021-04-04,MO,Wright,1,5031,29229
2021-04-05,MO,Wright,40,5071,29229
2021-04-06,MO,Wright,85,5156,29229
2021-04-07,MO,Wright,138,5294,29229
2021-04-08,MO,Wright,90,5384,29229
2021-04-09,MO,Wright,144,5528,29229
2021-04-10,MO,Wright,63,5591,29229
2021-04-11,MO,Wright,16,5607,29229
2021-04-12,MO,Wright,89,5696,29229
2021-04-13,MO,Wright,174,5870,29229
2021-04-14,MO,Wright,108,5978,29229
2021-04-15,MO,Wright,53,6031,29229
2021-04-16,MO,Wright,72,6103,29229
2021-04-17,MO,Wright,15,6118,29229
2021-04-18,MO,Wright,1,6119,29229
2021-04-19,MO,Wright,34,6153,29229
2021-04-20,MO,Wright,64,6217,29229
2021-04-21,MO,Wright,51,6268,29229
2021-04-22,MO,Wright,51,6319,29229
2021-04-23,MO,Wright,74,6393,29229
2021-04-24,MO,Wright,26,6419,29229
2021-04-25,MO,Wright,14,6433,29229
2021-04-26,MO,Wright,30,6463,29229
2021-04-27,MO,Wright,39,6502,29229
2021-04-28,MO,Wright,77,6579,29229
2021-04-29,MO,Wright,23,6602,29229
2021-04-30,MO,Wright,35,6637,29229
2021-05-01,MO,Wright,44,6681,29229
2021-05-02,MO,Wright,2,6683,29229
2021-05-03,MO,Wright,40,6723,29229
2021-05-04,MO,Wright,79,6802,29229
2021-05-05,MO,Wright,53,6855,29229
2021-05-06,MO,Wright,40,6895,29229
2021-05-07,MO,Wright,62,6957,29229
2021-05-08,MO,Wright,24,6981,29229
2021-05-09,MO,Wright,7,6988,29229
2021-05-10,MO,Wright,24,7012,29229
2021-05-11,MO,Wright,26,7038,29229
2021-05-12,MO,Wright,42,7080,29229
2021-05-13,MO,Wright,31,7111,29229
2021-05-14,MO,Wright,24,7135,29229
2021-05-15,MO,Wright,19,7154,29229
2021-05-16,MO,Wright,5,7159,29229
2021-05-17,MO,Wright,33,7192,29229
2021-05-18,MO,Wright,55,7247,29229
2021-05-19,MO,Wright,31,7278,29229
2021-05-20,MO,Wright,27,7305,29229
2021-05-21,MO,Wright,14,7319,29229
2021-05-22,MO,Wright,12,7331,29229
2021-05-23,MO,Wright,5,7336,29229
2021-05-24,MO,Wright,30,7366,29229
2021-05-25,MO,Wright,26,7392,29229
2021-05-26,MO,Wright,15,7407,29229
2021-05-27,MO,Wright,10,7417,29229
